CAMERA,RADIUS,NCELLS,AREA,MIN,MAX,RANGE,MEAN,STD
1,250,4,214739.56,7840,8005,165,7881.25,71.44709581
2,250,3,161054.67,6159,7918,1759,6896.333333,745.7230645
3,250,4,214739.56,7508,7766,258,7694.75,108.0078122
4,250,4,214739.56,7277,7503,226,7346,91.21951546
5,250,4,214739.56,7760,7934,174,7860,63.07138812
6,250,4,214739.56,7347,7598,251,7498.25,92.40231328
7,250,3,161054.67,7103,7456,353,7304.666667,148.4415336
8,250,4,214739.56,5998,7402,1404,6744.5,660.5049205
9,250,4,214739.56,7788,8213,425,8056.75,163.29938
10,250,4,214739.56,7700,8153,453,7867,183.4570794
11,250,4,214739.56,6060,7253,1193,6511.75,477.3878795
12,250,4,214739.56,7400,8123,723,7625.25,296.4214694
13,250,4,214739.56,6213,6365,152,6251,65.81793069
14,250,4,214739.56,7279,8445,1166,7916.25,422.5620517
16,250,4,214739.56,6488,9040,2552,7870.75,1178.955761
17,250,4,214739.56,6223,7157,934,6596.75,396.3334297
18,250,3,161054.67,8068,8476,408,8206.333333,190.7045417
19,250,2,107369.78,6704,6781,77,6742.5,38.5
20,250,4,214739.56,7580,8201,621,7904.25,225.9616948
21,250,4,214739.56,7995,8302,307,8116.75,129.765895
22,250,3,161054.67,4810,7674,2864,6291.333333,1171.302788
23,250,5,268424.45,6764,8047,1283,7432.6,406.4517684
24,250,4,214739.56,6937,8034,1097,7529.5,448.5423614
25,250,4,214739.56,7761,7915,154,7799.5,66.68395609
26,250,3,161054.67,7244,7787,543,7500,222.7599605
27,250,4,214739.56,7255,7855,600,7575.5,234.3976322
28,250,4,214739.56,7373,7834,461,7493.75,196.6486397
29,250,4,214739.56,7716,7873,157,7764,63.41529784
31,250,4,214739.56,7615,7689,74,7641.25,30.33459246
32,250,3,161054.67,6984,7707,723,7361.333333,296.0116364
33,250,4,214739.56,7236,7591,355,7397.5,147.9704362
34,250,3,161054.67,6660,7280,620,7039.333333,271.4422386
10A,250,4,214739.56,6977,8243,1266,7837.5,505.43323
10NE,250,4,214739.56,7815,7985,170,7900,61.74544518
10NW,250,3,161054.67,8220,8269,49,8236.333333,23.09882152
10SW,250,4,214739.56,6818,8920,2102,7533.25,818.4617813
11NE,250,4,214739.56,6906,7512,606,7151.25,258.4911749
11NW,250,4,214739.56,7204,7902,698,7667.75,277.0725311
11SE,250,3,161054.67,7104,7528,424,7386.666667,199.8755168
17NW,250,3,161054.67,7389,7402,13,7393.333333,6.128258771
17SE,250,3,161054.67,6867,7578,711,7104,335.1686143
17SW,250,4,214739.56,7577,7701,124,7660.75,50.31090836
22S,250,3,161054.67,7029,8228,1199,7666.333333,492.405208
23S,250,4,214739.56,1722,3173,1451,2244.25,596.1259829
24S,250,3,161054.67,7886,8034,148,7984.666667,69.76786908
27A,250,4,214739.56,7897,8484,587,8088.25,231.3572724
2A,250,4,214739.56,6899,7999,1100,7387,495.8144814
5NE,250,3,161054.67,7419,7578,159,7525,74.95331881
5NW,250,3,161054.67,6108,6349,241,6233.333333,98.6249912
5SE,250,4,214739.56,8145,8674,529,8291,222.2622325
6NE,250,4,214739.56,7209,8007,798,7655.75,315.6686356
6NW,250,4,214739.56,7457,8345,888,7973.5,322.2371021
6SW,250,3,161054.67,7752,7888,136,7809,57.65992253
Cell 1 2011/12,250,4,214739.56,7840,8005,165,7881.25,71.44709581
Cell 1 SW 2013,250,4,214739.56,7185,7456,271,7361.5,107.1972481
Cell 10 2011/12,250,4,214739.56,7700,8153,453,7867,183.4570794
Cell 10 NE 2011/12,250,4,214739.56,7815,7985,170,7900,61.74544518
Cell 10 NW 2011/12,250,3,161054.67,8220,8269,49,8236.333333,23.09882152
Cell 10 SE 2013,250,4,214739.56,7457,8345,888,7973.5,322.2371021
Cell 10 SW 2011/12,250,4,214739.56,6818,8920,2102,7533.25,818.4617813
Cell 10-A 2011/12,250,4,214739.56,6977,8243,1266,7837.5,505.43323
Cell 11 NE 2011/12,250,4,214739.56,6906,7512,606,7151.25,258.4911749
Cell 11 NW 2013,250,4,214739.56,7794,8201,407,8085.75,168.8022141
Cell 11 SW 2013,250,4,214739.56,6946,7323,377,7124.25,169.3389722
Cell 12 2013,250,3,161054.67,7103,7456,353,7304.666667,148.4415336
Cell 13 2013,250,4,214739.56,5711,7519,1808,6675.25,827.158502
Cell 14 2013,250,4,214739.56,8005,8191,186,8123.5,71.80006964
Cell 15 2013,250,3,161054.67,7698,7744,46,7713.333333,21.68460796
Cell 15-A 2013,250,4,214739.56,7730,7965,235,7835,84.56062914
Cell 16 2013,250,3,161054.67,7466,7795,329,7575.666667,155.0920873
Cell 17 NW 2011/12,250,3,161054.67,7389,7402,13,7393.333333,6.128258771
Cell 17 NW 2013,250,4,214739.56,2046,7085,5039,5226.5,1941.263055
Cell 17 SE 2013,250,3,161054.67,8220,8269,49,8236.333333,23.09882152
Cell 17 SW 2013,250,4,214739.56,7880,8227,347,8059.5,154.0559963
Cell 18 2011/12,250,3,161054.67,8068,8476,408,8206.333333,190.7045417
Cell 18 NE 2013,250,4,214739.56,6859,7888,1029,7364.75,460.4695294
Cell 18 NW 2013,250,3,161054.67,8145,8674,529,8339.666667,237.4732733
Cell 18 SE 2013,250,4,214739.56,6906,7512,606,7151.25,258.4911749
Cell 18 SSE 2013,250,3,161054.67,6785,7995,1210,7382.666667,494.0892857
Cell 19 NW 2013,250,3,161054.67,7658,7985,327,7866.666667,147.9917415
Cell 2 2011/12,250,3,161054.67,6159,7918,1759,6896.333333,745.7230645
Cell 2 NE 2013,250,4,214739.56,6347,7423,1076,6824.25,437.2535735
Cell 2 SW 2013,250,3,161054.67,7840,8005,165,7895,77.78174593
Cell 20 2013,250,4,214739.56,7489,7922,433,7743.75,165.1656366
Cell 21 2013,250,4,214739.56,5309,5512,203,5359.75,87.90157848
Cell 22 2013,250,3,161054.67,7092,7175,83,7121.333333,38.00292386
Cell 23 2013,250,4,214739.56,8374,8469,95,8439.75,39.00881311
Cell 24 2013,250,3,161054.67,8181,8191,10,8187.666667,4.714045208
Cell 25 NE 2013,250,4,214739.56,7700,8153,453,7867,183.4570794
Cell 25 SE 2013,250,4,214739.56,6818,8920,2102,7533.25,818.4617813
Cell 26 NE 2013,250,4,214739.56,6060,7253,1193,6511.75,477.3878795
Cell 26 NNW 2013,250,4,214739.56,7815,7985,170,7900,61.74544518
Cell 26 NW 2013,250,4,214739.56,6977,8243,1266,7837.5,505.43323
Cell 27 NW 2013,250,3,161054.67,7104,7528,424,7386.666667,199.8755168
Cell 28 2013,250,4,214739.56,7400,8123,723,7625.25,296.4214694
Cell 29 2013,250,4,214739.56,6213,6365,152,6251,65.81793069
Cell 3 NE 2013,250,4,214739.56,7315,8171,856,7768.25,383.6348361
Cell 3 NW 2013,250,3,161054.67,7109,8278,1169,7612.333333,490.8525463
Cell 30 2013,250,3,161054.67,7820,8023,203,7916,83.23861283
Cell 31 2013,250,4,214739.56,8374,8417,43,8390.25,16.08376511
Cell 32 2013,250,3,161054.67,8262,8488,226,8383.666667,93.07464149
Cell 33 NE 2013,250,3,161054.67,7389,7402,13,7393.333333,6.128258771
Cell 33 SE 2013,250,4,214739.56,7577,7701,124,7660.75,50.31090836
Cell 33 SW 2013,250,4,214739.56,4996,8449,3453,7525.75,1463.834583
Cell 34 N 2013,250,4,214739.56,7300,7977,677,7662.25,316.5370239
Cell 34 NW 2013,250,4,214739.56,6223,7157,934,6596.75,396.3334297
Cell 34 SE 2013,250,4,214739.56,6867,7578,711,7125.25,292.5887686
Cell 35 2013,250,5,268424.45,5805,7682,1877,7270.6,733.5940567
Cell 37 2013,250,3,161054.67,7845,8201,356,8012.333333,146.1171524
Cell 38 2013,250,4,214739.56,7995,8280,285,8111.25,122.0335507
Cell 39 2013,250,4,214739.56,7812,8559,747,8340,307.1847978
Cell 4 2013,250,3,161054.67,7684,7896,212,7761.666667,95.37411715
Cell 40 NE 2013,250,4,214739.56,5907,7704,1797,6826.25,794.9177237
Cell 41 N 2013,250,4,214739.56,7242,7549,307,7458.75,127.0676493
Cell 41 NW 2013,250,3,161054.67,5270,8277,3007,6300,1398.360707
Cell 42 NW 2013,250,4,214739.56,6533,8047,1514,7194,592.8899561
Cell 43 2013,250,4,214739.56,6946,7272,326,7141.75,138.2396018
Cell 44 2013,250,4,214739.56,7540,8069,529,7747,195.7843201
Cell 45 2013,250,3,161054.67,7244,7787,543,7500,222.7599605
Cell 47 2013,250,4,214739.56,6946,7706,760,7454,310.2772953
Cell 48 2013,250,3,161054.67,7886,8034,148,7984.666667,69.76786908
Cell 49 2013,250,4,214739.56,7761,7915,154,7799.5,66.68395609
Cell 5 2011/12 Summer,250,4,214739.56,7880,8227,347,8059.5,154.0559963
Cell 5 2013,250,4,214739.56,8197,8494,297,8308.5,112.1840006
Cell 50 2013,250,4,214739.56,7716,7873,157,7764,63.41529784
Cell 51 2013,250,4,214739.56,7646,8080,434,7832.75,191.5872843
Cell 52 2013,250,4,214739.56,7079,7740,661,7430,311.3526939
Cell 53 2013,250,4,214739.56,7373,7834,461,7493.75,196.6486397
Cell 54 2013,250,3,161054.67,8488,8644,156,8564.666667,63.71464161
Cell 55 2013,250,4,214739.56,7699,8129,430,7905,153.4861557
Cell 56 2013,250,4,214739.56,7236,7591,355,7397.5,147.9704362
Cell 57 2013,250,3,161054.67,6984,7707,723,7361.333333,296.0116364
Cell 58 2013,250,4,214739.56,7859,8070,211,7929.75,82.29633953
Cell 59 2013,250,3,161054.67,7154,7339,185,7231.666667,78.38508929
Cell 6 2011/12,250,4,214739.56,7347,7598,251,7498.25,92.40231328
Cell 6 2013,250,4,214739.56,8087,8319,232,8200.5,82.0624762
Cell 6 NE 2011/12,250,4,214739.56,7209,8007,798,7655.75,315.6686356
Cell 6 NW 2011/12,250,4,214739.56,7457,8345,888,7973.5,322.2371021
Cell 6 SW 2011/12,250,3,161054.67,7752,7888,136,7809,57.65992253
Cell 60 2013,250,4,214739.56,7054,7307,253,7169.25,110.7618504
Cell 61 2013,250,4,214739.56,7756,8199,443,7937.5,173.3414261
Cell 7 2013,250,4,214739.56,8106,8179,73,8134.75,26.94786633
Cell 9 NW 2013,250,4,214739.56,-322,5402,5724,3763,2364.582627
Cell 9 SE 2013,250,3,161054.67,7419,7578,159,7525,74.95331881
Cell 9 SW 2013,250,3,161054.67,6108,6349,241,6233.333333,98.6249912
Cell R1,250,5,268424.45,6542,7644,1102,7176,405.6781976
Cell R10,250,3,161054.67,7684,7896,212,7761.666667,95.37411715
Cell R100,250,4,214739.56,7716,7873,157,7764,63.41529784
Cell R101,250,3,161054.67,8171,8234,63,8194.333333,28.19377394
Cell R104,250,3,161054.67,8117,8218,101,8170.333333,41.42731252
Cell R105,250,4,214739.56,7373,7834,461,7493.75,196.6486397
Cell R106,250,3,161054.67,7728,8140,412,7989.666667,185.7100488
Cell R107,250,3,161054.67,8488,8644,156,8564.666667,63.71464161
Cell R11,250,4,214739.56,8197,8494,297,8308.5,112.1840006
Cell R111,250,3,161054.67,7326,8052,726,7697,296.6041133
Cell R112,250,4,214739.56,7404,7662,258,7483.75,104.0393555
Cell R113,250,3,161054.67,6984,7707,723,7361.333333,296.0116364
Cell R114,250,4,214739.56,7859,8070,211,7929.75,82.29633953
Cell R117,250,3,161054.67,7598,7978,380,7851.333333,179.1337179
Cell R118,250,4,214739.56,7236,7591,355,7397.5,147.9704362
Cell R119,250,3,161054.67,6540,6972,432,6775,178.3984305
Cell R120,250,5,268424.45,7962,8203,241,8060.6,87.9013083
Cell R121,250,4,214739.56,7213,7542,329,7400.25,130.1371872
Cell R123,250,4,214739.56,7430,7533,103,7455.75,44.60030829
Cell R124,250,4,214739.56,6512,7372,860,7152.5,369.8658541
Cell R125,250,4,214739.56,7068,7987,919,7429.25,339.4454117
Cell R126,250,4,214739.56,7903,8065,162,7973.25,71.87619564
Cell R15,250,4,214739.56,7185,7456,271,7361.5,107.1972481
Cell R16,250,4,214739.56,-322,5402,5724,3763,2364.582627
Cell R17,250,4,214739.56,7112,7874,762,7594,287.7177436
Cell R18,250,4,214739.56,7794,8201,407,8085.75,168.8022141
Cell R19,250,3,161054.67,7569,7997,428,7746,182.3970029
Cell R20,250,4,214739.56,7338,7551,213,7472.25,85.82358359
Cell R21,250,4,214739.56,7250,8250,1000,7835.25,368.5616468
Cell R22,250,4,214739.56,8005,8191,186,8123.5,71.80006964
Cell R24,250,4,214739.56,2046,7085,5039,5226.5,1941.263055
Cell R25,250,3,161054.67,8145,8674,529,8339.666667,237.4732733
Cell R26,250,3,161054.67,7457,8345,888,7951,369.3561966
Cell R27,250,3,161054.67,7658,7985,327,7866.666667,147.9917415
Cell R28,250,4,214739.56,4545,7210,2665,5786.25,1247.940178
Cell R29,250,4,214739.56,7489,7922,433,7743.75,165.1656366
Cell R30,250,3,161054.67,7158,8282,1124,7658.666667,466.9970259
Cell R31,250,4,214739.56,8196,8275,79,8226.5,32.7299557
Cell R35,250,4,214739.56,7880,8227,347,8059.5,154.0559963
Cell R36,250,3,161054.67,8220,8269,49,8236.333333,23.09882152
Cell R37,250,4,214739.56,6906,7512,606,7151.25,258.4911749
Cell R38,250,4,214739.56,7331,7907,576,7584.5,226.9509859
Cell R39,250,3,161054.67,7645,8390,745,8092.333333,322.0313994
Cell R40,250,4,214739.56,5309,5512,203,5359.75,87.90157848
Cell R46,250,4,214739.56,2545,7415,4870,4984,2236.696001
Cell R47,250,4,214739.56,6977,8243,1266,7837.5,505.43323
Cell R48,250,4,214739.56,6060,7253,1193,6511.75,477.3878795
Cell R49,250,3,161054.67,7104,7528,424,7386.666667,199.8755168
Cell R5,250,4,214739.56,5728,7638,1910,6932.25,731.1697392
Cell R50,250,4,214739.56,7400,8123,723,7625.25,296.4214694
Cell R51,250,4,214739.56,6213,6365,152,6251,65.81793069
Cell R52,250,4,214739.56,7380,8186,806,7770.25,299.5866945
Cell R53,250,4,214739.56,6925,7894,969,7377.25,344.1078138
Cell R54,250,4,214739.56,8374,8417,43,8390.25,16.08376511
Cell R58,250,4,214739.56,7372,7989,617,7664.75,219.3141297
Cell R59,250,3,161054.67,7389,7402,13,7393.333333,6.128258771
Cell R6,250,3,161054.67,7840,8005,165,7895,77.78174593
Cell R60,250,4,214739.56,6223,7157,934,6596.75,396.3334297
Cell R61,250,5,268424.45,5805,7682,1877,7270.6,733.5940567
Cell R62,250,4,214739.56,6704,7863,1159,7326.25,471.7522522
Cell R63,250,4,214739.56,7722,7810,88,7744,38.10511777
Cell R64,250,4,214739.56,7697,7889,192,7783,70.68238819
Cell R65,250,3,161054.67,7820,8023,203,7916,83.23861283
Cell R66,250,4,214739.56,7754,8348,594,8089.75,219.7889613
Cell R69,250,4,214739.56,4996,8449,3453,7525.75,1463.834583
Cell R7,250,3,161054.67,7109,8278,1169,7612.333333,490.8525463
Cell R70,250,4,214739.56,7577,7701,124,7660.75,50.31090836
Cell R71,250,4,214739.56,6867,7578,711,7125.25,292.5887686
Cell R72,250,4,214739.56,5373,8080,2707,7176.5,1105.12997
Cell R73,250,4,214739.56,6938,7981,1043,7639.25,410.4530272
Cell R74,250,3,161054.67,7381,7477,96,7445,45.254834
Cell R75,250,3,161054.67,7845,8201,356,8012.333333,146.1171524
Cell R76,250,4,214739.56,8289,8727,438,8527.75,156.3223832
Cell R77,250,4,214739.56,7995,8280,285,8111.25,122.0335507
Cell R8,250,4,214739.56,7866,8317,451,7978.75,195.2887286
Cell R80,250,4,214739.56,5907,7704,1797,6826.25,794.9177237
Cell R81,250,3,161054.67,7637,7945,308,7745.333333,141.3561302
Cell R82,250,4,214739.56,6533,8047,1514,7194,592.8899561
Cell R83,250,4,214739.56,7461,8490,1029,8083.25,434.3566363
Cell R84,250,3,161054.67,6932,7389,457,7084.333333,215.431866
Cell R85,250,4,214739.56,6946,7272,326,7141.75,138.2396018
Cell R86,250,3,161054.67,7700,7913,213,7793,89.02808546
Cell R87,250,3,161054.67,7244,7787,543,7500,222.7599605
Cell R9,250,5,268424.45,5341,7721,2380,6487.4,782.9617104
Cell R90,250,4,214739.56,6946,7706,760,7454,310.2772953
Cell R91,250,3,161054.67,7886,8034,148,7984.666667,69.76786908
Cell R92,250,4,214739.56,6786,7634,848,7162.25,382.2619357
Cell R93,250,4,214739.56,7761,7915,154,7799.5,66.68395609
Cell R97,250,4,214739.56,7956,8163,207,8094,82.45908076
Cell R98,250,4,214739.56,7255,7855,600,7575.5,234.3976322
Cell R99,250,4,214739.56,7079,7740,661,7430,311.3526939
Cell S102,250,4,214739.56,7498,7970,472,7787.75,197.4669276
Cell S108,250,4,214739.56,7699,8129,430,7905,153.4861557
Cell S13,250,4,214739.56,7572,7942,370,7849.5,160.2146997
Cell S14,250,4,214739.56,8106,8179,73,8134.75,26.94786633
Cell S2,250,4,214739.56,8087,8319,232,8200.5,82.0624762
Cell S23,250,4,214739.56,8235,8543,308,8449.75,126.793878
Cell S32,250,4,214739.56,8292,8448,156,8380.75,56.24666657
Cell S33,250,4,214739.56,7730,7965,235,7835,84.56062914
Cell S34,250,3,161054.67,8181,8191,10,8187.666667,4.714045208
Cell S41,250,4,214739.56,8017,8190,173,8129,66.31364867
Cell S42,250,4,214739.56,8374,8469,95,8439.75,39.00881311
Cell S44,250,4,214739.56,7769,7988,219,7876.25,105.8403869
Cell S56,250,4,214739.56,7246,8358,1112,7861.75,397.711186
Cell S67,250,3,161054.67,8262,8488,226,8383.666667,93.07464149
Cell S78,250,4,214739.56,7812,8559,747,8340,307.1847978
Cell S88,250,3,161054.67,7643,8197,554,8012.333333,261.1581045
Cell S94,250,4,214739.56,8020,8179,159,8139.25,68.8490196
Cell S95,250,4,214739.56,7646,8080,434,7832.75,191.5872843
W287,250,4,214739.56,4207,6180,1973,5164.75,701.0475644
W295,250,3,161054.67,4509,7446,2937,5689.333333,1266.38918
W338,250,4,214739.56,6865,7755,890,7256.75,325.4891511
W342,250,3,161054.67,5164,7553,2389,5960.333333,1126.1854
W345,250,4,214739.56,7649,7742,93,7707.25,34.98124497
W387,250,3,161054.67,7110,7781,671,7557.333333,316.3124335
W393,250,4,214739.56,7235,7447,212,7341,106
W440,250,4,214739.56,6812,7136,324,6949.5,117.1420078
W441,250,4,214739.56,7810,7925,115,7870.75,40.78832554
W445,250,4,214739.56,6352,7395,1043,6766.5,413.0983539
W500,250,4,214739.56,8017,8361,344,8189,172
1,500,14,751588.46,7723,8029,306,7907.285714,84.46168072
2,500,14,751588.46,5890,7918,2028,6926.357143,765.8684713
3,500,14,751588.46,7440,7828,388,7670.142857,143.8962211
4,500,14,751588.46,6628,7877,1249,7367.571429,269.7985265
5,500,15,805273.35,7760,8227,467,7953.466667,165.9670114
6,500,16,858958.24,7073,8233,1160,7638.5,353.2124007
7,500,15,805273.35,5167,7929,2762,7025.333333,754.8796519
8,500,14,751588.46,5733,7490,1757,6737.857143,650.7993829
9,500,14,751588.46,7521,8283,762,7942.5,229.4959539
10,500,16,858958.24,6574,8673,2099,7710.375,565.5658533
11,500,15,805273.35,6013,7609,1596,6821.2,561.8491138
12,500,16,858958.24,6530,8123,1593,7423.3125,400.1179074
13,500,14,751588.46,5427,7735,2308,6550.071429,657.0107049
14,500,14,751588.46,7279,8621,1342,8040.071429,450.9327578
16,500,14,751588.46,4996,9332,4336,7245.5,1525.591817
17,500,14,751588.46,6095,7664,1569,6902,528.3247108
18,500,15,805273.35,7439,8476,1037,8024.066667,285.3779872
19,500,16,858958.24,5591,7863,2272,6820.125,556.0060561
20,500,14,751588.46,7580,8201,621,7867,200.8595814
21,500,15,805273.35,7995,8419,424,8191,124.2615521
22,500,15,805273.35,-1724,8228,9952,4752.6,3724.458973
23,500,14,751588.46,6533,8047,1514,7213.071429,421.3685974
24,500,14,751588.46,6937,8387,1450,7710.071429,466.3278222
25,500,15,805273.35,7207,7915,708,7618.866667,226.4128579
26,500,15,805273.35,7244,7794,550,7587.133333,167.2841362
27,500,16,858958.24,7010,7944,934,7523.6875,264.7708251
28,500,16,858958.24,6896,7889,993,7528.5,320.2338989
29,500,14,751588.46,7630,8026,396,7805.785714,118.8523565
31,500,16,858958.24,7426,7810,384,7643.3125,99.04589766
32,500,14,751588.46,6965,7835,870,7347,290.6743391
33,500,14,751588.46,7223,7857,634,7440.142857,183.0772113
34,500,15,805273.35,6612,7292,680,6959.6,282.7702955
10A,500,14,751588.46,6855,8243,1388,7692.928571,489.7994435
10NE,500,14,751588.46,7614,8070,456,7916.642857,120.1104296
10NW,500,16,858958.24,7788,8473,685,8234.9375,190.969719
10SW,500,14,751588.46,6761,8920,2159,7708.5,847.4554982
11NE,500,15,805273.35,6377,7512,1135,7005.4,333.4490066
11NW,500,14,751588.46,6949,8438,1489,7723.285714,423.4444522
11SE,500,15,805273.35,7006,8173,1167,7495.066667,337.0456876
17NW,500,15,805273.35,6957,7945,988,7478.466667,264.0403673
17SE,500,14,751588.46,6862,7886,1024,7196.071429,330.7388837
17SW,500,15,805273.35,6038,7701,1663,7261,545.0958326
22S,500,16,858958.24,-1021,8228,9249,6433.875,2950.712496
23S,500,16,858958.24,1722,3173,1451,2445.125,456.18032
24S,500,16,858958.24,6937,8387,1450,7772.625,470.705438
27A,500,14,751588.46,7468,8484,1016,8015.571429,227.264388
2A,500,14,751588.46,6131,8262,2131,7273.571429,641.6095513
5NE,500,15,805273.35,6815,8301,1486,7515.6,387.2342616
5NW,500,14,751588.46,4597,8918,4321,6167.071429,1166.50531
5SE,500,14,751588.46,2994,8692,5698,7263.571429,1630.312359
6NE,500,15,805273.35,6165,8151,1986,7774.866667,497.1793595
6NW,500,16,858958.24,7183,8345,1162,7742.4375,373.0618194
6SW,500,15,805273.35,6028,8060,2032,7438.733333,526.9472417
Cell 1 2011/12,500,14,751588.46,7723,8029,306,7907.285714,84.46168072
Cell 1 SW 2013,500,14,751588.46,7064,7456,392,7312.5,120.6670449
Cell 10 2011/12,500,16,858958.24,6574,8673,2099,7710.375,565.5658533
Cell 10 NE 2011/12,500,14,751588.46,7614,8070,456,7916.642857,120.1104296
Cell 10 NW 2011/12,500,16,858958.24,7788,8473,685,8234.9375,190.969719
Cell 10 SE 2013,500,16,858958.24,7183,8345,1162,7742.4375,373.0618194
Cell 10 SW 2011/12,500,14,751588.46,6761,8920,2159,7708.5,847.4554982
Cell 10-A 2011/12,500,14,751588.46,6855,8243,1388,7692.928571,489.7994435
Cell 11 NE 2011/12,500,15,805273.35,6377,7512,1135,7005.4,333.4490066
Cell 11 NW 2013,500,14,751588.46,5665,8201,2536,7580.214286,794.5771722
Cell 11 SW 2013,500,14,751588.46,5576,7464,1888,7027.357143,448.9460049
Cell 12 2013,500,15,805273.35,5167,7929,2762,7025.333333,754.8796519
Cell 13 2013,500,14,751588.46,5555,7519,1964,6730.357143,748.1041378
Cell 14 2013,500,14,751588.46,7934,8194,260,8064.071429,96.23888751
Cell 15 2013,500,14,751588.46,7089,8063,974,7714.714286,203.2016692
Cell 15-A 2013,500,14,751588.46,7507,8205,698,7866.357143,159.6727041
Cell 16 2013,500,16,858958.24,7406,8244,838,7867.3125,308.6976107
Cell 17 NW 2011/12,500,15,805273.35,6957,7945,988,7478.466667,264.0403673
Cell 17 NW 2013,500,15,805273.35,1409,7085,5676,5154.2,2039.678478
Cell 17 SE 2013,500,16,858958.24,7788,8473,685,8234.9375,190.969719
Cell 17 SW 2013,500,14,751588.46,7760,8227,467,8000.642857,165.1793861
Cell 18 2011/12,500,15,805273.35,7439,8476,1037,8024.066667,285.3779872
Cell 18 NE 2013,500,14,751588.46,6859,8313,1454,7495.214286,433.613913
Cell 18 NW 2013,500,16,858958.24,5562,8692,3130,7679.875,1010.250642
Cell 18 SE 2013,500,16,858958.24,6377,7512,1135,6972.8125,346.6527836
Cell 18 SSE 2013,500,15,805273.35,6785,7995,1210,7364.533333,350.4722275
Cell 19 NW 2013,500,14,751588.46,6876,8157,1281,7876.428571,358.6679153
Cell 2 2011/12,500,14,751588.46,5890,7918,2028,6926.357143,765.8684713
Cell 2 NE 2013,500,16,858958.24,5135,7707,2572,6831.5,759.1263893
Cell 2 SW 2013,500,14,751588.46,7723,8029,306,7907.285714,84.46168072
Cell 20 2013,500,14,751588.46,7259,7922,663,7667.928571,208.3237399
Cell 21 2013,500,14,751588.46,3295,7936,4641,5705.142857,1144.408447
Cell 22 2013,500,16,858958.24,7059,7892,833,7503.25,332.2776512
Cell 23 2013,500,15,805273.35,8291,8651,360,8421.466667,85.19300962
Cell 24 2013,500,15,805273.35,8148,8375,227,8237.2,68.69371635
Cell 25 NE 2013,500,16,858958.24,6574,8673,2099,7710.375,565.5658533
Cell 25 SE 2013,500,14,751588.46,6761,8920,2159,7708.5,847.4554982
Cell 26 NE 2013,500,15,805273.35,6013,7609,1596,6821.2,561.8491138
Cell 26 NNW 2013,500,14,751588.46,7614,8070,456,7916.642857,120.1104296
Cell 26 NW 2013,500,14,751588.46,6855,8243,1388,7692.928571,489.7994435
Cell 27 NW 2013,500,15,805273.35,7006,8173,1167,7495.066667,337.0456876
Cell 28 2013,500,16,858958.24,6530,8123,1593,7423.3125,400.1179074
Cell 29 2013,500,14,751588.46,5427,7735,2308,6550.071429,657.0107049
Cell 3 NE 2013,500,14,751588.46,4898,8345,3447,7486.5,895.1422672
Cell 3 NW 2013,500,14,751588.46,6302,8307,2005,7628.357143,606.473484
Cell 30 2013,500,15,805273.35,7388,8139,751,7847.6,204.9457814
Cell 31 2013,500,15,805273.35,7383,8417,1034,8082.2,368.5977392
Cell 32 2013,500,16,858958.24,7504,8553,1049,8280.5,254.9872546
Cell 33 NE 2013,500,15,805273.35,6957,7945,988,7478.466667,264.0403673
Cell 33 SE 2013,500,15,805273.35,6038,7701,1663,7261,545.0958326
Cell 33 SW 2013,500,14,751588.46,4129,9332,5203,6781,1740.294638
Cell 34 N 2013,500,14,751588.46,6208,7977,1769,7343.642857,470.8300584
Cell 34 NW 2013,500,14,751588.46,6095,7664,1569,6902,528.3247108
Cell 34 SE 2013,500,14,751588.46,6862,7886,1024,7196.071429,330.7388837
Cell 35 2013,500,15,805273.35,5805,8093,2288,7263.533333,736.1150152
Cell 37 2013,500,15,805273.35,7580,8201,621,7858.666667,195.4341037
Cell 38 2013,500,14,751588.46,7995,8302,307,8166.714286,106.5876089
Cell 39 2013,500,14,751588.46,7812,8651,839,8424.785714,257.4682168
Cell 4 2013,500,16,858958.24,6740,7971,1231,7603.125,353.5134147
Cell 40 NE 2013,500,15,805273.35,3970,9038,5068,7138,1194.324077
Cell 41 N 2013,500,14,751588.46,6842,8692,1850,7580.571429,460.3173927
Cell 41 NW 2013,500,14,751588.46,-498,8277,8775,5294.357143,2780.700107
Cell 42 NW 2013,500,14,751588.46,5493,8047,2554,6993.214286,594.6251134
Cell 43 2013,500,15,805273.35,6518,7520,1002,7098.666667,292.5206925
Cell 44 2013,500,14,751588.46,7393,8293,900,7822.5,266.7159404
Cell 45 2013,500,16,858958.24,7244,7817,573,7601.5,171.2629557
Cell 47 2013,500,14,751588.46,6946,7832,886,7561,271.8983529
Cell 48 2013,500,15,805273.35,6937,8387,1450,7776.6,485.8824
Cell 49 2013,500,15,805273.35,7207,7915,708,7618.866667,226.4128579
Cell 5 2011/12 Summer,500,14,751588.46,7760,8227,467,8000.642857,165.1793861
Cell 5 2013,500,14,751588.46,7448,8494,1046,8181.642857,268.6839905
Cell 50 2013,500,14,751588.46,7630,8026,396,7805.785714,118.8523565
Cell 51 2013,500,16,858958.24,6875,8109,1234,7740.375,326.8860419
Cell 52 2013,500,14,751588.46,7015,8273,1258,7666,418.9411824
Cell 53 2013,500,16,858958.24,6896,7889,993,7528.5,320.2338989
Cell 54 2013,500,14,751588.46,7761,8644,883,8423.571429,244.0201146
Cell 55 2013,500,14,751588.46,7339,8443,1104,7892.714286,282.3641085
Cell 56 2013,500,15,805273.35,7223,7857,634,7434.133333,178.2929674
Cell 57 2013,500,14,751588.46,6965,7835,870,7347,290.6743391
Cell 58 2013,500,15,805273.35,7732,8400,668,8002.733333,221.3863792
Cell 59 2013,500,15,805273.35,6615,7630,1015,7285.066667,305.6565538
Cell 6 2011/12,500,16,858958.24,7073,8233,1160,7638.5,353.2124007
Cell 6 2013,500,16,858958.24,7171,8319,1148,7840.375,427.1695909
Cell 6 NE 2011/12,500,15,805273.35,6165,8151,1986,7774.866667,497.1793595
Cell 6 NW 2011/12,500,16,858958.24,7183,8345,1162,7742.4375,373.0618194
Cell 6 SW 2011/12,500,15,805273.35,6028,8060,2032,7438.733333,526.9472417
Cell 60 2013,500,14,751588.46,6862,7762,900,7207.714286,217.3280695
Cell 61 2013,500,16,858958.24,7542,8199,657,7983.75,182.3741004
Cell 7 2013,500,15,805273.35,7774,8440,666,8186.133333,178.0860716
Cell 9 NW 2013,500,16,858958.24,-322,8119,8441,4144.5625,2816.407818
Cell 9 SE 2013,500,15,805273.35,6815,8301,1486,7515.6,387.2342616
Cell 9 SW 2013,500,13,697903.57,4597,8918,4321,6235.846154,1182.872374
Cell R1,500,13,697903.57,6542,7758,1216,7192.076923,444.477474
Cell R10,500,16,858958.24,6740,7971,1231,7603.125,353.5134147
Cell R100,500,14,751588.46,7630,8026,396,7805.785714,118.8523565
Cell R101,500,15,805273.35,7917,8345,428,8211.4,103.6994375
Cell R104,500,16,858958.24,7716,8218,502,7979.125,146.7263077
Cell R105,500,16,858958.24,6896,7889,993,7528.5,320.2338989
Cell R106,500,15,805273.35,7728,8319,591,7911.933333,169.1289318
Cell R107,500,14,751588.46,7761,8644,883,8423.571429,244.0201146
Cell R11,500,14,751588.46,7448,8494,1046,8181.642857,268.6839905
Cell R111,500,16,858958.24,7326,8161,835,7917.0625,208.4929461
Cell R112,500,14,751588.46,7016,7662,646,7379.071429,143.6137997
Cell R113,500,14,751588.46,6965,7835,870,7347,290.6743391
Cell R114,500,14,751588.46,7732,8400,668,8011.642857,226.5437855
Cell R117,500,15,805273.35,7347,8400,1053,7739.333333,252.8200062
Cell R118,500,15,805273.35,7223,7857,634,7434.133333,178.2929674
Cell R119,500,16,858958.24,6320,7122,802,6782.75,276.9184221
Cell R120,500,13,697903.57,7833,8203,370,8051.153846,98.79726417
Cell R121,500,15,805273.35,6706,7861,1155,7541.666667,309.2029898
Cell R123,500,16,858958.24,7372,7915,543,7533.5625,129.3212902
Cell R124,500,14,751588.46,6512,7762,1250,7245.071429,376.8060252
Cell R125,500,15,805273.35,6984,7987,1003,7376.333333,332.0043507
Cell R126,500,14,751588.46,7542,8065,523,7929.285714,167.8325818
Cell R15,500,14,751588.46,7064,7456,392,7312.5,120.6670449
Cell R16,500,16,858958.24,-322,8119,8441,4144.5625,2816.407818
Cell R17,500,14,751588.46,7112,8070,958,7544.571429,354.4385327
Cell R18,500,16,858958.24,5665,8201,2536,7529,764.1705471
Cell R19,500,15,805273.35,7091,7997,906,7568.6,206.4983616
Cell R20,500,14,751588.46,6631,7551,920,7238.142857,356.2330411
Cell R21,500,14,751588.46,7250,8315,1065,7771.928571,353.065446
Cell R22,500,14,751588.46,7934,8194,260,8064.071429,96.23888751
Cell R24,500,15,805273.35,1409,7085,5676,5154.2,2039.678478
Cell R25,500,15,805273.35,5562,8674,3112,7612.4,1007.869423
Cell R26,500,16,858958.24,7451,8345,894,7849.375,313.3053373
Cell R27,500,15,805273.35,6876,8157,1281,7841.8,369.9384093
Cell R28,500,16,858958.24,4090,8172,4082,6138.5625,1301.820935
Cell R29,500,14,751588.46,7259,7922,663,7667.928571,208.3237399
Cell R30,500,16,858958.24,6693,8282,1589,7673,498.7694858
Cell R31,500,14,751588.46,7791,8275,484,8150.214286,133.2104557
Cell R35,500,14,751588.46,7760,8227,467,8000.642857,165.1793861
Cell R36,500,16,858958.24,7788,8473,685,8234.9375,190.969719
Cell R37,500,15,805273.35,6377,7512,1135,7005.4,333.4490066
Cell R38,500,15,805273.35,7216,8085,869,7610.2,278.6774001
Cell R39,500,15,805273.35,6565,8525,1960,7843.466667,501.9302563
Cell R40,500,14,751588.46,3295,7936,4641,5705.142857,1144.408447
Cell R46,500,14,751588.46,1904,8434,6530,5054.428571,2241.928147
Cell R47,500,14,751588.46,6855,8243,1388,7692.928571,489.7994435
Cell R48,500,15,805273.35,6013,7609,1596,6821.2,561.8491138
Cell R49,500,16,858958.24,6523,8173,1650,7434.3125,402.3255396
Cell R5,500,16,858958.24,-1970,7792,9762,6446.6875,2250.843029
Cell R50,500,16,858958.24,6530,8123,1593,7423.3125,400.1179074
Cell R51,500,14,751588.46,5427,7735,2308,6550.071429,657.0107049
Cell R52,500,14,751588.46,7296,8186,890,7671.357143,265.0489462
Cell R53,500,14,751588.46,6925,8002,1077,7526.857143,298.5636704
Cell R54,500,15,805273.35,7383,8417,1034,8082.2,368.5977392
Cell R58,500,14,751588.46,7182,9620,2438,8285.285714,877.5471846
Cell R59,500,15,805273.35,6957,7945,988,7478.466667,264.0403673
Cell R6,500,14,751588.46,7723,8029,306,7907.285714,84.46168072
Cell R60,500,14,751588.46,6095,7664,1569,6902,528.3247108
Cell R61,500,15,805273.35,5805,8093,2288,7263.533333,736.1150152
Cell R62,500,14,751588.46,5591,7863,2272,6978.142857,509.1077429
Cell R63,500,14,751588.46,6994,8104,1110,7557.785714,335.3231232
Cell R64,500,14,751588.46,7595,7889,294,7731.714286,78.17053571
Cell R65,500,15,805273.35,7388,8139,751,7847.6,204.9457814
Cell R66,500,14,751588.46,7754,8545,791,8132.071429,229.227418
Cell R69,500,14,751588.46,4129,9332,5203,6781,1740.294638
Cell R7,500,14,751588.46,6302,8307,2005,7628.357143,606.473484
Cell R70,500,15,805273.35,6038,7701,1663,7261,545.0958326
Cell R71,500,14,751588.46,6862,7886,1024,7196.071429,330.7388837
Cell R72,500,14,751588.46,2906,9046,6140,7173.285714,1604.244968
Cell R73,500,14,751588.46,6938,8263,1325,7718.714286,421.7057926
Cell R74,500,14,751588.46,5963,7563,1600,7302.857143,390.9278079
Cell R75,500,15,805273.35,7580,8201,621,7858.666667,195.4341037
Cell R76,500,14,751588.46,6807,8727,1920,8291.928571,480.4938626
Cell R77,500,14,751588.46,7995,8302,307,8166.714286,106.5876089
Cell R8,500,14,751588.46,7322,8406,1084,7950.071429,327.5590381
Cell R80,500,15,805273.35,3970,9038,5068,7138,1194.324077
Cell R81,500,15,805273.35,7533,8025,492,7750.4,128.5730921
Cell R82,500,14,751588.46,5493,8047,2554,6993.214286,594.6251134
Cell R83,500,14,751588.46,6755,8490,1735,7868.714286,532.2223526
Cell R84,500,14,751588.46,6099,7994,1895,7192.071429,642.6154665
Cell R85,500,15,805273.35,6518,7520,1002,7098.666667,292.5206925
Cell R86,500,14,751588.46,7083,8004,921,7743.714286,207.6798458
Cell R87,500,16,858958.24,7244,7817,573,7601.5,171.2629557
Cell R9,500,15,805273.35,5341,8158,2817,7127.133333,795.2052034
Cell R90,500,14,751588.46,6946,7832,886,7561,271.8983529
Cell R91,500,15,805273.35,6937,8387,1450,7776.6,485.8824
Cell R92,500,14,751588.46,4635,8405,3770,7100.214286,1041.484873
Cell R93,500,15,805273.35,7207,7915,708,7618.866667,226.4128579
Cell R97,500,14,751588.46,7804,8284,480,8104.142857,145.7212883
Cell R98,500,16,858958.24,7010,7944,934,7523.6875,264.7708251
Cell R99,500,14,751588.46,7015,8273,1258,7666,418.9411824
Cell S102,500,15,805273.35,7229,7982,753,7674.933333,260.4671359
Cell S108,500,14,751588.46,7339,8443,1104,7892.714286,282.3641085
Cell S13,500,14,751588.46,7332,8387,1055,7973.785714,317.730384
Cell S14,500,15,805273.35,7774,8440,666,8186.133333,178.0860716
Cell S2,500,16,858958.24,7171,8319,1148,7840.375,427.1695909
Cell S23,500,14,751588.46,8164,8651,487,8505.571429,135.1997011
Cell S32,500,14,751588.46,7892,8460,568,8362.714286,142.3960416
Cell S33,500,14,751588.46,7507,8205,698,7866.357143,159.6727041
Cell S34,500,15,805273.35,8148,8375,227,8237.2,68.69371635
Cell S41,500,14,751588.46,7615,8404,789,8046.571429,185.948808
Cell S42,500,15,805273.35,8291,8651,360,8421.466667,85.19300962
Cell S44,500,14,751588.46,7769,8166,397,7950.357143,134.0637413
Cell S56,500,15,805273.35,6406,8358,1952,7730.2,608.7655487
Cell S67,500,16,858958.24,7504,8553,1049,8280.5,254.9872546
Cell S78,500,14,751588.46,7812,8651,839,8424.785714,257.4682168
Cell S88,500,16,858958.24,6790,8537,1747,7963.75,518.5221186
Cell S94,500,16,858958.24,7938,8426,488,8137.625,119.5177157
Cell S95,500,16,858958.24,6875,8109,1234,7740.375,326.8860419
W287,500,14,751588.46,4207,7573,3366,6016.142857,1120.28433
W295,500,14,751588.46,4197,7852,3655,6183.357143,1326.723602
W338,500,16,858958.24,3952,7973,4021,6998.4375,990.9867537
W342,500,15,805273.35,4908,7842,2934,6453.933333,937.6745325
W345,500,16,858958.24,7228,7742,514,7524.1875,172.035323
W387,500,15,805273.35,7110,8038,928,7460.666667,300.2478236
W393,500,16,858958.24,6575,8128,1553,7434.4375,338.9216297
W440,500,14,751588.46,6026,7897,1871,7262.285714,519.2616225
W441,500,15,805273.35,7133,7925,792,7637.933333,233.58495
W445,500,16,858958.24,6082,7678,1596,7021.0625,505.7693976
W500,500,14,751588.46,7673,8361,688,7998.714286,181.9436446
1,750,32,1717916.48,7723,8057,334,7909.875,78.30140085
2,750,33,1771601.37,4934,8017,3083,6896.363636,801.5448273
3,750,34,1825286.26,6890,7922,1032,7567.058824,280.166436
4,750,32,1717916.48,6628,7877,1249,7319.125,288.0728803
5,750,33,1771601.37,7104,8339,1235,7947.666667,274.0547022
6,750,33,1771601.37,5797,8233,2436,7689.333333,495.0165389
7,750,33,1771601.37,5167,7929,2762,7147.030303,734.9427718
8,750,34,1825286.26,4433,7519,3086,6541.147059,879.9995031
9,750,34,1825286.26,6954,8283,1329,7857.617647,315.6358675
10,750,32,1717916.48,5400,8673,3273,7561,654.5952948
11,750,32,1717916.48,6013,7844,1831,7114.03125,550.3128363
12,750,32,1717916.48,2420,8123,5703,7128.59375,1029.735854
13,750,32,1717916.48,4876,7947,3071,6720.40625,815.073841
14,750,34,1825286.26,7123,8621,1498,7995.941176,477.4561847
16,750,32,1717916.48,2569,9332,6763,6704.4375,2123.987125
17,750,33,1771601.37,5612,7803,2191,6960.242424,548.2278353
18,750,34,1825286.26,4437,9982,5545,7916.558824,1097.288562
19,750,34,1825286.26,2143,7998,5855,6453.941176,1092.874056
20,750,32,1717916.48,7079,8201,1122,7831.34375,218.2519486
21,750,34,1825286.26,7809,8531,722,8195.970588,184.3731008
22,750,33,1771601.37,-1724,8811,10535,5144.666667,3539.084239
23,750,37,1986340.93,3731,8047,4316,6802.432432,1115.642138
24,750,32,1717916.48,6882,8387,1505,7771.84375,441.4995831
25,750,36,1932656.04,6538,7915,1377,7481.861111,308.8724254
26,750,33,1771601.37,7244,8023,779,7679.515152,202.7632029
27,750,33,1771601.37,7010,8200,1190,7689.757576,337.3797456
28,750,33,1771601.37,6224,7938,1714,7364.787879,467.8505173
29,750,33,1771601.37,7630,8214,584,7900.393939,167.4786173
31,750,33,1771601.37,7259,7860,601,7646.878788,125.8478537
32,750,33,1771601.37,6083,7837,1754,7279.242424,386.6596679
33,750,32,1717916.48,7060,7857,797,7431.625,192.5131083
34,750,34,1825286.26,6612,7564,952,7022.382353,257.0814719
10A,750,32,1717916.48,4753,8243,3490,7412.28125,775.3531951
10NE,750,32,1717916.48,7352,8318,966,7887.8125,228.9985586
10NW,750,32,1717916.48,7778,8704,926,8209.65625,273.3238246
10SW,750,32,1717916.48,3732,8920,5188,7395.15625,1190.684969
11NE,750,35,1878971.15,4009,7662,3653,6818,675.4583629
11NW,750,32,1717916.48,6785,8976,2191,7814.28125,536.6781062
11SE,750,33,1771601.37,6523,8173,1650,7499.121212,368.3275681
17NW,750,33,1771601.37,6851,8007,1156,7554.060606,287.4842751
17SE,750,32,1717916.48,5227,7886,2659,7231.5,492.7106783
17SW,750,32,1717916.48,4685,7768,3083,7190.1875,694.7955382
22S,750,32,1717916.48,-1724,9195,10919,6377,2717.595582
23S,750,32,1717916.48,1722,4985,3263,2698.40625,729.26962
24S,750,32,1717916.48,6937,8387,1450,7823,407.9626208
27A,750,32,1717916.48,6127,8625,2498,7887.40625,498.1724638
2A,750,33,1771601.37,5786,8837,3051,7482.060606,771.1230668
5NE,750,33,1771601.37,4574,8301,3727,7241.363636,829.533305
5NW,750,33,1771601.37,869,8918,8049,6090.848485,1707.871848
5SE,750,32,1717916.48,996,8692,7696,6514.90625,2237.207444
6NE,750,35,1878971.15,6165,8151,1986,7639.314286,543.325673
6NW,750,35,1878971.15,6917,8345,1428,7687.857143,366.0758815
6SW,750,34,1825286.26,6021,8313,2292,7420.441176,578.4343062
Cell 1 2011/12,750,32,1717916.48,7723,8057,334,7909.875,78.30140085
Cell 1 SW 2013,750,32,1717916.48,5371,7458,2087,7075.0625,492.5598909
Cell 10 2011/12,750,32,1717916.48,5400,8673,3273,7561,654.5952948
Cell 10 NE 2011/12,750,32,1717916.48,7352,8318,966,7887.8125,228.9985586
Cell 10 NW 2011/12,750,32,1717916.48,7778,8704,926,8209.65625,273.3238246
Cell 10 SE 2013,750,34,1825286.26,6917,8345,1428,7701.794118,362.1528585
Cell 10 SW 2011/12,750,32,1717916.48,3732,8920,5188,7395.15625,1190.684969
Cell 10-A 2011/12,750,32,1717916.48,4753,8243,3490,7412.28125,775.3531951
Cell 11 NE 2011/12,750,35,1878971.15,4009,7662,3653,6818,675.4583629
Cell 11 NW 2013,750,34,1825286.26,5665,8201,2536,7465.294118,705.3974486
Cell 11 SW 2013,750,33,1771601.37,5576,8130,2554,7074.818182,640.4656192
Cell 12 2013,750,33,1771601.37,5167,7929,2762,7147.030303,734.9427718
Cell 13 2013,750,34,1825286.26,3917,7519,3602,6402.147059,1029.358885
Cell 14 2013,750,32,1717916.48,7934,8516,582,8093.28125,137.1450497
Cell 15 2013,750,33,1771601.37,7089,8121,1032,7708.212121,225.6663879
Cell 15-A 2013,750,33,1771601.37,7277,8208,931,7857.484848,226.8759
Cell 16 2013,750,33,1771601.37,7014,8349,1335,7930.666667,341.4359753
Cell 17 NW 2011/12,750,33,1771601.37,6851,8007,1156,7554.060606,287.4842751
Cell 17 NW 2013,750,35,1878971.15,-1333,7929,9262,5139.6,2348.507735
Cell 17 SE 2013,750,32,1717916.48,7778,8704,926,8209.65625,273.3238246
Cell 17 SW 2013,750,32,1717916.48,7590,8409,819,8005.71875,204.640727
Cell 18 2011/12,750,34,1825286.26,4437,9982,5545,7916.558824,1097.288562
Cell 18 NE 2013,750,32,1717916.48,6028,8463,2435,7461.59375,567.2919145
Cell 18 NW 2013,750,34,1825286.26,996,8692,7696,6520.058824,2095.067203
Cell 18 SE 2013,750,35,1878971.15,4009,7662,3653,6818,675.4583629
Cell 18 SSE 2013,750,33,1771601.37,6785,7995,1210,7458.606061,305.4681394
Cell 19 NW 2013,750,33,1771601.37,6346,8201,1855,7758.424242,480.9463544
Cell 2 2011/12,750,33,1771601.37,4934,8017,3083,6896.363636,801.5448273
Cell 2 NE 2013,750,32,1717916.48,4428,8263,3835,6956.9375,966.3844324
Cell 2 SW 2013,750,32,1717916.48,7723,8057,334,7909.875,78.30140085
Cell 20 2013,750,33,1771601.37,6954,7922,968,7561.151515,240.6050607
Cell 21 2013,750,32,1717916.48,3295,8808,5513,6282.78125,1526.285928
Cell 22 2013,750,34,1825286.26,7010,8059,1049,7562.794118,318.8832332
Cell 23 2013,750,35,1878971.15,7993,8651,658,8417.971429,142.8520685
Cell 24 2013,750,34,1825286.26,7820,8658,838,8244,159.1469909
Cell 25 NE 2013,750,32,1717916.48,5400,8673,3273,7561,654.5952948
Cell 25 SE 2013,750,32,1717916.48,3732,8920,5188,7395.15625,1190.684969
Cell 26 NE 2013,750,32,1717916.48,6013,7844,1831,7114.03125,550.3128363
Cell 26 NNW 2013,750,32,1717916.48,7352,8318,966,7887.8125,228.9985586
Cell 26 NW 2013,750,32,1717916.48,4753,8243,3490,7412.28125,775.3531951
Cell 27 NW 2013,750,33,1771601.37,6523,8173,1650,7499.121212,368.3275681
Cell 28 2013,750,32,1717916.48,2420,8123,5703,7128.59375,1029.735854
Cell 29 2013,750,32,1717916.48,4876,7947,3071,6720.40625,815.073841
Cell 3 NE 2013,750,34,1825286.26,4898,8345,3447,7241.235294,924.8746834
Cell 3 NW 2013,750,32,1717916.48,5920,8337,2417,7388.21875,679.6395062
Cell 30 2013,750,34,1825286.26,7166,8239,1073,7845.676471,252.7949321
Cell 31 2013,750,32,1717916.48,7141,8432,1291,7983.21875,429.6614753
Cell 32 2013,750,33,1771601.37,7504,8553,1049,8227.848485,283.7486213
Cell 33 NE 2013,750,33,1771601.37,6851,8007,1156,7554.060606,287.4842751
Cell 33 SE 2013,750,32,1717916.48,4685,7768,3083,7190.1875,694.7955382
Cell 33 SW 2013,750,33,1771601.37,1342,9332,7990,6220.787879,1922.263703
Cell 34 N 2013,750,33,1771601.37,6208,7977,1769,7296.878788,411.8697027
Cell 34 NW 2013,750,33,1771601.37,5612,7803,2191,6960.242424,548.2278353
Cell 34 SE 2013,750,32,1717916.48,5227,7886,2659,7231.5,492.7106783
Cell 35 2013,750,37,1986340.93,1745,8228,6483,6699.432432,1745.698831
Cell 37 2013,750,33,1771601.37,7079,8201,1122,7822.242424,215.806736
Cell 38 2013,750,32,1717916.48,7995,8680,685,8246.96875,170.7819305
Cell 39 2013,750,33,1771601.37,7488,8651,1163,8332.272727,346.6263618
Cell 4 2013,750,33,1771601.37,6722,7971,1249,7578.212121,370.6185458
Cell 40 NE 2013,750,36,1932656.04,3787,9795,6008,7126.777778,1244.890917
Cell 41 N 2013,750,32,1717916.48,6825,8692,1867,7644.4375,543.3328824
Cell 41 NW 2013,750,32,1717916.48,-498,8351,8849,5437.4375,2752.969362
Cell 42 NW 2013,750,32,1717916.48,2250,8047,5797,6674.21875,1305.842921
Cell 43 2013,750,32,1717916.48,6356,7747,1391,7225.71875,351.1285586
Cell 44 2013,750,32,1717916.48,6871,8369,1498,7823.46875,336.189956
Cell 45 2013,750,33,1771601.37,7244,8023,779,7679.515152,202.7632029
Cell 47 2013,750,34,1825286.26,6946,8064,1118,7653.529412,236.3556935
Cell 48 2013,750,33,1771601.37,6937,8387,1450,7835.212121,407.6302363
Cell 49 2013,750,36,1932656.04,6538,7915,1377,7481.861111,308.8724254
Cell 5 2011/12 Summer,750,32,1717916.48,7590,8409,819,8005.71875,204.640727
Cell 5 2013,750,34,1825286.26,6675,8540,1865,8057.117647,412.5895101
Cell 50 2013,750,33,1771601.37,7630,8214,584,7900.393939,167.4786173
Cell 51 2013,750,32,1717916.48,6731,8124,1393,7666.21875,409.9381611
Cell 52 2013,750,32,1717916.48,7015,8273,1258,7664.125,350.2434644
Cell 53 2013,750,33,1771601.37,6224,7938,1714,7364.787879,467.8505173
Cell 54 2013,750,33,1771601.37,7761,8691,930,8386.212121,236.0664721
Cell 55 2013,750,34,1825286.26,7339,8597,1258,7986.970588,326.0033819
Cell 56 2013,750,32,1717916.48,7060,7857,797,7431.625,192.5131083
Cell 57 2013,750,33,1771601.37,6083,7837,1754,7279.242424,386.6596679
Cell 58 2013,750,34,1825286.26,7635,8617,982,8037.764706,256.9377424
Cell 59 2013,750,35,1878971.15,6615,7747,1132,7352.142857,287.6092729
Cell 6 2011/12,750,33,1771601.37,5797,8233,2436,7689.333333,495.0165389
Cell 6 2013,750,33,1771601.37,7171,8323,1152,7940.515152,332.7025354
Cell 6 NE 2011/12,750,35,1878971.15,6165,8151,1986,7639.314286,543.325673
Cell 6 NW 2011/12,750,35,1878971.15,6917,8345,1428,7687.857143,366.0758815
Cell 6 SW 2011/12,750,34,1825286.26,6021,8313,2292,7420.441176,578.4343062
Cell 60 2013,750,32,1717916.48,6589,7762,1173,7132.71875,299.5778524
Cell 61 2013,750,33,1771601.37,7268,8352,1084,7937.787879,232.2373078
Cell 7 2013,750,32,1717916.48,7774,8494,720,8181.375,194.2427203
Cell 9 NW 2013,750,33,1771601.37,-736,8506,9242,3851,3157.424891
Cell 9 SE 2013,750,33,1771601.37,4574,8301,3727,7241.363636,829.533305
Cell 9 SW 2013,750,33,1771601.37,869,8918,8049,6090.848485,1707.871848
Cell R1,750,37,1986340.93,6263,7758,1495,7116.432432,442.3224665
Cell R10,750,33,1771601.37,6722,7971,1249,7578.212121,370.6185458
Cell R100,750,33,1771601.37,7630,8214,584,7900.393939,167.4786173
Cell R101,750,33,1771601.37,7859,8404,545,8179.272727,142.3108575
Cell R104,750,32,1717916.48,7716,8218,502,7953.5,129.2872287
Cell R105,750,33,1771601.37,6224,7938,1714,7364.787879,467.8505173
Cell R106,750,33,1771601.37,6494,8319,1825,7786.787879,332.1648694
Cell R107,750,33,1771601.37,7761,8691,930,8386.212121,236.0664721
Cell R11,750,34,1825286.26,6675,8540,1865,8057.117647,412.5895101
Cell R111,750,32,1717916.48,7326,8335,1009,7914.6875,214.4196291
Cell R112,750,34,1825286.26,6955,8378,1423,7395.911765,252.9153971
Cell R113,750,33,1771601.37,6083,7837,1754,7279.242424,386.6596679
Cell R114,750,34,1825286.26,7635,8617,982,8037.764706,256.9377424
Cell R117,750,34,1825286.26,7086,8688,1602,7692.264706,409.0277791
Cell R118,750,32,1717916.48,7060,7857,797,7431.625,192.5131083
Cell R119,750,32,1717916.48,6320,7310,990,6760.90625,285.8493221
Cell R120,750,37,1986340.93,7538,8205,667,7979.567568,164.6482804
Cell R121,750,34,1825286.26,6706,8286,1580,7626,361.0403269
Cell R123,750,33,1771601.37,7312,7915,603,7534,143.7841396
Cell R124,750,32,1717916.48,6512,7972,1460,7244.34375,340.368698
Cell R125,750,32,1717916.48,6957,7987,1030,7420.84375,283.750783
Cell R126,750,32,1717916.48,6736,8395,1659,7817.6875,362.2785908
Cell R15,750,32,1717916.48,5371,7458,2087,7075.0625,492.5598909
Cell R16,750,34,1825286.26,-736,8506,9242,3883.441176,3060.358516
Cell R17,750,33,1771601.37,5229,8070,2841,7176.484848,785.4504641
Cell R18,750,32,1717916.48,5665,8201,2536,7446.25,722.8548437
Cell R19,750,34,1825286.26,7082,7997,915,7578.941176,250.7340918
Cell R20,750,35,1878971.15,5855,7551,1696,7119.628571,398.192996
Cell R21,750,34,1825286.26,7182,8521,1339,7906.941176,393.5312934
Cell R22,750,32,1717916.48,7934,8516,582,8093.28125,137.1450497
Cell R24,750,35,1878971.15,-1333,7929,9262,5139.6,2348.507735
Cell R25,750,34,1825286.26,996,8692,7696,6520.058824,2095.067203
Cell R26,750,32,1717916.48,7133,8345,1212,7705.8125,356.8543503
Cell R27,750,33,1771601.37,6346,8201,1855,7758.424242,480.9463544
Cell R28,750,33,1771601.37,3975,8348,4373,6543.636364,1347.627181
Cell R29,750,33,1771601.37,6954,7922,968,7561.151515,240.6050607
Cell R30,750,33,1771601.37,6693,8294,1601,7681.272727,434.1891274
Cell R31,750,32,1717916.48,6275,8486,2211,8068.75,403.2434903
Cell R35,750,32,1717916.48,7590,8409,819,8005.71875,204.640727
Cell R36,750,32,1717916.48,7778,8704,926,8209.65625,273.3238246
Cell R37,750,35,1878971.15,4009,7662,3653,6818,675.4583629
Cell R38,750,32,1717916.48,7209,8085,876,7605.28125,254.6186161
Cell R39,750,33,1771601.37,4433,8525,4092,7686.787879,809.5734664
Cell R40,750,33,1771601.37,3295,8808,5513,6335.545455,1532.333615
Cell R46,750,32,1717916.48,1904,8434,6530,4696.84375,2143.292387
Cell R47,750,32,1717916.48,4753,8243,3490,7412.28125,775.3531951
Cell R48,750,32,1717916.48,6013,7844,1831,7114.03125,550.3128363
Cell R49,750,33,1771601.37,6523,8173,1650,7499.121212,368.3275681
Cell R5,750,35,1878971.15,-1970,7792,9762,6620.228571,1716.824678
Cell R50,750,32,1717916.48,2420,8123,5703,7128.59375,1029.735854
Cell R51,750,32,1717916.48,4876,7947,3071,6720.40625,815.073841
Cell R52,750,32,1717916.48,7035,8186,1151,7560.75,269.2921276
Cell R53,750,34,1825286.26,6925,8002,1077,7560.647059,271.4743929
Cell R54,750,32,1717916.48,7141,8432,1291,7983.21875,429.6614753
Cell R58,750,33,1771601.37,5491,9901,4410,8092.030303,1223.755211
Cell R59,750,33,1771601.37,6851,8007,1156,7554.060606,287.4842751
Cell R6,750,32,1717916.48,7723,8057,334,7909.875,78.30140085
Cell R60,750,33,1771601.37,5612,7803,2191,6960.242424,548.2278353
Cell R61,750,37,1986340.93,1745,8228,6483,6699.432432,1745.698831
Cell R62,750,33,1771601.37,2143,8266,6123,6623.818182,1129.807075
Cell R63,750,34,1825286.26,6994,8104,1110,7541.529412,299.7134156
Cell R64,750,34,1825286.26,7429,7908,479,7698.823529,114.7986653
Cell R65,750,34,1825286.26,7166,8239,1073,7845.676471,252.7949321
Cell R66,750,32,1717916.48,7754,8634,880,8240.125,249.4696562
Cell R69,750,33,1771601.37,1342,9332,7990,6220.787879,1922.263703
Cell R7,750,32,1717916.48,5920,8337,2417,7388.21875,679.6395062
Cell R70,750,32,1717916.48,4685,7768,3083,7190.1875,694.7955382
Cell R71,750,33,1771601.37,5227,7886,2659,7238.181818,486.6580191
Cell R72,750,34,1825286.26,2596,9046,6450,6223.117647,2048.97347
Cell R73,750,32,1717916.48,6892,8263,1371,7795.96875,407.4772604
Cell R74,750,33,1771601.37,5343,7563,2220,7149.666667,557.5580778
Cell R75,750,33,1771601.37,7079,8201,1122,7822.242424,215.806736
Cell R76,750,32,1717916.48,6807,8727,1920,8273.8125,448.9462967
Cell R77,750,32,1717916.48,7995,8680,685,8246.96875,170.7819305
Cell R8,750,34,1825286.26,5164,8406,3242,7734.352941,698.4603607
Cell R80,750,35,1878971.15,3787,9795,6008,7175.542857,1228.178683
Cell R81,750,33,1771601.37,7533,8148,615,7794.454545,155.451462
Cell R82,750,32,1717916.48,2250,8047,5797,6674.21875,1305.842921
Cell R83,750,32,1717916.48,4272,8490,4218,7667.25,795.127309
Cell R84,750,33,1771601.37,3677,7994,4317,6571.606061,1206.778932
Cell R85,750,32,1717916.48,6356,7747,1391,7225.71875,351.1285586
Cell R86,750,33,1771601.37,6961,8004,1043,7667.454545,239.6546873
Cell R87,750,33,1771601.37,7244,8023,779,7679.515152,202.7632029
Cell R9,750,35,1878971.15,5341,8158,2817,7328.8,645.1901071
Cell R90,750,33,1771601.37,6946,8064,1118,7644.606061,234.199855
Cell R91,750,33,1771601.37,6937,8387,1450,7835.212121,407.6302363
Cell R92,750,32,1717916.48,1403,8690,7287,6133.625,2383.280719
Cell R93,750,37,1986340.93,6538,7915,1377,7477.135135,305.9865888
Cell R97,750,32,1717916.48,7694,8337,643,8081.15625,157.0149494
Cell R98,750,33,1771601.37,7010,8200,1190,7689.757576,337.3797456
Cell R99,750,33,1771601.37,7015,8273,1258,7669.181818,346.0801671
Cell S102,750,32,1717916.48,7060,8257,1197,7663.3125,303.5129154
Cell S108,750,34,1825286.26,7339,8597,1258,7986.970588,326.0033819
Cell S13,750,33,1771601.37,7295,8387,1092,7936.30303,334.349616
Cell S14,750,32,1717916.48,7774,8494,720,8181.375,194.2427203
Cell S2,750,33,1771601.37,7171,8323,1152,7940.515152,332.7025354
Cell S23,750,34,1825286.26,8164,8753,589,8558.352941,136.6478691
Cell S32,750,33,1771601.37,7754,8473,719,8256.757576,215.2237779
Cell S33,750,33,1771601.37,7277,8208,931,7857.484848,226.8759
Cell S34,750,34,1825286.26,7820,8658,838,8244,159.1469909
Cell S41,750,34,1825286.26,7064,8404,1340,7898.823529,302.3175649
Cell S42,750,35,1878971.15,7993,8651,658,8417.971429,142.8520685
Cell S44,750,32,1717916.48,7453,8315,862,7945.3125,215.6829904
Cell S56,750,33,1771601.37,6406,8358,1952,7696.848485,558.8450819
Cell S67,750,33,1771601.37,7504,8553,1049,8227.848485,283.7486213
Cell S78,750,33,1771601.37,7488,8651,1163,8332.272727,346.6263618
Cell S88,750,33,1771601.37,6399,8537,2138,7900.787879,625.6826457
Cell S94,750,33,1771601.37,7853,8460,607,8128.848485,166.2623194
Cell S95,750,32,1717916.48,6731,8124,1393,7666.21875,409.9381611
W287,750,32,1717916.48,3305,7573,4268,5801.125,1134.139645
W295,750,33,1771601.37,4197,7852,3655,6692.636364,1276.212835
W338,750,34,1825286.26,2672,7973,5301,6554.882353,1590.257892
W342,750,35,1878971.15,4821,7842,3021,6582.857143,869.9877222
W345,750,33,1771601.37,7183,7742,559,7497.454545,161.3400495
W387,750,33,1771601.37,5997,8038,2041,7329.606061,463.2782356
W393,750,34,1825286.26,6575,8170,1595,7452.970588,437.5264352
W440,750,32,1717916.48,3019,7897,4878,6878,970.5903809
W441,750,34,1825286.26,7133,8537,1404,7652.705882,245.5886721
W445,750,35,1878971.15,6005,7678,1673,7110.628571,446.8856093
W500,750,33,1771601.37,4853,8361,3508,7718.090909,709.1118373
1,1000,60,3221093.4,7691,8057,366,7899.183333,83.6178792
2,1000,60,3221093.4,3595,8174,4579,6815.316667,1075.562357
3,1000,58,3113723.62,6890,7922,1032,7563.741379,255.815165
4,1000,58,3113723.62,5855,7877,2022,7304.965517,370.6712441
5,1000,58,3113723.62,6911,8409,1498,7926.982759,371.466548
6,1000,59,3167408.51,5797,8274,2477,7699.237288,546.9162964
7,1000,60,3221093.4,5167,7988,2821,7231.35,654.0749403
8,1000,58,3113723.62,3953,7519,3566,6408.568966,967.4288909
9,1000,58,3113723.62,6954,8283,1329,7806.086207,319.1318658
10,1000,59,3167408.51,3494,8673,5179,7420.20339,980.7283834
11,1000,57,3060038.73,6013,8899,2886,7257.964912,564.9578455
12,1000,58,3113723.62,1929,8123,6194,6688.5,1661.58925
13,1000,58,3113723.62,4876,7962,3086,7015.706897,817.6166585
14,1000,58,3113723.62,6896,8634,1738,7953.034483,525.9681702
16,1000,57,3060038.73,1342,9332,7990,5977.105263,2253.001933
17,1000,58,3113723.62,5065,8181,3116,7094.793103,696.8561609
18,1000,62,3328463.18,1715,9982,8267,7276.951613,1857.307655
19,1000,60,3221093.4,2143,8266,6123,6037.716667,1461.99584
20,1000,58,3113723.62,7079,8201,1122,7820.275862,183.5033395
21,1000,59,3167408.51,7736,8680,944,8221.525424,231.0290433
22,1000,60,3221093.4,-1724,9195,10919,5304.983333,3543.371998
23,1000,61,3274778.29,2036,8334,6298,6361.934426,1587.559741
24,1000,58,3113723.62,6882,8387,1505,7847.586207,378.7892251
25,1000,61,3274778.29,6538,7915,1377,7386.508197,315.5614628
26,1000,60,3221093.4,7244,8113,869,7723.433333,205.0839963
27,1000,58,3113723.62,7003,8200,1197,7726.051724,327.0279131
28,1000,59,3167408.51,6224,8057,1833,7279.983051,500.4712861
29,1000,59,3167408.51,7146,8214,1068,7866.186441,199.1026032
31,1000,59,3167408.51,7259,8058,799,7659.169492,172.9137291
32,1000,60,3221093.4,6083,7890,1807,7310.25,396.4525035
33,1000,57,3060038.73,6800,7857,1057,7392.596491,207.7522867
34,1000,62,3328463.18,6398,7764,1366,7053.645161,282.1103134
10A,1000,56,3006353.84,2935,8243,5308,7371.017857,1027.837735
10NE,1000,58,3113723.62,6547,8318,1771,7783.586207,386.905452
10NW,1000,59,3167408.51,6555,8704,2149,8164.118644,348.6294271
10SW,1000,56,3006353.84,3509,8920,5411,7235.107143,1453.379764
11NE,1000,61,3274778.29,3623,7721,4098,6642.081967,899.4523524
11NW,1000,58,3113723.62,6749,8976,2227,7760.62069,526.660652
11SE,1000,60,3221093.4,6523,8345,1822,7528.766667,375.3965622
17NW,1000,60,3221093.4,6695,8423,1728,7647.533333,358.5431386
17SE,1000,59,3167408.51,4104,7886,3782,7086.610169,841.3910801
17SW,1000,57,3060038.73,4561,7781,3220,7094.754386,721.170206
22S,1000,59,3167408.51,-1724,9195,10919,5827.305085,2871.509219
23S,1000,58,3113723.62,1722,6463,4741,2834.655172,941.8356902
24S,1000,59,3167408.51,6882,8387,1505,7846.169492,379.6518098
27A,1000,58,3113723.62,4659,8980,4321,7608.637931,818.0350447
2A,1000,58,3113723.62,4134,8837,4703,7384.948276,872.6707801
5NE,1000,58,3113723.62,-1842,8301,10143,6750.982759,2135.476588
5NW,1000,61,3274778.29,-937,8918,9855,5659.590164,1950.754788
5SE,1000,56,3006353.84,925,8692,7767,5512.339286,2556.885328
6NE,1000,60,3221093.4,6165,8201,2036,7637.816667,498.3391914
6NW,1000,60,3221093.4,6368,8345,1977,7652.2,422.1565981
6SW,1000,59,3167408.51,4717,8463,3746,7375.745763,736.6682806
Cell 1 2011/12,1000,60,3221093.4,7691,8057,366,7899.183333,83.6178792
Cell 1 SW 2013,1000,57,3060038.73,2812,7549,4737,6875.245614,904.1480488
Cell 10 2011/12,1000,59,3167408.51,3494,8673,5179,7420.20339,980.7283834
Cell 10 NE 2011/12,1000,58,3113723.62,6547,8318,1771,7783.586207,386.905452
Cell 10 NW 2011/12,1000,59,3167408.51,6555,8704,2149,8164.118644,348.6294271
Cell 10 SE 2013,1000,60,3221093.4,6368,8345,1977,7652.2,422.1565981
Cell 10 SW 2011/12,1000,56,3006353.84,3509,8920,5411,7235.107143,1453.379764
Cell 10-A 2011/12,1000,56,3006353.84,2935,8243,5308,7371.017857,1027.837735
Cell 11 NE 2011/12,1000,61,3274778.29,3623,7721,4098,6642.081967,899.4523524
Cell 11 NW 2013,1000,58,3113723.62,5665,8220,2555,7356.810345,704.3060281
Cell 11 SW 2013,1000,58,3113723.62,5576,8211,2635,7203.155172,699.4557934
Cell 12 2013,1000,60,3221093.4,5167,7988,2821,7231.35,654.0749403
Cell 13 2013,1000,58,3113723.62,3917,7519,3602,6349.068966,1136.756834
Cell 14 2013,1000,58,3113723.62,7749,8610,861,8105.241379,171.362422
Cell 15 2013,1000,60,3221093.4,6900,8121,1221,7666.516667,238.7055014
Cell 15-A 2013,1000,58,3113723.62,6913,8556,1643,7781.603448,332.1947362
Cell 16 2013,1000,59,3167408.51,7014,8737,1723,8055.101695,358.0558471
Cell 17 NW 2011/12,1000,60,3221093.4,6695,8423,1728,7647.533333,358.5431386
Cell 17 NW 2013,1000,59,3167408.51,-1333,7929,9262,5252.305085,2550.685526
Cell 17 SE 2013,1000,59,3167408.51,6555,8704,2149,8164.118644,348.6294271
Cell 17 SW 2013,1000,58,3113723.62,6911,8409,1498,7953.103448,350.9062499
Cell 18 2011/12,1000,62,3328463.18,1715,9982,8267,7276.951613,1857.307655
Cell 18 NE 2013,1000,58,3113723.62,3560,8463,4903,7281.431034,871.5577634
Cell 18 NW 2013,1000,62,3328463.18,925,8692,7767,5514.467742,2423.230114
Cell 18 SE 2013,1000,60,3221093.4,3623,7721,4098,6636.466667,905.8557734
Cell 18 SSE 2013,1000,60,3221093.4,6662,8699,2037,7546.383333,466.4964127
Cell 19 NW 2013,1000,59,3167408.51,6346,8201,1855,7794.237288,431.2427583
Cell 2 2011/12,1000,60,3221093.4,3595,8174,4579,6815.316667,1075.562357
Cell 2 NE 2013,1000,60,3221093.4,4428,8383,3955,7044.616667,1003.510058
Cell 2 SW 2013,1000,59,3167408.51,7691,8057,366,7899.271186,84.32078187
Cell 20 2013,1000,58,3113723.62,6930,8183,1253,7499.724138,272.8683397
Cell 21 2013,1000,58,3113723.62,3295,8808,5513,6645.913793,1482.062499
Cell 22 2013,1000,59,3167408.51,6954,8063,1109,7574.118644,327.1011912
Cell 23 2013,1000,60,3221093.4,7993,8761,768,8443.616667,137.2484477
Cell 24 2013,1000,60,3221093.4,7734,8658,924,8239.1,194.1409024
Cell 25 NE 2013,1000,59,3167408.51,3494,8673,5179,7420.20339,980.7283834
Cell 25 SE 2013,1000,56,3006353.84,3509,8920,5411,7235.107143,1453.379764
Cell 26 NE 2013,1000,57,3060038.73,6013,8899,2886,7257.964912,564.9578455
Cell 26 NNW 2013,1000,58,3113723.62,6547,8318,1771,7783.586207,386.905452
Cell 26 NW 2013,1000,56,3006353.84,2935,8243,5308,7371.017857,1027.837735
Cell 27 NW 2013,1000,60,3221093.4,6523,8345,1822,7528.766667,375.3965622
Cell 28 2013,1000,58,3113723.62,1929,8123,6194,6688.5,1661.58925
Cell 29 2013,1000,58,3113723.62,4876,7962,3086,7015.706897,817.6166585
Cell 3 NE 2013,1000,58,3113723.62,382,8345,7963,7094.396552,1340.729188
Cell 3 NW 2013,1000,60,3221093.4,5920,8337,2417,7264.75,715.3845731
Cell 30 2013,1000,62,3328463.18,7166,8239,1073,7880.951613,219.6809584
Cell 31 2013,1000,57,3060038.73,7141,8626,1485,8085.964912,410.8957252
Cell 32 2013,1000,59,3167408.51,7174,8588,1414,8176.423729,337.4294755
Cell 33 NE 2013,1000,60,3221093.4,6695,8423,1728,7647.533333,358.5431386
Cell 33 SE 2013,1000,58,3113723.62,4561,7781,3220,7101.827586,716.9178315
Cell 33 SW 2013,1000,58,3113723.62,1342,9332,7990,5887.913793,2110.303796
Cell 34 N 2013,1000,58,3113723.62,6208,8038,1830,7384.534483,354.5179445
Cell 34 NW 2013,1000,58,3113723.62,5065,8181,3116,7094.793103,696.8561609
Cell 34 SE 2013,1000,59,3167408.51,4104,7886,3782,7149.542373,749.8275129
Cell 35 2013,1000,61,3274778.29,1722,9879,8157,6699.803279,1960.117911
Cell 37 2013,1000,60,3221093.4,7079,8201,1122,7823.75,182.7461468
Cell 38 2013,1000,56,3006353.84,7736,8680,944,8243.375,219.2278302
Cell 39 2013,1000,58,3113723.62,7073,8651,1578,8333.275862,349.465345
Cell 4 2013,1000,59,3167408.51,6689,7971,1282,7532.508475,381.5203472
Cell 40 NE 2013,1000,61,3274778.29,-359,9795,10154,6615.327869,1740.549308
Cell 41 N 2013,1000,57,3060038.73,6129,8692,2563,7553.508772,528.1013699
Cell 41 NW 2013,1000,60,3221093.4,-1538,8839,10377,5699.583333,2795.023824
Cell 42 NW 2013,1000,56,3006353.84,1480,8058,6578,6070.696429,1884.805711
Cell 43 2013,1000,57,3060038.73,5687,8179,2492,7288.122807,425.9299452
Cell 44 2013,1000,56,3006353.84,6871,8369,1498,7810.178571,342.6889003
Cell 45 2013,1000,59,3167408.51,7244,8113,869,7726.474576,205.4686545
Cell 47 2013,1000,58,3113723.62,6946,8064,1118,7601.396552,272.7214658
Cell 48 2013,1000,59,3167408.51,6882,8387,1505,7846.169492,379.6518098
Cell 49 2013,1000,61,3274778.29,6538,7915,1377,7386.508197,315.5614628
Cell 5 2011/12 Summer,1000,58,3113723.62,6911,8409,1498,7953.103448,350.9062499
Cell 5 2013,1000,58,3113723.62,6054,8540,2486,8005.189655,507.1933066
Cell 50 2013,1000,60,3221093.4,7146,8214,1068,7859.816667,203.4084964
Cell 51 2013,1000,59,3167408.51,6731,8378,1647,7672.423729,459.4851283
Cell 52 2013,1000,58,3113723.62,7015,8273,1258,7630.551724,302.0971625
Cell 53 2013,1000,58,3113723.62,6224,8057,1833,7277.706897,504.46438
Cell 54 2013,1000,60,3221093.4,7761,8752,991,8389.433333,227.0793082
Cell 55 2013,1000,58,3113723.62,7339,8792,1453,8055.568966,378.730325
Cell 56 2013,1000,57,3060038.73,6800,7857,1057,7394.719298,210.1887
Cell 57 2013,1000,60,3221093.4,6083,7890,1807,7310.25,396.4525035
Cell 58 2013,1000,58,3113723.62,7634,8699,1065,8067.155172,274.0281764
Cell 59 2013,1000,62,3328463.18,6615,7747,1132,7382.209677,253.4600647
Cell 6 2011/12,1000,59,3167408.51,5797,8274,2477,7699.237288,546.9162964
Cell 6 2013,1000,59,3167408.51,7171,8466,1295,7939.915254,355.553247
Cell 6 NE 2011/12,1000,60,3221093.4,6165,8201,2036,7637.816667,498.3391914
Cell 6 NW 2011/12,1000,60,3221093.4,6368,8345,1977,7652.2,422.1565981
Cell 6 SW 2011/12,1000,59,3167408.51,4717,8463,3746,7375.745763,736.6682806
Cell 60 2013,1000,57,3060038.73,6512,7764,1252,7106.22807,295.6541375
Cell 61 2013,1000,59,3167408.51,7175,8352,1177,7855.644068,267.9553316
Cell 7 2013,1000,58,3113723.62,6501,8611,2110,8168.068966,318.9689674
Cell 9 NW 2013,1000,60,3221093.4,-736,9468,10204,4722.716667,3115.538771
Cell 9 SE 2013,1000,58,3113723.62,-1842,8301,10143,6750.982759,2135.476588
Cell 9 SW 2013,1000,61,3274778.29,-937,8918,9855,5659.590164,1950.754788
Cell R1,1000,61,3274778.29,6196,7905,1709,7151.491803,448.7948388
Cell R10,1000,59,3167408.51,6689,7971,1282,7532.508475,381.5203472
Cell R100,1000,60,3221093.4,7146,8214,1068,7859.816667,203.4084964
Cell R101,1000,59,3167408.51,7536,8404,868,8176.728814,166.0135619
Cell R104,1000,60,3221093.4,7655,8218,563,7920.083333,131.1893405
Cell R105,1000,59,3167408.51,6224,8057,1833,7279.983051,500.4712861
Cell R106,1000,61,3274778.29,6494,8367,1873,7686.721311,450.0207329
Cell R107,1000,60,3221093.4,7761,8752,991,8389.433333,227.0793082
Cell R11,1000,58,3113723.62,6054,8540,2486,8005.189655,507.1933066
Cell R111,1000,60,3221093.4,7326,8457,1131,7899.116667,214.8629091
Cell R112,1000,58,3113723.62,6780,8378,1598,7402.689655,264.470858
Cell R113,1000,60,3221093.4,6083,7890,1807,7310.25,396.4525035
Cell R114,1000,58,3113723.62,7634,8699,1065,8067.155172,274.0281764
Cell R117,1000,62,3328463.18,6987,8688,1701,7668.419355,435.6735071
Cell R118,1000,57,3060038.73,6800,7857,1057,7394.719298,210.1887
Cell R119,1000,59,3167408.51,6170,7386,1216,6798.220339,305.7265904
Cell R120,1000,61,3274778.29,6174,8226,2052,7908.52459,307.785885
Cell R121,1000,58,3113723.62,6706,8389,1683,7768.741379,379.8284804
Cell R123,1000,58,3113723.62,7312,7915,603,7535.844828,149.4400816
Cell R124,1000,58,3113723.62,6512,8041,1529,7300.758621,349.3343577
Cell R125,1000,57,3060038.73,4010,7987,3977,7342.701754,528.0815648
Cell R126,1000,59,3167408.51,6334,8395,2061,7791.254237,419.4405715
Cell R15,1000,56,3006353.84,2812,7549,4737,6873.160714,912.0492581
Cell R16,1000,59,3167408.51,-736,9468,10204,4673.389831,3118.511178
Cell R17,1000,60,3221093.4,5229,8400,3171,7239.383333,766.1184002
Cell R18,1000,60,3221093.4,5665,8220,2555,7382.1,687.3419746
Cell R19,1000,61,3274778.29,6856,7997,1141,7587.442623,246.8921929
Cell R20,1000,58,3113723.62,4285,7790,3505,6936.827586,758.8116421
Cell R21,1000,58,3113723.62,6858,8521,1663,7971.206897,400.9864027
Cell R22,1000,58,3113723.62,7749,8610,861,8105.241379,171.362422
Cell R24,1000,59,3167408.51,-1333,7929,9262,5252.305085,2550.685526
Cell R25,1000,62,3328463.18,925,8692,7767,5514.467742,2423.230114
Cell R26,1000,60,3221093.4,6237,8345,2108,7696.933333,407.3865841
Cell R27,1000,59,3167408.51,6346,8201,1855,7794.237288,431.2427583
Cell R28,1000,58,3113723.62,3975,8348,4373,6509.982759,1291.42416
Cell R29,1000,58,3113723.62,6930,8183,1253,7499.724138,272.8683397
Cell R30,1000,59,3167408.51,6377,8294,1917,7646.711864,438.1963824
Cell R31,1000,56,3006353.84,5511,8486,2975,7966.339286,553.2348467
Cell R35,1000,58,3113723.62,6911,8409,1498,7953.103448,350.9062499
Cell R36,1000,59,3167408.51,6555,8704,2149,8164.118644,348.6294271
Cell R37,1000,60,3221093.4,3623,7721,4098,6636.466667,905.8557734
Cell R38,1000,57,3060038.73,7209,8085,876,7636.368421,234.346769
Cell R39,1000,60,3221093.4,4433,8525,4092,7483.95,904.2440567
Cell R40,1000,58,3113723.62,3295,8808,5513,6645.913793,1482.062499
Cell R46,1000,56,3006353.84,800,9056,8256,4484,2283.069699
Cell R47,1000,56,3006353.84,2935,8243,5308,7371.017857,1027.837735
Cell R48,1000,57,3060038.73,6013,8899,2886,7257.964912,564.9578455
Cell R49,1000,60,3221093.4,6523,8345,1822,7528.766667,375.3965622
Cell R5,1000,60,3221093.4,-1970,7792,9762,6347.766667,1820.94711
Cell R50,1000,60,3221093.4,1929,8123,6194,6717.233333,1640.974023
Cell R51,1000,58,3113723.62,4876,7962,3086,7015.706897,817.6166585
Cell R52,1000,59,3167408.51,6725,8186,1461,7479.355932,331.2955444
Cell R53,1000,58,3113723.62,5473,8035,2562,7562.051724,375.8480719
Cell R54,1000,57,3060038.73,7141,8626,1485,8085.964912,410.8957252
Cell R58,1000,59,3167408.51,5491,9901,4410,7910.067797,1350.92173
Cell R59,1000,60,3221093.4,6695,8423,1728,7647.533333,358.5431386
Cell R6,1000,60,3221093.4,7691,8057,366,7899.183333,83.6178792
Cell R60,1000,58,3113723.62,5065,8181,3116,7094.793103,696.8561609
Cell R61,1000,61,3274778.29,1722,9879,8157,6699.803279,1960.117911
Cell R62,1000,60,3221093.4,2143,8266,6123,6196.166667,1478.580785
Cell R63,1000,58,3113723.62,6994,8104,1110,7546.482759,270.1142314
Cell R64,1000,58,3113723.62,7416,7962,546,7703.034483,143.9726944
Cell R65,1000,62,3328463.18,7166,8239,1073,7880.951613,219.6809584
Cell R66,1000,57,3060038.73,7754,8798,1044,8341.77193,268.2321603
Cell R69,1000,58,3113723.62,1342,9332,7990,5887.913793,2110.303796
Cell R7,1000,60,3221093.4,5920,8337,2417,7264.75,715.3845731
Cell R70,1000,58,3113723.62,4561,7781,3220,7101.827586,716.9178315
Cell R71,1000,59,3167408.51,4104,7886,3782,7149.542373,749.8275129
Cell R72,1000,58,3113723.62,1651,9046,7395,5394.362069,2297.042834
Cell R73,1000,56,3006353.84,6892,8269,1377,7840.892857,344.4107638
Cell R74,1000,59,3167408.51,5195,7738,2543,7110.033898,643.928277
Cell R75,1000,60,3221093.4,7079,8201,1122,7823.75,182.7461468
Cell R76,1000,56,3006353.84,6807,8790,1983,8253.892857,440.7548994
Cell R77,1000,56,3006353.84,7736,8680,944,8243.375,219.2278302
Cell R8,1000,58,3113723.62,382,8612,8230,7491.413793,1381.063846
Cell R80,1000,61,3274778.29,-359,9795,10154,6615.327869,1740.549308
Cell R81,1000,60,3221093.4,7528,8149,621,7802.316667,169.3691719
Cell R82,1000,56,3006353.84,1480,8058,6578,6070.696429,1884.805711
Cell R83,1000,58,3113723.62,3849,8490,4641,7430.051724,1069.40324
Cell R84,1000,59,3167408.51,1845,8687,6842,6003.033898,1813.197522
Cell R85,1000,57,3060038.73,5687,8179,2492,7288.122807,425.9299452
Cell R86,1000,59,3167408.51,6961,8004,1043,7593.372881,260.7422195
Cell R87,1000,59,3167408.51,7244,8113,869,7726.474576,205.4686545
Cell R9,1000,60,3221093.4,5341,8436,3095,7403.716667,582.7171438
Cell R90,1000,58,3113723.62,6946,8064,1118,7601.396552,272.7214658
Cell R91,1000,59,3167408.51,6882,8387,1505,7846.169492,379.6518098
Cell R92,1000,58,3113723.62,1345,8690,7345,5605.017241,2423.163503
Cell R93,1000,61,3274778.29,6538,7915,1377,7386.508197,315.5614628
Cell R97,1000,57,3060038.73,7369,8847,1478,8103.22807,317.521709
Cell R98,1000,58,3113723.62,7003,8200,1197,7726.051724,327.0279131
Cell R99,1000,58,3113723.62,7015,8273,1258,7630.551724,302.0971625
Cell S102,1000,60,3221093.4,7060,8560,1500,7809.533333,357.3647747
Cell S108,1000,58,3113723.62,7339,8792,1453,8055.568966,378.730325
Cell S13,1000,58,3113723.62,7295,8764,1469,8024.724138,325.7237984
Cell S14,1000,58,3113723.62,6501,8611,2110,8168.068966,318.9689674
Cell S2,1000,59,3167408.51,7171,8466,1295,7939.915254,355.553247
Cell S23,1000,58,3113723.62,8029,8753,724,8527.741379,157.8260239
Cell S32,1000,58,3113723.62,7734,8473,739,8202.689655,212.2551496
Cell S33,1000,58,3113723.62,6913,8556,1643,7781.603448,332.1947362
Cell S34,1000,60,3221093.4,7734,8658,924,8239.1,194.1409024
Cell S41,1000,58,3113723.62,7064,8404,1340,7847.275862,328.8664331
Cell S42,1000,60,3221093.4,7993,8761,768,8443.616667,137.2484477
Cell S44,1000,58,3113723.62,7453,8639,1186,8036.672414,266.8897091
Cell S56,1000,59,3167408.51,6406,8385,1979,7725.305085,495.1108506
Cell S67,1000,59,3167408.51,7174,8588,1414,8176.423729,337.4294755
Cell S78,1000,58,3113723.62,7073,8651,1578,8333.275862,349.465345
Cell S88,1000,59,3167408.51,6399,8541,2142,7855.525424,598.3956051
Cell S94,1000,58,3113723.62,7606,8522,916,8125.603448,201.7500109
Cell S95,1000,59,3167408.51,6731,8378,1647,7672.423729,459.4851283
W287,1000,58,3113723.62,2308,7573,5265,5281.344828,1342.905658
W295,1000,59,3167408.51,4009,7963,3954,6756.491525,1239.971697
W338,1000,60,3221093.4,2271,8139,5868,6524.15,1571.451429
W342,1000,60,3221093.4,3010,7842,4832,6448.833333,983.5304633
W345,1000,58,3113723.62,6992,7864,872,7485.603448,197.7178362
W387,1000,60,3221093.4,3016,8038,5022,7059.966667,910.7733521
W393,1000,59,3167408.51,6313,8170,1857,7343.423729,477.797319
W440,1000,56,3006353.84,3019,8295,5276,6574.339286,1202.399525
W441,1000,58,3113723.62,7133,8537,1404,7654.758621,226.915168
W445,1000,60,3221093.4,5842,7678,1836,7086.033333,484.7053389
W500,1000,58,3113723.62,4853,8412,3559,7578.672414,771.394201
1,1250,94,5046379.66,6552,8093,1541,7840.585106,221.2471137
2,1250,94,5046379.66,2843,8174,5331,6717.425532,1336.62992
3,1250,93,4992694.77,6890,8004,1114,7587.301075,225.5017719
4,1250,90,4831640.1,5855,7877,2022,7302.511111,377.7674842
5,1250,91,4885324.99,6081,8738,2657,7894.604396,451.1089603
6,1250,93,4992694.77,5797,8372,2575,7729.043011,518.8140926
7,1250,94,5046379.66,5167,8348,3181,7256.797872,578.6339853
8,1250,91,4885324.99,3917,7646,3729,6351.274725,1057.207768
9,1250,90,4831640.1,6954,8283,1329,7774.488889,302.3665268
10,1250,93,4992694.77,2561,8673,6112,7137.258065,1375.449509
11,1250,88,4724270.32,6013,9034,3021,7434.534091,642.6175511
12,1250,88,4724270.32,1751,8123,6372,6457.193182,1815.007951
13,1250,90,4831640.1,4438,8219,3781,7164.355556,821.1649085
14,1250,92,4939009.88,6896,8634,1738,7970.815217,537.5201499
16,1250,90,4831640.1,453,9332,8879,5505.833333,2370.852609
17,1250,93,4992694.77,5065,8181,3116,7163.827957,737.913866
18,1250,93,4992694.77,1715,9982,8267,6775.032258,2195.284999
19,1250,92,4939009.88,1164,8266,7102,5764.826087,1694.202336
20,1250,90,4831640.1,7013,8201,1188,7785.8,213.2195113
21,1250,93,4992694.77,7402,8680,1278,8186.645161,264.8458933
22,1250,93,4992694.77,-1724,9195,10919,5493.731183,3351.751913
23,1250,94,5046379.66,1441,8824,7383,5854.351064,2193.533318
24,1250,90,4831640.1,6882,8387,1505,7879.111111,337.6371637
25,1250,94,5046379.66,6424,7915,1491,7333.393617,318.4721244
26,1250,93,4992694.77,7244,8245,1001,7756.623656,210.3600556
27,1250,92,4939009.88,7003,8200,1197,7741.836957,300.5456009
28,1250,92,4939009.88,6224,8101,1877,7360.597826,506.7999575
29,1250,91,4885324.99,6475,8214,1739,7804.912088,268.0658296
31,1250,93,4992694.77,7259,8058,799,7676.451613,179.1290468
32,1250,94,5046379.66,6083,7890,1807,7334.957447,399.9440098
33,1250,91,4885324.99,6767,7894,1127,7382,228.341079
34,1250,94,5046379.66,5586,7896,2310,7048.893617,393.7974819
10A,1250,90,4831640.1,1913,8243,6330,7073.622222,1520.30303
10NE,1250,90,4831640.1,6547,8426,1879,7794.944444,392.4506016
10NW,1250,93,4992694.77,6555,8727,2172,8111.827957,410.4723118
10SW,1250,88,4724270.32,1862,8920,7058,6750.477273,1736.989225
11NE,1250,93,4992694.77,2154,7869,5715,6611.11828,1029.969953
11NW,1250,90,4831640.1,5448,8976,3528,7663.5,591.1944454
11SE,1250,94,5046379.66,5681,8345,2664,7454.148936,476.2875039
17NW,1250,93,4992694.77,4739,8545,3806,7691.591398,513.3004159
17SE,1250,93,4992694.77,2238,8077,5839,7044.870968,1187.651665
17SW,1250,88,4724270.32,3246,7834,4588,7118.215909,759.710807
22S,1250,93,4992694.77,-1724,9795,11519,5482.83871,2936.768253
23S,1250,88,4724270.32,1090,6463,5373,2825.375,1113.572448
24S,1250,92,4939009.88,6882,8387,1505,7867.73913,341.5484201
27A,1250,90,4831640.1,1984,8980,6996,7196.611111,1539.359663
2A,1250,93,4992694.77,4134,8837,4703,7212.655914,1033.616269
5NE,1250,94,5046379.66,-1842,8301,10143,6414.297872,2430.781565
5NW,1250,94,5046379.66,-937,9827,10764,5658.244681,2020.448
5SE,1250,90,4831640.1,925,8692,7767,4901.422222,2431.41406
6NE,1250,93,4992694.77,6165,8201,2036,7609.634409,500.1579274
6NW,1250,94,5046379.66,3258,8368,5110,7545.468085,845.4869137
6SW,1250,92,4939009.88,3560,8463,4903,7279.108696,881.2339972
Cell 1 2011/12,1250,94,5046379.66,6552,8093,1541,7840.585106,221.2471137
Cell 1 SW 2013,1250,90,4831640.1,-1839,8429,10268,6674.022222,1436.665854
Cell 10 2011/12,1250,93,4992694.77,2561,8673,6112,7137.258065,1375.449509
Cell 10 NE 2011/12,1250,90,4831640.1,6547,8426,1879,7794.944444,392.4506016
Cell 10 NW 2011/12,1250,93,4992694.77,6555,8727,2172,8111.827957,410.4723118
Cell 10 SE 2013,1250,94,5046379.66,3258,8368,5110,7545.468085,845.4869137
Cell 10 SW 2011/12,1250,88,4724270.32,1862,8920,7058,6750.477273,1736.989225
Cell 10-A 2011/12,1250,90,4831640.1,1913,8243,6330,7073.622222,1520.30303
Cell 11 NE 2011/12,1250,93,4992694.77,2154,7869,5715,6611.11828,1029.969953
Cell 11 NW 2013,1250,91,4885324.99,3350,8220,4870,7232.989011,899.5421729
Cell 11 SW 2013,1250,90,4831640.1,5576,8400,2824,7353.6,686.6679094
Cell 12 2013,1250,93,4992694.77,5167,8348,3181,7257.795699,580.8593848
Cell 13 2013,1250,90,4831640.1,3649,7805,4156,6239.866667,1181.486439
Cell 14 2013,1250,91,4885324.99,7328,8683,1355,8125.406593,219.4661344
Cell 15 2013,1250,94,5046379.66,6803,8166,1363,7642,282.6864664
Cell 15-A 2013,1250,91,4885324.99,6913,8556,1643,7733.21978,351.0235208
Cell 16 2013,1250,92,4939009.88,6820,8737,1917,8048.369565,374.8544563
Cell 17 NW 2011/12,1250,93,4992694.77,4739,8545,3806,7691.591398,513.3004159
Cell 17 NW 2013,1250,93,4992694.77,-1846,7929,9775,5190.88172,2825.973753
Cell 17 SE 2013,1250,92,4939009.88,6555,8727,2172,8123.467391,397.1392662
Cell 17 SW 2013,1250,91,4885324.99,6081,8738,2657,7919.978022,438.6040287
Cell 18 2011/12,1250,93,4992694.77,1715,9982,8267,6775.032258,2195.284999
Cell 18 NE 2013,1250,91,4885324.99,3560,8463,4903,7173.549451,995.1559629
Cell 18 NW 2013,1250,94,5046379.66,925,8692,7767,4676.287234,2488.394405
Cell 18 SE 2013,1250,93,4992694.77,2154,7869,5715,6611.11828,1029.969953
Cell 18 SSE 2013,1250,94,5046379.66,6662,8976,2314,7621.223404,558.5631101
Cell 19 NW 2013,1250,93,4992694.77,6346,8201,1855,7776.16129,427.4711156
Cell 2 2011/12,1250,94,5046379.66,2843,8174,5331,6717.425532,1336.62992
Cell 2 NE 2013,1250,93,4992694.77,3627,8383,4756,7011.860215,1048.026785
Cell 2 SW 2013,1250,94,5046379.66,6552,8093,1541,7840.585106,221.2471137
Cell 20 2013,1250,90,4831640.1,6541,9715,3174,7560.744444,571.6524111
Cell 21 2013,1250,89,4777955.21,3295,8808,5513,6712.719101,1433.549143
Cell 22 2013,1250,92,4939009.88,6954,8104,1150,7645.184783,316.0563354
Cell 23 2013,1250,94,5046379.66,7993,8761,768,8429.829787,139.6138015
Cell 24 2013,1250,94,5046379.66,7598,8658,1060,8188.882979,233.1421745
Cell 25 NE 2013,1250,93,4992694.77,2561,8673,6112,7137.258065,1375.449509
Cell 25 SE 2013,1250,88,4724270.32,1862,8920,7058,6750.477273,1736.989225
Cell 26 NE 2013,1250,88,4724270.32,6013,9034,3021,7434.534091,642.6175511
Cell 26 NNW 2013,1250,90,4831640.1,6547,8426,1879,7794.944444,392.4506016
Cell 26 NW 2013,1250,90,4831640.1,1913,8243,6330,7073.622222,1520.30303
Cell 27 NW 2013,1250,94,5046379.66,5681,8345,2664,7454.148936,476.2875039
Cell 28 2013,1250,88,4724270.32,1751,8123,6372,6457.193182,1815.007951
Cell 29 2013,1250,90,4831640.1,4438,8219,3781,7164.355556,821.1649085
Cell 3 NE 2013,1250,92,4939009.88,382,8406,8024,7229.402174,1225.046415
Cell 3 NW 2013,1250,93,4992694.77,5438,8337,2899,7230.064516,700.8384657
Cell 30 2013,1250,93,4992694.77,7166,8406,1240,7890.236559,233.6272372
Cell 31 2013,1250,91,4885324.99,7141,8626,1485,8133.307692,386.1873853
Cell 32 2013,1250,92,4939009.88,7174,8771,1597,8200.858696,342.0911264
Cell 33 NE 2013,1250,93,4992694.77,4739,8545,3806,7691.591398,513.3004159
Cell 33 SE 2013,1250,88,4724270.32,3246,7834,4588,7118.215909,759.710807
Cell 33 SW 2013,1250,90,4831640.1,453,9332,8879,5231.3,2474.600333
Cell 34 N 2013,1250,90,4831640.1,6208,8038,1830,7413.511111,342.1841689
Cell 34 NW 2013,1250,93,4992694.77,5065,8181,3116,7163.827957,737.913866
Cell 34 SE 2013,1250,93,4992694.77,2238,8077,5839,7044.870968,1187.651665
Cell 35 2013,1250,93,4992694.77,1722,9879,8157,6681.290323,2154.292133
Cell 37 2013,1250,93,4992694.77,7079,8201,1122,7794.645161,195.5592282
Cell 38 2013,1250,90,4831640.1,7402,8680,1278,8215.933333,246.7030063
Cell 39 2013,1250,90,4831640.1,6953,8653,1700,8324.222222,340.8217122
Cell 4 2013,1250,92,4939009.88,6689,8050,1361,7523.25,361.9261162
Cell 40 NE 2013,1250,94,5046379.66,-359,9795,10154,6139.882979,2157.353752
Cell 41 N 2013,1250,90,4831640.1,1954,8692,6738,7405.266667,891.6829382
Cell 41 NW 2013,1250,94,5046379.66,-1538,8839,10377,5923.744681,2594.675046
Cell 42 NW 2013,1250,90,4831640.1,961,8334,7373,5603.255556,2321.987437
Cell 43 2013,1250,88,4724270.32,5687,8522,2835,7258.727273,495.5203814
Cell 44 2013,1250,90,4831640.1,6859,8369,1510,7761.388889,365.3960924
Cell 45 2013,1250,92,4939009.88,7244,8245,1001,7757.923913,211.1281928
Cell 47 2013,1250,90,4831640.1,6878,8064,1186,7580.144444,284.0818177
Cell 48 2013,1250,92,4939009.88,6882,8387,1505,7867.73913,341.5484201
Cell 49 2013,1250,94,5046379.66,6424,7915,1491,7333.393617,318.4721244
Cell 5 2011/12 Summer,1250,92,4939009.88,6081,8738,2657,7921.195652,436.3684183
Cell 5 2013,1250,93,4992694.77,5910,8540,2630,7897.322581,593.4502028
Cell 50 2013,1250,92,4939009.88,6475,8214,1739,7799.891304,270.872963
Cell 51 2013,1250,88,4724270.32,6731,8452,1721,7697.113636,476.7716585
Cell 52 2013,1250,90,4831640.1,7015,8273,1258,7592.966667,272.9225144
Cell 53 2013,1250,92,4939009.88,6224,8101,1877,7360.597826,506.7999575
Cell 54 2013,1250,94,5046379.66,7637,8752,1115,8388.297872,254.8249224
Cell 55 2013,1250,91,4885324.99,7177,8870,1693,8132.076923,399.403215
Cell 56 2013,1250,90,4831640.1,6767,7894,1127,7384.422222,228.440509
Cell 57 2013,1250,94,5046379.66,6083,7890,1807,7334.957447,399.9440098
Cell 58 2013,1250,92,4939009.88,7634,8699,1065,8100.021739,274.5612697
Cell 59 2013,1250,93,4992694.77,6615,7805,1190,7401.322581,237.4622171
Cell 6 2011/12,1250,93,4992694.77,5797,8372,2575,7729.043011,518.8140926
Cell 6 2013,1250,93,4992694.77,7171,8576,1405,7969.946237,344.5814156
Cell 6 NE 2011/12,1250,93,4992694.77,6165,8201,2036,7609.634409,500.1579274
Cell 6 NW 2011/12,1250,94,5046379.66,3258,8368,5110,7545.468085,845.4869137
Cell 6 SW 2011/12,1250,92,4939009.88,3560,8463,4903,7279.108696,881.2339972
Cell 60 2013,1250,91,4885324.99,6398,7972,1574,7115.769231,316.4864831
Cell 61 2013,1250,93,4992694.77,6699,8352,1653,7775.268817,320.9245428
Cell 7 2013,1250,88,4724270.32,5706,8668,2962,8131.386364,478.8168048
Cell 9 NW 2013,1250,93,4992694.77,-736,9468,10204,5236.548387,2833.813895
Cell 9 SE 2013,1250,93,4992694.77,-1842,8301,10143,6405.83871,2442.438744
Cell 9 SW 2013,1250,93,4992694.77,-937,9827,10764,5692.344086,2004.196729
Cell R1,1250,97,5207434.33,5816,8083,2267,7198.42268,518.0887723
Cell R10,1250,92,4939009.88,6689,8050,1361,7523.25,361.9261162
Cell R100,1250,92,4939009.88,6475,8214,1739,7799.891304,270.872963
Cell R101,1250,94,5046379.66,7536,8618,1082,8148.691489,212.1869422
Cell R104,1250,93,4992694.77,7538,8218,680,7902.419355,127.0192029
Cell R105,1250,92,4939009.88,6224,8101,1877,7360.597826,506.7999575
Cell R106,1250,94,5046379.66,6077,8368,2291,7524.648936,551.4614183
Cell R107,1250,94,5046379.66,7637,8752,1115,8388.297872,254.8249224
Cell R11,1250,93,4992694.77,5910,8540,2630,7897.322581,593.4502028
Cell R111,1250,93,4992694.77,7214,8627,1413,7880,282.9881262
Cell R112,1250,93,4992694.77,6780,8378,1598,7435.096774,285.1966333
Cell R113,1250,94,5046379.66,6083,7890,1807,7334.957447,399.9440098
Cell R114,1250,92,4939009.88,7634,8699,1065,8100.021739,274.5612697
Cell R117,1250,94,5046379.66,6799,8803,2004,7677.297872,453.2031114
Cell R118,1250,90,4831640.1,6767,7894,1127,7384.422222,228.440509
Cell R119,1250,92,4939009.88,6170,7565,1395,6836.782609,307.503617
Cell R120,1250,94,5046379.66,6174,8226,2052,7836.106383,356.8194152
Cell R121,1250,91,4885324.99,6706,8481,1775,7852.472527,372.9305489
Cell R123,1250,92,4939009.88,7211,7915,704,7522.23913,154.9056073
Cell R124,1250,90,4831640.1,6512,8138,1626,7302.777778,345.3063303
Cell R125,1250,88,4724270.32,3799,7987,4188,7212.465909,744.9266887
Cell R126,1250,92,4939009.88,6259,8395,2136,7756,432.1244537
Cell R15,1250,90,4831640.1,-1839,8429,10268,6674.022222,1436.665854
Cell R16,1250,93,4992694.77,-736,9468,10204,5236.548387,2833.813895
Cell R17,1250,93,4992694.77,5229,8510,3281,7305.376344,712.2507851
Cell R18,1250,88,4724270.32,5152,8262,3110,7328,751.5145919
Cell R19,1250,94,5046379.66,6856,7997,1141,7568.393617,246.6890634
Cell R20,1250,92,4939009.88,4285,8037,3752,7002.402174,805.4291195
Cell R21,1250,92,4939009.88,6858,8521,1663,7961.152174,387.9095293
Cell R22,1250,91,4885324.99,7328,8683,1355,8125.406593,219.4661344
Cell R24,1250,93,4992694.77,-1846,7929,9775,5190.88172,2825.973753
Cell R25,1250,94,5046379.66,925,8692,7767,4676.287234,2488.394405
Cell R26,1250,92,4939009.88,6237,8368,2131,7711.130435,451.7545798
Cell R27,1250,94,5046379.66,6346,8201,1855,7772.234043,426.8746496
Cell R28,1250,92,4939009.88,2504,8348,5844,6550.391304,1358.526527
Cell R29,1250,92,4939009.88,6541,9715,3174,7562.576087,565.7079488
Cell R30,1250,91,4885324.99,6377,8294,1917,7632.78022,437.0029497
Cell R31,1250,90,4831640.1,5511,8486,2975,7899.077778,583.5113105
Cell R35,1250,92,4939009.88,6081,8738,2657,7921.195652,436.3684183
Cell R36,1250,92,4939009.88,6555,8727,2172,8123.467391,397.1392662
Cell R37,1250,93,4992694.77,2154,7869,5715,6611.11828,1029.969953
Cell R38,1250,88,4724270.32,7176,8085,909,7646.136364,232.8345678
Cell R39,1250,95,5100064.55,4263,8657,4394,7382.621053,973.3571009
Cell R40,1250,90,4831640.1,3295,8808,5513,6690.733333,1440.572593
Cell R46,1250,90,4831640.1,800,9056,8256,4567.611111,2345.786259
Cell R47,1250,90,4831640.1,1913,8243,6330,7073.622222,1520.30303
Cell R48,1250,88,4724270.32,6013,9034,3021,7434.534091,642.6175511
Cell R49,1250,93,4992694.77,5681,8345,2664,7458.333333,477.1196584
Cell R5,1250,94,5046379.66,-1970,7848,9818,6010.553191,2016.826608
Cell R50,1250,88,4724270.32,1751,8123,6372,6457.193182,1815.007951
Cell R51,1250,91,4885324.99,4438,8219,3781,7165.67033,816.7357981
Cell R52,1250,91,4885324.99,6725,8186,1461,7493.43956,314.7650863
Cell R53,1250,93,4992694.77,3421,8165,4744,7510.634409,562.3252184
Cell R54,1250,90,4831640.1,7141,8626,1485,8137.944444,385.7996418
Cell R58,1250,93,4992694.77,1403,9901,8498,7463.032258,1940.235733
Cell R59,1250,93,4992694.77,4739,8545,3806,7691.591398,513.3004159
Cell R6,1250,94,5046379.66,6552,8093,1541,7840.585106,221.2471137
Cell R60,1250,93,4992694.77,5065,8181,3116,7163.827957,737.913866
Cell R61,1250,93,4992694.77,1722,9879,8157,6681.290323,2154.292133
Cell R62,1250,93,4992694.77,1164,9348,8184,5936.827957,1714.355722
Cell R63,1250,92,4939009.88,6506,8104,1598,7502.195652,321.5581711
Cell R64,1250,91,4885324.99,7180,8021,841,7709.450549,171.09905
Cell R65,1250,93,4992694.77,7166,8406,1240,7890.236559,233.6272372
Cell R66,1250,89,4777955.21,7731,8798,1067,8377.640449,263.7434166
Cell R69,1250,90,4831640.1,453,9332,8879,5231.3,2474.600333
Cell R7,1250,94,5046379.66,5438,8337,2899,7228.755319,697.2149564
Cell R70,1250,88,4724270.32,3246,7834,4588,7118.215909,759.710807
Cell R71,1250,93,4992694.77,2238,8077,5839,7044.870968,1187.651665
Cell R72,1250,92,4939009.88,1523,9046,7523,4848.467391,2460.480173
Cell R73,1250,90,4831640.1,6892,8632,1740,7865.811111,329.6026528
Cell R74,1250,93,4992694.77,5100,7738,2638,7116.677419,658.5018376
Cell R75,1250,93,4992694.77,7079,8201,1122,7794.645161,195.5592282
Cell R76,1250,90,4831640.1,6807,8790,1983,8243.577778,395.3840602
Cell R77,1250,90,4831640.1,7402,8680,1278,8215.933333,246.7030063
Cell R8,1250,91,4885324.99,382,8813,8431,7411.967033,1406.877334
Cell R80,1250,94,5046379.66,-359,9795,10154,6139.882979,2157.353752
Cell R81,1250,93,4992694.77,7417,8290,873,7818.860215,188.5784165
Cell R82,1250,90,4831640.1,961,8334,7373,5603.255556,2321.987437
Cell R83,1250,90,4831640.1,3694,8490,4796,7187.622222,1264.756767
Cell R84,1250,94,5046379.66,1718,8687,6969,5694.574468,1954.262142
Cell R85,1250,88,4724270.32,5687,8522,2835,7258.727273,495.5203814
Cell R86,1250,94,5046379.66,6900,8004,1104,7548.244681,284.7293484
Cell R87,1250,92,4939009.88,7244,8245,1001,7757.923913,211.1281928
Cell R9,1250,93,4992694.77,5341,8436,3095,7388.27957,545.144873
Cell R90,1250,90,4831640.1,6878,8064,1186,7580.144444,284.0818177
Cell R91,1250,92,4939009.88,6882,8387,1505,7867.73913,341.5484201
Cell R92,1250,90,4831640.1,1259,8690,7431,4813.677778,2528.582219
Cell R93,1250,94,5046379.66,6424,7915,1491,7333.393617,318.4721244
Cell R97,1250,91,4885324.99,6426,8847,2421,7984.736264,415.2147024
Cell R98,1250,92,4939009.88,7003,8200,1197,7741.836957,300.5456009
Cell R99,1250,90,4831640.1,7015,8273,1258,7592.966667,272.9225144
Cell S102,1250,94,5046379.66,7060,8562,1502,7913.553191,387.0345418
Cell S108,1250,91,4885324.99,7177,8870,1693,8132.076923,399.403215
Cell S13,1250,91,4885324.99,7172,8794,1622,8100.230769,369.4790534
Cell S14,1250,88,4724270.32,5706,8668,2962,8131.386364,478.8168048
Cell S2,1250,93,4992694.77,7171,8576,1405,7969.946237,344.5814156
Cell S23,1250,91,4885324.99,7877,8753,876,8492.802198,183.1489048
Cell S32,1250,90,4831640.1,7578,8473,895,8174.944444,223.761796
Cell S33,1250,91,4885324.99,6913,8556,1643,7733.21978,351.0235208
Cell S34,1250,94,5046379.66,7598,8658,1060,8188.882979,233.1421745
Cell S41,1250,91,4885324.99,7064,8404,1340,7821.846154,313.9262153
Cell S42,1250,94,5046379.66,7993,8761,768,8429.829787,139.6138015
Cell S44,1250,90,4831640.1,7453,8639,1186,8040.433333,272.5606986
Cell S56,1250,92,4939009.88,6406,8385,1979,7743.315217,477.9817381
Cell S67,1250,92,4939009.88,7174,8771,1597,8200.858696,342.0911264
Cell S78,1250,90,4831640.1,6953,8653,1700,8324.222222,340.8217122
Cell S88,1250,92,4939009.88,6399,8541,2142,7873.108696,559.5306546
Cell S94,1250,92,4939009.88,7045,8838,1793,8073.804348,307.6163703
Cell S95,1250,88,4724270.32,6731,8452,1721,7697.113636,476.7716585
W287,1250,90,4831640.1,2116,7573,5457,4833.155556,1505.136324
W295,1250,93,4992694.77,3281,7963,4682,6801.419355,1238.571457
W338,1250,94,5046379.66,2203,8307,6104,6611.234043,1526.508681
W342,1250,93,4992694.77,2483,7842,5359,6212.602151,1244.913739
W345,1250,92,4939009.88,4915,7864,2949,7445.054348,338.3002385
W387,1250,93,4992694.77,3004,8038,5034,6732.333333,1277.075156
W393,1250,93,4992694.77,6313,8475,2162,7356.290323,525.5873229
W440,1250,90,4831640.1,3019,8295,5276,6366.766667,1343.282944
W441,1250,91,4885324.99,6880,8537,1657,7639.32967,253.3916334
W445,1250,94,5046379.66,5842,7678,1836,7123.574468,469.5470087
W500,1250,93,4992694.77,2408,8445,6037,6890.655914,1711.61655
1,1500,134,7193775.26,6317,8093,1776,7792.238806,250.6495198
2,1500,135,7247460.15,2228,8201,5973,6644.22963,1382.355402
3,1500,132,7086405.48,6890,8004,1114,7574.712121,234.0843713
4,1500,132,7086405.48,5794,7877,2083,7306.94697,401.2967109
5,1500,131,7032720.59,5294,8738,3444,7805.427481,574.561114
6,1500,133,7140090.37,5797,8418,2621,7718.684211,546.2540428
7,1500,133,7140090.37,5167,8348,3181,7252.383459,551.5461483
8,1500,132,7086405.48,3649,7979,4330,6385.492424,1094.895121
9,1500,131,7032720.59,6954,8283,1329,7750.725191,321.3203451
10,1500,133,7140090.37,1862,8673,6811,6820.105263,1627.024316
11,1500,131,7032720.59,3552,9388,5836,7340.534351,891.9344129
12,1500,129,6925350.81,1751,8495,6744,6249.263566,1907.007211
13,1500,133,7140090.37,4438,8481,4043,7264.172932,799.6082642
14,1500,133,7140090.37,6679,8634,1955,8007.827068,534.2467329
16,1500,130,6979035.7,453,9332,8879,4956.323077,2537.012547
17,1500,133,7140090.37,5065,8206,3141,7233.466165,711.6892068
18,1500,134,7193775.26,1466,9982,8516,6125.716418,2559.297433
19,1500,131,7032720.59,1093,9348,8255,5535.51145,1986.045522
20,1500,131,7032720.59,7013,8201,1188,7793.541985,208.8068708
21,1500,132,7086405.48,6700,8742,2042,8138.924242,320.003992
22,1500,132,7086405.48,-1724,9795,11519,5453.818182,3052.307378
23,1500,137,7354829.93,961,8824,7863,5553.912409,2396.66093
24,1500,133,7140090.37,6882,8387,1505,7835.195489,342.4506212
25,1500,137,7354829.93,5976,8195,2219,7286.890511,416.4507959
26,1500,133,7140090.37,6943,8316,1373,7752.368421,215.8549873
27,1500,131,7032720.59,6763,8200,1437,7752.793893,305.0729538
28,1500,131,7032720.59,6224,8101,1877,7432.633588,503.6066441
29,1500,133,7140090.37,6475,8387,1912,7767.954887,291.8059625
31,1500,133,7140090.37,6715,8058,1343,7668.87218,212.2982515
32,1500,135,7247460.15,6083,8208,2125,7351.488889,388.5428213
33,1500,132,7086405.48,6685,7894,1209,7378.651515,244.695698
34,1500,134,7193775.26,5586,8161,2575,7054.746269,450.8452044
10A,1500,131,7032720.59,1913,8381,6468,6915.381679,1688.157853
10NE,1500,131,7032720.59,5110,8595,3485,7711.541985,561.8581123
10NW,1500,132,7086405.48,2565,8727,6162,7978.818182,848.7023055
10SW,1500,131,7032720.59,1862,8920,7058,6171.389313,2008.429912
11NE,1500,133,7140090.37,2154,8053,5899,6680.984962,1118.177431
11NW,1500,133,7140090.37,3072,8976,5904,7504.526316,831.5889183
11SE,1500,133,7140090.37,2710,8427,5717,7314.43609,816.6423588
17NW,1500,132,7086405.48,4739,9571,4832,7668.727273,595.3709449
17SE,1500,133,7140090.37,1868,8134,6266,6942.263158,1479.987548
17SW,1500,131,7032720.59,2305,8478,6173,6831.48855,1219.498986
22S,1500,133,7140090.37,-1724,9795,11519,5407.669173,2886.461727
23S,1500,128,6871665.92,1090,6864,5774,2812.1875,1237.974276
24S,1500,133,7140090.37,6882,8427,1545,7846.203008,339.1213494
27A,1500,132,7086405.48,1447,8980,7533,6966.174242,1826.708173
2A,1500,134,7193775.26,2750,8837,6087,6997.626866,1284.948525
5NE,1500,133,7140090.37,-1842,8301,10143,6549.887218,2235.905699
5NW,1500,135,7247460.15,-1428,9827,11255,5741.444444,2117.479188
5SE,1500,132,7086405.48,791,8757,7966,4598.606061,2445.849734
6NE,1500,135,7247460.15,3739,8201,4462,7514.622222,649.4306323
6NW,1500,135,7247460.15,1692,8611,6919,7390.748148,1185.464195
6SW,1500,132,7086405.48,2408,8463,6055,7007.401515,1197.301346
Cell 1 2011/12,1500,134,7193775.26,6317,8093,1776,7792.238806,250.6495198
Cell 1 SW 2013,1500,132,7086405.48,-1839,8429,10268,6410.25,1889.394365
Cell 10 2011/12,1500,133,7140090.37,1862,8673,6811,6820.105263,1627.024316
Cell 10 NE 2011/12,1500,131,7032720.59,5110,8595,3485,7711.541985,561.8581123
Cell 10 NW 2011/12,1500,132,7086405.48,2565,8727,6162,7978.818182,848.7023055
Cell 10 SE 2013,1500,135,7247460.15,1692,8611,6919,7390.748148,1185.464195
Cell 10 SW 2011/12,1500,131,7032720.59,1862,8920,7058,6171.389313,2008.429912
Cell 10-A 2011/12,1500,131,7032720.59,1913,8381,6468,6915.381679,1688.157853
Cell 11 NE 2011/12,1500,133,7140090.37,2154,8053,5899,6680.984962,1118.177431
Cell 11 NW 2013,1500,132,7086405.48,2843,8837,5994,7096.083333,1127.018728
Cell 11 SW 2013,1500,131,7032720.59,5576,8428,2852,7508.40458,680.3165606
Cell 12 2013,1500,132,7086405.48,5167,8348,3181,7257.113636,551.9771851
Cell 13 2013,1500,131,7032720.59,3649,7924,4275,6222.396947,1182.819872
Cell 14 2013,1500,134,7193775.26,7328,8683,1355,8146.268657,229.0888886
Cell 15 2013,1500,135,7247460.15,6458,8222,1764,7628.644444,339.6328184
Cell 15-A 2013,1500,131,7032720.59,6913,8556,1643,7761.061069,330.0655904
Cell 16 2013,1500,133,7140090.37,6616,8737,2121,7998.030075,389.2205231
Cell 17 NW 2011/12,1500,132,7086405.48,4739,9571,4832,7668.727273,595.3709449
Cell 17 NW 2013,1500,134,7193775.26,-1875,8361,10236,5384.850746,2907.924657
Cell 17 SE 2013,1500,132,7086405.48,2565,8727,6162,7978.818182,848.7023055
Cell 17 SW 2013,1500,131,7032720.59,5294,8738,3444,7832.603053,563.8967839
Cell 18 2011/12,1500,134,7193775.26,1466,9982,8516,6125.716418,2559.297433
Cell 18 NE 2013,1500,133,7140090.37,2365,8683,6318,7099.932331,1200.319132
Cell 18 NW 2013,1500,134,7193775.26,791,8692,7901,4369.067164,2440.92027
Cell 18 SE 2013,1500,133,7140090.37,2154,8053,5899,6680.984962,1118.177431
Cell 18 SSE 2013,1500,133,7140090.37,5448,8976,3528,7584.503759,600.3858236
Cell 19 NW 2013,1500,133,7140090.37,6346,8242,1896,7787.714286,419.3932526
Cell 2 2011/12,1500,135,7247460.15,2228,8201,5973,6644.22963,1382.355402
Cell 2 NE 2013,1500,133,7140090.37,3573,8383,4810,7008.015038,1092.85788
Cell 2 SW 2013,1500,134,7193775.26,6317,8093,1776,7792.238806,250.6495198
Cell 20 2013,1500,132,7086405.48,6487,9715,3228,7637.515152,670.6165694
Cell 21 2013,1500,131,7032720.59,3295,8808,5513,6697.671756,1381.257555
Cell 22 2013,1500,133,7140090.37,6954,8235,1281,7721.541353,309.6721407
Cell 23 2013,1500,135,7247460.15,7880,8761,881,8417.511111,164.0955849
Cell 24 2013,1500,133,7140090.37,7550,8658,1108,8146.345865,243.0050912
Cell 25 NE 2013,1500,133,7140090.37,1862,8673,6811,6820.105263,1627.024316
Cell 25 SE 2013,1500,131,7032720.59,1862,8920,7058,6171.389313,2008.429912
Cell 26 NE 2013,1500,131,7032720.59,3552,9388,5836,7340.534351,891.9344129
Cell 26 NNW 2013,1500,131,7032720.59,5110,8595,3485,7711.541985,561.8581123
Cell 26 NW 2013,1500,131,7032720.59,1913,8381,6468,6915.381679,1688.157853
Cell 27 NW 2013,1500,133,7140090.37,2710,8427,5717,7314.43609,816.6423588
Cell 28 2013,1500,128,6871665.92,1751,8495,6744,6234.9375,1907.514764
Cell 29 2013,1500,133,7140090.37,4438,8481,4043,7264.172932,799.6082642
Cell 3 NE 2013,1500,133,7140090.37,382,8436,8054,7334.090226,1192.589042
Cell 3 NW 2013,1500,133,7140090.37,2353,8383,6030,7145.458647,913.7872814
Cell 30 2013,1500,134,7193775.26,7166,8406,1240,7906.253731,231.6241386
Cell 31 2013,1500,130,6979035.7,6954,8652,1698,8155.061538,383.7999229
Cell 32 2013,1500,132,7086405.48,6967,8771,1804,8203.55303,375.8249978
Cell 33 NE 2013,1500,132,7086405.48,4739,9571,4832,7668.727273,595.3709449
Cell 33 SE 2013,1500,131,7032720.59,2305,8478,6173,6831.48855,1219.498986
Cell 33 SW 2013,1500,131,7032720.59,453,9332,8879,4857.175573,2535.602798
Cell 34 N 2013,1500,131,7032720.59,5273,8038,2765,7322,464.0291186
Cell 34 NW 2013,1500,133,7140090.37,5065,8206,3141,7233.466165,711.6892068
Cell 34 SE 2013,1500,134,7193775.26,1868,8134,6266,6947.850746,1475.862311
Cell 35 2013,1500,137,7354829.93,1715,9982,8267,6399,2309.649308
Cell 37 2013,1500,132,7086405.48,7013,8201,1188,7784.409091,210.7556374
Cell 38 2013,1500,132,7086405.48,6700,8742,2042,8157.318182,323.6450852
Cell 39 2013,1500,132,7086405.48,6953,8660,1707,8325.310606,326.7672727
Cell 4 2013,1500,133,7140090.37,6580,8050,1470,7524.390977,352.6555506
Cell 40 NE 2013,1500,137,7354829.93,-1724,9795,11519,5708.248175,2448.623438
Cell 41 N 2013,1500,130,6979035.7,1954,8839,6885,7365.115385,968.4800672
Cell 41 NW 2013,1500,134,7193775.26,-1538,8839,10377,6095.544776,2497.070327
Cell 42 NW 2013,1500,131,7032720.59,961,8824,7863,5293.167939,2521.411852
Cell 43 2013,1500,130,6979035.7,2670,8522,5852,7089.169231,814.0125036
Cell 44 2013,1500,131,7032720.59,6563,8369,1806,7714.015267,407.526611
Cell 45 2013,1500,133,7140090.37,6943,8316,1373,7753.616541,215.6641333
Cell 47 2013,1500,131,7032720.59,6610,8100,1490,7572.832061,333.0551648
Cell 48 2013,1500,133,7140090.37,6882,8427,1545,7841.796992,343.4590685
Cell 49 2013,1500,137,7354829.93,5976,8195,2219,7286.890511,416.4507959
Cell 5 2011/12 Summer,1500,131,7032720.59,5294,8738,3444,7832.603053,563.8967839
Cell 5 2013,1500,133,7140090.37,5910,8688,2778,7852.541353,583.2101662
Cell 50 2013,1500,133,7140090.37,6475,8387,1912,7767.954887,291.8059625
Cell 51 2013,1500,129,6925350.81,6731,8452,1721,7688.72093,477.2358879
Cell 52 2013,1500,131,7032720.59,7015,8273,1258,7580.328244,253.2237777
Cell 53 2013,1500,131,7032720.59,6224,8101,1877,7432.633588,503.6066441
Cell 54 2013,1500,133,7140090.37,7523,8752,1229,8349.744361,281.6450241
Cell 55 2013,1500,132,7086405.48,7123,8870,1747,8183.984848,387.632499
Cell 56 2013,1500,130,6979035.7,6685,7894,1209,7376.153846,245.0005796
Cell 57 2013,1500,135,7247460.15,6083,8208,2125,7351.488889,388.5428213
Cell 58 2013,1500,133,7140090.37,7634,8699,1065,8127.353383,268.2304641
Cell 59 2013,1500,135,7247460.15,6615,8100,1485,7407.607407,248.720015
Cell 6 2011/12,1500,133,7140090.37,5797,8418,2621,7718.684211,546.2540428
Cell 6 2013,1500,133,7140090.37,7171,8640,1469,7984.646617,330.4213577
Cell 6 NE 2011/12,1500,135,7247460.15,3739,8201,4462,7514.622222,649.4306323
Cell 6 NW 2011/12,1500,135,7247460.15,1692,8611,6919,7390.748148,1185.464195
Cell 6 SW 2011/12,1500,132,7086405.48,2408,8463,6055,7007.401515,1197.301346
Cell 60 2013,1500,131,7032720.59,6309,8041,1732,7171.923664,353.0642875
Cell 61 2013,1500,133,7140090.37,6555,8395,1840,7666.834586,392.0582698
Cell 7 2013,1500,131,7032720.59,5706,8703,2997,8183.40458,465.2571936
Cell 9 NW 2013,1500,133,7140090.37,-736,9468,10204,5471.924812,2633.817095
Cell 9 SE 2013,1500,133,7140090.37,-1842,8301,10143,6549.887218,2235.905699
Cell 9 SW 2013,1500,135,7247460.15,-1428,9827,11255,5741.444444,2117.479188
Cell R1,1500,137,7354829.93,2547,8189,5642,7146.591241,780.4570957
Cell R10,1500,133,7140090.37,6580,8050,1470,7524.390977,352.6555506
Cell R100,1500,133,7140090.37,6475,8387,1912,7767.954887,291.8059625
Cell R101,1500,133,7140090.37,7536,8618,1082,8133.210526,218.0501099
Cell R104,1500,133,7140090.37,7538,8218,680,7914.030075,125.413418
Cell R105,1500,131,7032720.59,6224,8101,1877,7432.633588,503.6066441
Cell R106,1500,133,7140090.37,5827,8376,2549,7496.729323,558.7386322
Cell R107,1500,133,7140090.37,7523,8752,1229,8349.744361,281.6450241
Cell R11,1500,133,7140090.37,5910,8688,2778,7852.541353,583.2101662
Cell R111,1500,133,7140090.37,3427,8627,5200,7727.721805,726.1640005
Cell R112,1500,133,7140090.37,6780,8378,1598,7463.270677,304.0318822
Cell R113,1500,135,7247460.15,6083,8208,2125,7351.488889,388.5428213
Cell R114,1500,133,7140090.37,7634,8699,1065,8127.353383,268.2304641
Cell R117,1500,134,7193775.26,6799,8803,2004,7665.126866,455.4697169
Cell R118,1500,130,6979035.7,6685,7894,1209,7376.153846,245.0005796
Cell R119,1500,133,7140090.37,6170,7565,1395,6895.338346,322.7015402
Cell R120,1500,137,7354829.93,6174,8293,2119,7753.715328,427.947042
Cell R121,1500,132,7086405.48,6706,8579,1873,7896.886364,355.836821
Cell R123,1500,131,7032720.59,7184,8137,953,7514.923664,176.9721425
Cell R124,1500,133,7140090.37,6512,8138,1626,7312.819549,332.2853162
Cell R125,1500,131,7032720.59,2390,7987,5597,7049.015267,977.9490377
Cell R126,1500,133,7140090.37,6259,8395,2136,7688.676692,487.0354937
Cell R15,1500,132,7086405.48,-1839,8429,10268,6410.25,1889.394365
Cell R16,1500,132,7086405.48,-736,9468,10204,5483.931818,2640.146036
Cell R17,1500,133,7140090.37,3958,8510,4552,7392.699248,748.1719776
Cell R18,1500,124,6656926.36,3350,8837,5487,7184.709677,981.3106671
Cell R19,1500,133,7140090.37,6856,7997,1141,7575.706767,235.4571232
Cell R20,1500,132,7086405.48,4285,8190,3905,7092.492424,784.650284
Cell R21,1500,132,7086405.48,6858,8521,1663,7925.272727,377.2751004
Cell R22,1500,133,7140090.37,7328,8683,1355,8145.225564,229.6312708
Cell R24,1500,133,7140090.37,-1875,8361,10236,5369.639098,2913.519886
Cell R25,1500,134,7193775.26,791,8692,7901,4369.067164,2440.92027
Cell R26,1500,133,7140090.37,1692,8611,6919,7439.360902,1101.203828
Cell R27,1500,133,7140090.37,6346,8242,1896,7787.714286,419.3932526
Cell R28,1500,131,7032720.59,2164,8348,6184,6461.053435,1523.273821
Cell R29,1500,132,7086405.48,6487,9715,3228,7637.515152,670.6165694
Cell R30,1500,132,7086405.48,5971,8476,2505,7646.606061,443.1150709
Cell R31,1500,132,7086405.48,5511,8498,2987,7865.045455,542.500815
Cell R35,1500,132,7086405.48,5294,8738,3444,7834.378788,562.1242924
Cell R36,1500,132,7086405.48,2565,8727,6162,7978.818182,848.7023055
Cell R37,1500,134,7193775.26,2154,8053,5899,6689.365672,1118.182204
Cell R38,1500,131,7032720.59,6881,8085,1204,7633.633588,240.1932176
Cell R39,1500,133,7140090.37,4263,9211,4948,7375.120301,1005.431146
Cell R40,1500,131,7032720.59,3295,8808,5513,6697.671756,1381.257555
Cell R46,1500,132,7086405.48,448,9056,8608,4480.689394,2445.672025
Cell R47,1500,131,7032720.59,1913,8381,6468,6915.381679,1688.157853
Cell R48,1500,131,7032720.59,3552,9388,5836,7340.534351,891.9344129
Cell R49,1500,133,7140090.37,2710,8427,5717,7314.43609,816.6423588
Cell R5,1500,135,7247460.15,-1970,7848,9818,5806.362963,2061.349255
Cell R50,1500,128,6871665.92,1751,8495,6744,6234.9375,1907.514764
Cell R51,1500,133,7140090.37,4438,8219,3781,7267.052632,793.1622853
Cell R52,1500,133,7140090.37,6725,8244,1519,7560.112782,316.37452
Cell R53,1500,133,7140090.37,3421,8165,4744,7490.511278,553.5094951
Cell R54,1500,130,6979035.7,6954,8652,1698,8155.061538,383.7999229
Cell R58,1500,133,7140090.37,766,9901,9135,6979.774436,2289.284774
Cell R59,1500,133,7140090.37,4739,9571,4832,7665.887218,594.0253362
Cell R6,1500,134,7193775.26,6317,8093,1776,7792.238806,250.6495198
Cell R60,1500,133,7140090.37,5065,8206,3141,7233.466165,711.6892068
Cell R61,1500,137,7354829.93,1715,9982,8267,6399,2309.649308
Cell R62,1500,133,7140090.37,1164,9348,8184,5628.992481,1904.62512
Cell R63,1500,134,7193775.26,6506,8244,1738,7493.126866,357.1278132
Cell R64,1500,132,7086405.48,7093,8021,928,7697.484848,199.274536
Cell R65,1500,134,7193775.26,7166,8406,1240,7906.253731,231.6241386
Cell R66,1500,132,7086405.48,7476,8798,1322,8396.939394,257.722036
Cell R69,1500,131,7032720.59,453,9332,8879,4857.175573,2535.602798
Cell R7,1500,133,7140090.37,2353,8383,6030,7145.458647,913.7872814
Cell R70,1500,131,7032720.59,2305,8478,6173,6831.48855,1219.498986
Cell R71,1500,134,7193775.26,1868,8134,6266,6947.850746,1475.862311
Cell R72,1500,133,7140090.37,1254,9046,7792,4247.706767,2516.776124
Cell R73,1500,132,7086405.48,6892,8632,1740,7868.295455,333.845313
Cell R74,1500,133,7140090.37,5100,8283,3183,7148.586466,660.9067265
Cell R75,1500,132,7086405.48,7013,8201,1188,7784.409091,210.7556374
Cell R76,1500,131,7032720.59,6807,8790,1983,8223.992366,360.5687089
Cell R77,1500,132,7086405.48,6700,8742,2042,8157.318182,323.6450852
Cell R8,1500,130,6979035.7,382,8813,8431,7452.376923,1322.850356
Cell R80,1500,137,7354829.93,-1724,9795,11519,5708.248175,2448.623438
Cell R81,1500,132,7086405.48,7417,8294,877,7840.886364,196.3578462
Cell R82,1500,131,7032720.59,961,8824,7863,5293.167939,2521.411852
Cell R83,1500,132,7086405.48,1793,8490,6697,6862.560606,1451.857365
Cell R84,1500,133,7140090.37,1376,8687,7311,5345.406015,2139.997839
Cell R85,1500,130,6979035.7,2670,8522,5852,7089.169231,814.0125036
Cell R86,1500,133,7140090.37,6864,8111,1247,7531.37594,293.8285675
Cell R87,1500,133,7140090.37,6943,8316,1373,7753.616541,215.6641333
Cell R9,1500,135,7247460.15,5341,8436,3095,7340.962963,537.9709122
Cell R90,1500,131,7032720.59,6610,8100,1490,7572.832061,333.0551648
Cell R91,1500,133,7140090.37,6882,8427,1545,7841.796992,343.4590685
Cell R92,1500,132,7086405.48,1259,9242,7983,4524.545455,2551.921873
Cell R93,1500,137,7354829.93,5976,8195,2219,7286.890511,416.4507959
Cell R97,1500,131,7032720.59,3108,8980,5872,7831.801527,744.0889652
Cell R98,1500,131,7032720.59,6763,8200,1437,7752.793893,305.0729538
Cell R99,1500,131,7032720.59,7015,8273,1258,7580.328244,253.2237777
Cell S102,1500,135,7247460.15,7060,8562,1502,7982.6,398.5487971
Cell S108,1500,132,7086405.48,7123,8870,1747,8183.984848,387.632499
Cell S13,1500,133,7140090.37,7044,8867,1823,8140.81203,382.3618951
Cell S14,1500,131,7032720.59,5706,8703,2997,8183.40458,465.2571936
Cell S2,1500,133,7140090.37,7171,8640,1469,7984.646617,330.4213577
Cell S23,1500,131,7032720.59,7742,8753,1011,8472.664122,196.1757512
Cell S32,1500,132,7086405.48,7119,8721,1602,8144.477273,271.3655274
Cell S33,1500,131,7032720.59,6913,8556,1643,7761.061069,330.0655904
Cell S34,1500,133,7140090.37,7550,8658,1108,8146.345865,243.0050912
Cell S41,1500,132,7086405.48,7064,8404,1340,7803.068182,297.8445597
Cell S42,1500,135,7247460.15,7880,8761,881,8417.511111,164.0955849
Cell S44,1500,132,7086405.48,7453,8667,1214,8040.659091,281.4409306
Cell S56,1500,134,7193775.26,6029,8501,2472,7793.11194,507.1137772
Cell S67,1500,132,7086405.48,6967,8771,1804,8203.55303,375.8249978
Cell S78,1500,132,7086405.48,6953,8660,1707,8325.310606,326.7672727
Cell S88,1500,131,7032720.59,6375,8541,2166,7870.496183,549.6923272
Cell S94,1500,131,7032720.59,7045,8838,1793,8091.076336,331.7074637
Cell S95,1500,129,6925350.81,6731,8452,1721,7688.72093,477.2358879
W287,1500,130,6979035.7,1749,8994,7245,4607.761538,1659.105203
W295,1500,133,7140090.37,3281,8128,4847,6893.255639,1204.573775
W338,1500,135,7247460.15,2000,9138,7138,6701.207407,1522.423877
W342,1500,135,7247460.15,1906,7842,5936,6006.37037,1460.122434
W345,1500,131,7032720.59,4915,7864,2949,7419.717557,434.6533984
W387,1500,133,7140090.37,2046,8101,6055,6387.947368,1626.126147
W393,1500,132,7086405.48,6313,8488,2175,7351.80303,551.5783611
W440,1500,131,7032720.59,2316,8295,5979,6231.709924,1446.658437
W441,1500,132,7086405.48,6858,8537,1679,7621.765152,268.9712404
W445,1500,135,7247460.15,5842,7678,1836,7136.614815,444.6830746
W500,1500,134,7193775.26,2408,8445,6037,6599.440299,1902.83784
1,1750,182,9770649.98,6317,8356,2039,7777.06044,249.466203
2,1750,183,9824334.87,1985,8722,6737,6588,1409.447355
3,1750,179,9609595.31,6890,8004,1114,7576.446927,227.0354517
4,1750,179,9609595.31,5794,7910,2116,7269.039106,419.1187931
5,1750,183,9824334.87,5294,8738,3444,7715.639344,645.3050797
6,1750,181,9716965.09,5797,8418,2621,7673.651934,568.4328902
7,1750,182,9770649.98,4545,8348,3803,7245.802198,581.0654522
8,1750,179,9609595.31,3649,8109,4460,6408.798883,1106.975851
9,1750,181,9716965.09,6954,8323,1369,7778.922652,308.1299227
10,1750,181,9716965.09,1862,8892,7030,6775.668508,1712.17457
11,1750,179,9609595.31,1752,9388,7636,7040.670391,1265.159803
12,1750,180,9663280.2,1551,8736,7185,6132.611111,1878.060008
13,1750,179,9609595.31,4438,8481,4043,7299.994413,762.4906667
14,1750,179,9609595.31,5965,8680,2715,8025.340782,560.8276715
16,1750,180,9663280.2,294,9332,9038,4678.966667,2574.984768
17,1750,181,9716965.09,3632,8206,4574,7261.508287,745.4235299
18,1750,181,9716965.09,1464,9982,8518,5655.928177,2717.038614
19,1750,184,9878019.76,1093,9348,8255,5263.592391,2134.470373
20,1750,179,9609595.31,7013,8401,1388,7787.927374,227.2267105
21,1750,181,9716965.09,6700,8742,2042,8138.574586,323.2571992
22,1750,181,9716965.09,-1724,9795,11519,5259.662983,2939.487978
23,1750,180,9663280.2,951,8824,7873,5354.316667,2462.004875
24,1750,180,9663280.2,6270,8492,2222,7824.844444,361.4283058
25,1750,180,9663280.2,5782,8650,2868,7291.311111,468.9760156
26,1750,182,9770649.98,6943,8316,1373,7742.450549,229.7449022
27,1750,182,9770649.98,6729,8200,1471,7727.604396,326.2758854
28,1750,183,9824334.87,6027,8149,2122,7494.808743,498.9403433
29,1750,179,9609595.31,6475,8387,1912,7743.301676,294.7096072
31,1750,181,9716965.09,6423,8197,1774,7673.933702,246.932017
32,1750,183,9824334.87,6083,8208,2125,7340.666667,397.8827344
33,1750,179,9609595.31,6685,7894,1209,7375.01676,244.1288806
34,1750,180,9663280.2,5586,8161,2575,7060.561111,463.5331004
10A,1750,181,9716965.09,1913,8381,6468,6869.403315,1712.869554
10NE,1750,180,9663280.2,4027,8595,4568,7654.666667,716.7998636
10NW,1750,182,9770649.98,2565,8886,6321,7892.252747,1010.844175
10SW,1750,180,9663280.2,1499,8920,7421,5754.2,2136.882569
11NE,1750,181,9716965.09,2154,8298,6144,6765.187845,1210.334399
11NW,1750,178,9555910.42,3002,8976,5974,7371.657303,984.5001187
11SE,1750,182,9770649.98,1860,8427,6567,6984.846154,1316.676985
17NW,1750,182,9770649.98,4129,9942,5813,7627.56044,769.8715493
17SE,1750,181,9716965.09,1868,8173,6305,6938.883978,1483.501034
17SW,1750,180,9663280.2,1919,9302,7383,6539.383333,1626.231907
22S,1750,182,9770649.98,-1724,9795,11519,5220.510989,2874.597366
23S,1750,180,9663280.2,1090,7597,6507,2932.066667,1473.247556
24S,1750,182,9770649.98,6270,8492,2222,7818.587912,364.5367231
27A,1750,180,9663280.2,1447,8980,7533,6638.783333,2112.678822
2A,1750,180,9663280.2,1950,8837,6887,6850.594444,1414.532533
5NE,1750,181,9716965.09,-1842,9827,11669,6549.232044,2166.992705
5NW,1750,183,9824334.87,-1428,9827,11255,5724.491803,2171.476619
5SE,1750,180,9663280.2,791,8763,7972,4415.605556,2441.721398
6NE,1750,181,9716965.09,2231,8201,5970,7371.657459,888.3573915
6NW,1750,180,9663280.2,1692,9201,7509,7268.622222,1369.564161
6SW,1750,181,9716965.09,1628,8515,6887,6912.917127,1434.545686
Cell 1 2011/12,1750,182,9770649.98,6317,8356,2039,7777.06044,249.466203
Cell 1 SW 2013,1750,178,9555910.42,-1839,8429,10268,6250.977528,1874.102802
Cell 10 2011/12,1750,181,9716965.09,1862,8892,7030,6775.668508,1712.17457
Cell 10 NE 2011/12,1750,180,9663280.2,4027,8595,4568,7654.666667,716.7998636
Cell 10 NW 2011/12,1750,182,9770649.98,2565,8886,6321,7892.252747,1010.844175
Cell 10 SE 2013,1750,180,9663280.2,1692,9201,7509,7268.622222,1369.564161
Cell 10 SW 2011/12,1750,180,9663280.2,1499,8920,7421,5754.2,2136.882569
Cell 10-A 2011/12,1750,181,9716965.09,1913,8381,6468,6869.403315,1712.869554
Cell 11 NE 2011/12,1750,181,9716965.09,2154,8298,6144,6765.187845,1210.334399
Cell 11 NW 2013,1750,177,9502225.53,2843,8837,5994,7023.564972,1177.530533
Cell 11 SW 2013,1750,180,9663280.2,5576,8615,3039,7600.272222,664.3622492
Cell 12 2013,1750,182,9770649.98,4545,8348,3803,7248.230769,580.2246927
Cell 13 2013,1750,180,9663280.2,2057,7979,5922,6193.527778,1215.351117
Cell 14 2013,1750,178,9555910.42,7328,8702,1374,8183.168539,233.8600482
Cell 15 2013,1750,183,9824334.87,6458,8356,1898,7666.535519,367.6681171
Cell 15-A 2013,1750,181,9716965.09,6913,8556,1643,7791.375691,322.1268791
Cell 16 2013,1750,181,9716965.09,6616,8737,2121,7946.20442,386.187767
Cell 17 NW 2011/12,1750,182,9770649.98,4129,9942,5813,7627.56044,769.8715493
Cell 17 NW 2013,1750,181,9716965.09,-1875,8475,10350,5369.093923,3023.950723
Cell 17 SE 2013,1750,182,9770649.98,2565,8886,6321,7892.252747,1010.844175
Cell 17 SW 2013,1750,179,9609595.31,5294,8738,3444,7752.681564,615.395412
Cell 18 2011/12,1750,181,9716965.09,1464,9982,8518,5655.928177,2717.038614
Cell 18 NE 2013,1750,179,9609595.31,1628,8683,7055,7020.106145,1435.229951
Cell 18 NW 2013,1750,180,9663280.2,791,8757,7966,4188.733333,2397.654019
Cell 18 SE 2013,1750,181,9716965.09,2154,8298,6144,6765.187845,1210.334399
Cell 18 SSE 2013,1750,182,9770649.98,3002,8976,5974,7414.175824,904.1511421
Cell 19 NW 2013,1750,181,9716965.09,6346,8418,2072,7789.314917,423.4604553
Cell 2 2011/12,1750,183,9824334.87,1985,8722,6737,6588,1409.447355
Cell 2 NE 2013,1750,183,9824334.87,3573,8427,4854,6891.879781,1218.675742
Cell 2 SW 2013,1750,183,9824334.87,6317,8356,2039,7778.04918,249.1410003
Cell 20 2013,1750,177,9502225.53,6380,9764,3384,7693,712.8473739
Cell 21 2013,1750,179,9609595.31,3295,8808,5513,6724.452514,1321.927804
Cell 22 2013,1750,181,9716965.09,6954,8354,1400,7760.038674,297.3563512
Cell 23 2013,1750,180,9663280.2,7737,8761,1024,8398.588889,184.6866652
Cell 24 2013,1750,181,9716965.09,7239,8673,1434,8104.734807,271.9763078
Cell 25 NE 2013,1750,181,9716965.09,1862,8892,7030,6775.668508,1712.17457
Cell 25 SE 2013,1750,180,9663280.2,1499,8920,7421,5754.2,2136.882569
Cell 26 NE 2013,1750,179,9609595.31,1752,9388,7636,7040.670391,1265.159803
Cell 26 NNW 2013,1750,180,9663280.2,4027,8595,4568,7654.666667,716.7998636
Cell 26 NW 2013,1750,180,9663280.2,1913,8381,6468,6885.372222,1704.131917
Cell 27 NW 2013,1750,181,9716965.09,1860,8427,6567,6980.480663,1318.995045
Cell 28 2013,1750,180,9663280.2,1551,8736,7185,6132.611111,1878.060008
Cell 29 2013,1750,180,9663280.2,4438,8481,4043,7301.866667,760.7821735
Cell 3 NE 2013,1750,179,9609595.31,382,8612,8230,7375.905028,1149.403147
Cell 3 NW 2013,1750,182,9770649.98,2353,8383,6030,7129.868132,884.045039
Cell 30 2013,1750,180,9663280.2,7166,8566,1400,7910.2,236.79108
Cell 31 2013,1750,180,9663280.2,6954,8662,1708,8171.911111,377.4584346
Cell 32 2013,1750,183,9824334.87,6896,8771,1875,8218.142077,386.4676964
Cell 33 NE 2013,1750,182,9770649.98,4129,9942,5813,7627.56044,769.8715493
Cell 33 SE 2013,1750,178,9555910.42,1919,9302,7383,6551.421348,1616.598366
Cell 33 SW 2013,1750,179,9609595.31,453,9332,8879,4503.24581,2532.064169
Cell 34 N 2013,1750,179,9609595.31,3569,8038,4469,7212.620112,602.8044244
Cell 34 NW 2013,1750,181,9716965.09,3632,8206,4574,7261.508287,745.4235299
Cell 34 SE 2013,1750,182,9770649.98,1868,8173,6305,6944.071429,1481.065087
Cell 35 2013,1750,179,9609595.31,1426,9982,8556,6145.703911,2454.223755
Cell 37 2013,1750,182,9770649.98,7013,8401,1388,7781.681319,231.0282262
Cell 38 2013,1750,179,9609595.31,6700,8742,2042,8157.206704,329.8659907
Cell 39 2013,1750,179,9609595.31,6953,8710,1757,8325.290503,313.8753524
Cell 4 2013,1750,182,9770649.98,5853,8050,2197,7534.43956,353.7272404
Cell 40 NE 2013,1750,180,9663280.2,-1724,9795,11519,5415.927778,2625.036571
Cell 41 N 2013,1750,179,9609595.31,-498,8839,9337,7196.212291,1350.977064
Cell 41 NW 2013,1750,182,9770649.98,-1538,9615,11153,6266.434066,2380.665096
Cell 42 NW 2013,1750,179,9609595.31,951,8824,7873,5114.73743,2592.327903
Cell 43 2013,1750,180,9663280.2,2034,8712,6678,6935.227778,1095.029674
Cell 44 2013,1750,180,9663280.2,6563,8369,1806,7704.311111,392.9828988
Cell 45 2013,1750,182,9770649.98,6943,8316,1373,7738.379121,232.3338688
Cell 47 2013,1750,179,9609595.31,6610,8288,1678,7596.318436,340.1419589
Cell 48 2013,1750,181,9716965.09,6270,8492,2222,7820.480663,364.6494054
Cell 49 2013,1750,180,9663280.2,5782,8650,2868,7291.311111,468.9760156
Cell 5 2011/12 Summer,1750,179,9609595.31,5294,8738,3444,7752.681564,615.395412
Cell 5 2013,1750,179,9609595.31,5910,8688,2778,7815.027933,569.6403592
Cell 50 2013,1750,179,9609595.31,6475,8387,1912,7743.301676,294.7096072
Cell 51 2013,1750,180,9663280.2,6731,8589,1858,7735.366667,479.2989197
Cell 52 2013,1750,179,9609595.31,6795,8273,1478,7571.547486,246.6418065
Cell 53 2013,1750,182,9770649.98,6027,8149,2122,7493.472527,499.9825347
Cell 54 2013,1750,183,9824334.87,7248,8756,1508,8320.546448,306.239659
Cell 55 2013,1750,180,9663280.2,7123,8870,1747,8233.422222,365.8455041
Cell 56 2013,1750,179,9609595.31,6685,7894,1209,7372.536313,241.234054
Cell 57 2013,1750,183,9824334.87,6083,8208,2125,7340.666667,397.8827344
Cell 58 2013,1750,179,9609595.31,7634,8699,1065,8144.631285,257.3989107
Cell 59 2013,1750,181,9716965.09,6615,8100,1485,7408.132597,255.1376924
Cell 6 2011/12,1750,181,9716965.09,5797,8418,2621,7673.651934,568.4328902
Cell 6 2013,1750,181,9716965.09,7171,8640,1469,7985.524862,327.6500722
Cell 6 NE 2011/12,1750,181,9716965.09,2231,8201,5970,7371.657459,888.3573915
Cell 6 NW 2011/12,1750,180,9663280.2,1692,9201,7509,7268.622222,1369.564161
Cell 6 SW 2011/12,1750,181,9716965.09,1628,8515,6887,6912.917127,1434.545686
Cell 60 2013,1750,178,9555910.42,6044,8138,2094,7177.050562,382.2880888
Cell 61 2013,1750,181,9716965.09,6431,8395,1964,7617.546961,420.6398891
Cell 7 2013,1750,181,9716965.09,5706,8878,3172,8269.364641,434.8791915
Cell 9 NW 2013,1750,181,9716965.09,-736,9468,10204,5597.977901,2491.208988
Cell 9 SE 2013,1750,181,9716965.09,-1842,9827,11669,6549.232044,2166.992705
Cell 9 SW 2013,1750,183,9824334.87,-1428,9827,11255,5724.491803,2171.476619
Cell R1,1750,177,9502225.53,2547,8189,5642,7006.514124,1029.036696
Cell R10,1750,182,9770649.98,5853,8050,2197,7534.43956,353.7272404
Cell R100,1750,179,9609595.31,6475,8387,1912,7743.301676,294.7096072
Cell R101,1750,181,9716965.09,7536,8618,1082,8100.513812,226.4941697
Cell R104,1750,183,9824334.87,7538,8285,747,7921.63388,129.224684
Cell R105,1750,182,9770649.98,6027,8149,2122,7493.472527,499.9825347
Cell R106,1750,182,9770649.98,4165,8573,4408,7454.131868,619.1834965
Cell R107,1750,183,9824334.87,7248,8756,1508,8320.546448,306.239659
Cell R11,1750,179,9609595.31,5910,8688,2778,7815.027933,569.6403592
Cell R111,1750,183,9824334.87,2116,8627,6511,7546.540984,1130.944408
Cell R112,1750,179,9609595.31,6780,8378,1598,7472.24581,306.0658379
Cell R113,1750,183,9824334.87,6083,8208,2125,7340.666667,397.8827344
Cell R114,1750,179,9609595.31,7634,8699,1065,8144.631285,257.3989107
Cell R117,1750,180,9663280.2,6799,9034,2235,7704.311111,476.3116894
Cell R118,1750,179,9609595.31,6685,7894,1209,7372.536313,241.234054
Cell R119,1750,182,9770649.98,6083,7579,1496,6925.758242,322.6125101
Cell R120,1750,180,9663280.2,5837,8293,2456,7716.788889,451.9857912
Cell R121,1750,182,9770649.98,6706,8579,1873,7945.186813,338.9707891
Cell R123,1750,184,9878019.76,7019,8137,1118,7505.728261,196.7581888
Cell R124,1750,178,9555910.42,6512,8138,1626,7324.348315,330.2120055
Cell R125,1750,180,9663280.2,2390,7987,5597,6900.383333,1132.603874
Cell R126,1750,179,9609595.31,5869,8395,2526,7577.357542,564.020103
Cell R15,1750,178,9555910.42,-1839,8429,10268,6250.977528,1874.102802
Cell R16,1750,181,9716965.09,-736,9468,10204,5610.055249,2492.473911
Cell R17,1750,179,9609595.31,3600,8510,4910,7345.26257,855.6804886
Cell R18,1750,180,9663280.2,2843,8837,5994,7032.033333,1170.477855
Cell R19,1750,180,9663280.2,6856,8006,1150,7586.122222,240.3901379
Cell R20,1750,178,9555910.42,4285,8190,3905,7148.550562,750.2725125
Cell R21,1750,178,9555910.42,6858,8521,1663,7888.426966,366.9493241
Cell R22,1750,178,9555910.42,7328,8702,1374,8183.168539,233.8600482
Cell R24,1750,181,9716965.09,-1875,8475,10350,5369.093923,3023.950723
Cell R25,1750,180,9663280.2,791,8757,7966,4188.733333,2397.654019
Cell R26,1750,183,9824334.87,1692,9201,7509,7333.923497,1248.739537
Cell R27,1750,181,9716965.09,6346,8418,2072,7789.314917,423.4604553
Cell R28,1750,183,9824334.87,1629,9768,8139,6418.333333,1625.039612
Cell R29,1750,177,9502225.53,6380,9764,3384,7693,712.8473739
Cell R30,1750,181,9716965.09,5971,8476,2505,7657.220994,445.1813161
Cell R31,1750,180,9663280.2,5511,8498,2987,7862.927778,524.2601987
Cell R35,1750,179,9609595.31,5294,8738,3444,7752.681564,615.395412
Cell R36,1750,182,9770649.98,2565,8886,6321,7892.252747,1010.844175
Cell R37,1750,181,9716965.09,2154,8298,6144,6765.187845,1210.334399
Cell R38,1750,180,9663280.2,6717,8187,1470,7624.938889,264.1772167
Cell R39,1750,182,9770649.98,3953,9211,5258,7362.67033,1043.204215
Cell R40,1750,179,9609595.31,3295,8808,5513,6724.452514,1321.927804
Cell R46,1750,180,9663280.2,448,9056,8608,4465.772222,2519.658058
Cell R47,1750,181,9716965.09,1913,8381,6468,6869.403315,1712.869554
Cell R48,1750,180,9663280.2,1752,9388,7636,7045.883333,1263.566866
Cell R49,1750,182,9770649.98,1860,8427,6567,6984.401099,1316.423493
Cell R5,1750,180,9663280.2,-1970,7872,9842,5765.327778,2032.608819
Cell R50,1750,180,9663280.2,1551,8736,7185,6132.611111,1878.060008
Cell R51,1750,179,9609595.31,4438,8481,4043,7272.815642,764.2918397
Cell R52,1750,179,9609595.31,6476,8244,1768,7587.994413,341.4883706
Cell R53,1750,179,9609595.31,3421,8165,4744,7442.268156,553.3553372
Cell R54,1750,179,9609595.31,6954,8662,1708,8170.435754,377.9934084
Cell R58,1750,181,9716965.09,766,9901,9135,6299.563536,2627.36725
Cell R59,1750,181,9716965.09,4129,9942,5813,7625.292818,771.3889657
Cell R6,1750,183,9824334.87,6317,8356,2039,7778.04918,249.1410003
Cell R60,1750,181,9716965.09,3632,8206,4574,7261.508287,745.4235299
Cell R61,1750,179,9609595.31,1426,9982,8556,6145.703911,2454.223755
Cell R62,1750,179,9609595.31,1093,9348,8255,5282.837989,2072.967204
Cell R63,1750,180,9663280.2,2817,8394,5577,7429.133333,564.9661878
Cell R64,1750,182,9770649.98,7058,8112,1054,7699.450549,224.1115187
Cell R65,1750,181,9716965.09,7166,8566,1400,7909.950276,236.1598222
Cell R66,1750,180,9663280.2,7476,8798,1322,8399.838889,253.5188173
Cell R69,1750,179,9609595.31,453,9332,8879,4503.24581,2532.064169
Cell R7,1750,182,9770649.98,2353,8383,6030,7129.868132,884.045039
Cell R70,1750,178,9555910.42,1919,9302,7383,6551.421348,1616.598366
Cell R71,1750,182,9770649.98,1868,8173,6305,6944.071429,1481.065087
Cell R72,1750,179,9609595.31,1241,9343,8102,4052.860335,2506.478559
Cell R73,1750,180,9663280.2,4793,8632,3839,7770.861111,516.992153
Cell R74,1750,181,9716965.09,5100,8283,3183,7181.867403,670.6136005
Cell R75,1750,182,9770649.98,7013,8401,1388,7781.681319,231.0282262
Cell R76,1750,180,9663280.2,6807,8790,1983,8209.266667,347.7625084
Cell R77,1750,179,9609595.31,6700,8742,2042,8157.206704,329.8659907
Cell R8,1750,182,9770649.98,382,8813,8431,7483.016484,1236.750641
Cell R80,1750,180,9663280.2,-1724,9795,11519,5415.927778,2625.036571
Cell R81,1750,182,9770649.98,7284,8294,1010,7832,198.2118137
Cell R82,1750,179,9609595.31,951,8824,7873,5114.73743,2592.327903
Cell R83,1750,180,9663280.2,1793,8490,6697,6519.361111,1712.337294
Cell R84,1750,181,9716965.09,1376,8712,7336,5057.734807,2140.654737
Cell R85,1750,179,9609595.31,2034,8712,6678,6932.50838,1097.477877
Cell R86,1750,182,9770649.98,6333,8111,1778,7520.379121,308.3859331
Cell R87,1750,181,9716965.09,6943,8316,1373,7741.226519,229.786109
Cell R9,1750,181,9716965.09,4898,8436,3538,7335.41989,553.2303832
Cell R90,1750,180,9663280.2,6610,8288,1678,7597.25,339.4247073
Cell R91,1750,181,9716965.09,6270,8492,2222,7820.480663,364.6494054
Cell R92,1750,179,9609595.31,1249,9683,8434,4151.921788,2557.571532
Cell R93,1750,180,9663280.2,5782,8650,2868,7291.311111,468.9760156
Cell R97,1750,180,9663280.2,2360,8980,6620,7602.85,1101.81557
Cell R98,1750,182,9770649.98,6729,8200,1471,7727.604396,326.2758854
Cell R99,1750,179,9609595.31,6795,8273,1478,7571.547486,246.6418065
Cell S102,1750,183,9824334.87,6757,8580,1823,8001.819672,416.6852611
Cell S108,1750,180,9663280.2,7123,8870,1747,8233.422222,365.8455041
Cell S13,1750,177,9502225.53,6800,8867,2067,8136.384181,402.8679381
Cell S14,1750,181,9716965.09,5706,8878,3172,8269.364641,434.8791915
Cell S2,1750,181,9716965.09,7171,8640,1469,7985.524862,327.6500722
Cell S23,1750,183,9824334.87,7742,8753,1011,8461.136612,195.7407339
Cell S32,1750,178,9555910.42,7119,8721,1602,8114.005618,324.6468868
Cell S33,1750,181,9716965.09,6913,8556,1643,7791.375691,322.1268791
Cell S34,1750,181,9716965.09,7239,8673,1434,8104.734807,271.9763078
Cell S41,1750,178,9555910.42,7064,8404,1340,7786.691011,281.2410299
Cell S42,1750,180,9663280.2,7737,8761,1024,8398.588889,184.6866652
Cell S44,1750,180,9663280.2,7448,8667,1219,8048.755556,280.9914317
Cell S56,1750,179,9609595.31,5634,8677,3043,7794.324022,553.7946557
Cell S67,1750,183,9824334.87,6896,8771,1875,8218.142077,386.4676964
Cell S78,1750,179,9609595.31,6953,8710,1757,8325.290503,313.8753524
Cell S88,1750,182,9770649.98,6375,8657,2282,7899.89011,546.0554847
Cell S94,1750,182,9770649.98,7045,8935,1890,8093.884615,349.9039003
Cell S95,1750,180,9663280.2,6731,8589,1858,7735.366667,479.2989197
W287,1750,178,9555910.42,1284,8994,7710,4441.775281,1675.371461
W295,1750,181,9716965.09,3281,8128,4847,6991.707182,1169.769651
W338,1750,180,9663280.2,2000,9138,7138,6707.861111,1554.205981
W342,1750,181,9716965.09,1482,7842,6360,5824.110497,1688.204734
W345,1750,183,9824334.87,4595,7889,3294,7327.786885,627.6907312
W387,1750,181,9716965.09,2020,8136,6116,6165.629834,1824.322331
W393,1750,181,9716965.09,6007,8536,2529,7415.779006,580.8182224
W440,1750,180,9663280.2,2137,8295,6158,6159.933333,1513.06293
W441,1750,181,9716965.09,6211,8537,2326,7624.635359,286.7096047
W445,1750,180,9663280.2,5842,7682,1840,7134.466667,431.3406414
W500,1750,180,9663280.2,2208,8445,6237,6326.338889,2031.879051
1,2000,235,12615949.15,6317,8455,2138,7771.370213,275.7267132
2,2000,234,12562264.26,1985,8722,6737,6479.017094,1452.109985
3,2000,236,12669634.04,6890,8004,1114,7575.360169,229.3263568
4,2000,238,12777003.82,4757,8029,3272,7215.886555,520.4450985
5,2000,236,12669634.04,123,8738,8615,7522.444915,1077.325361
6,2000,234,12562264.26,4465,8418,3953,7603.952991,647.9674285
7,2000,235,12615949.15,4090,8348,4258,7241.182979,639.9614321
8,2000,237,12723318.93,2057,8165,6108,6416.552743,1217.554994
9,2000,236,12669634.04,6954,8354,1400,7802.487288,306.446355
10,2000,233,12508579.37,1499,8920,7421,6739.83691,1796.031878
11,2000,238,12777003.82,1752,9388,7636,6847.260504,1473.746349
12,2000,239,12830688.71,1551,8736,7185,5985.046025,1881.181551
13,2000,236,12669634.04,4438,8481,4043,7260.885593,758.7148532
14,2000,237,12723318.93,5965,8680,2715,8031.544304,550.8163898
16,2000,238,12777003.82,93,9332,9239,4414.281513,2571.93849
17,2000,236,12669634.04,3632,8258,4626,7276.610169,784.2388411
18,2000,236,12669634.04,1353,9982,8629,5262.622881,2776.455751
19,2000,234,12562264.26,1029,9348,8319,4949.888889,2178.764463
20,2000,236,12669634.04,7013,8401,1388,7801.237288,236.0124666
21,2000,234,12562264.26,6700,8742,2042,8140.863248,326.5675649
22,2000,233,12508579.37,-1724,9795,11519,5109.034335,2913.142671
23,2000,239,12830688.71,951,8824,7873,5210.221757,2507.639355
24,2000,238,12777003.82,6270,8505,2235,7820.340336,378.6548141
25,2000,238,12777003.82,5782,8754,2972,7332.327731,500.006506
26,2000,233,12508579.37,6943,8316,1373,7724.72103,236.8674034
27,2000,236,12669634.04,6729,8234,1505,7702.15678,349.3931858
28,2000,235,12615949.15,6025,8149,2124,7524.66383,493.9888897
29,2000,235,12615949.15,6475,8387,1912,7712.646809,323.5751068
31,2000,234,12562264.26,6423,8681,2258,7683.91453,274.2245032
32,2000,236,12669634.04,6083,8208,2125,7306,397.667351
33,2000,236,12669634.04,6685,8100,1415,7380.279661,247.6958012
34,2000,234,12562264.26,5586,8161,2575,7101.991453,465.2917841
10A,2000,237,12723318.93,1913,8867,6954,6914.337553,1717.016944
10NE,2000,237,12723318.93,2518,8595,6077,7539,957.8211693
10NW,2000,236,12669634.04,2565,8886,6321,7774.911017,1130.443698
10SW,2000,238,12777003.82,674,9056,8382,5476.676471,2275.582988
11NE,2000,235,12615949.15,2154,8432,6278,6805.434043,1274.120572
11NW,2000,237,12723318.93,1361,8976,7615,7116.261603,1410.16435
11SE,2000,234,12562264.26,1860,8427,6567,6770.991453,1481.782958
17NW,2000,234,12562264.26,4129,9942,5813,7649.209402,816.0113193
17SE,2000,235,12615949.15,1868,8173,6305,7004.544681,1408.775307
17SW,2000,238,12777003.82,1919,9302,7383,6308.441176,1802.55702
22S,2000,236,12669634.04,-1724,9795,11519,4918.25,2872.974907
23S,2000,240,12884373.6,1090,7597,6507,2939.345833,1459.80001
24S,2000,235,12615949.15,6270,8505,2235,7814.812766,384.7336839
27A,2000,237,12723318.93,1447,8980,7533,6453.759494,2238.187938
2A,2000,237,12723318.93,1607,8837,7230,6719.679325,1539.750456
5NE,2000,234,12562264.26,-1842,9827,11669,6478.145299,2075.690244
5NW,2000,234,12562264.26,-1428,9827,11255,5814.57265,2060.670235
5SE,2000,237,12723318.93,791,9784,8993,4369.468354,2518.690488
6NE,2000,236,12669634.04,2001,8280,6279,7178.927966,1179.253487
6NW,2000,237,12723318.93,1692,9201,7509,7177.797468,1474.251103
6SW,2000,235,12615949.15,1588,8683,7095,6849.642553,1594.55542
Cell 1 2011/12,2000,235,12615949.15,6317,8455,2138,7771.370213,275.7267132
Cell 1 SW 2013,2000,236,12669634.04,-1957,8429,10386,6044.012712,1998.661252
Cell 10 2011/12,2000,233,12508579.37,1499,8920,7421,6739.83691,1796.031878
Cell 10 NE 2011/12,2000,237,12723318.93,2518,8595,6077,7539,957.8211693
Cell 10 NW 2011/12,2000,236,12669634.04,2565,8886,6321,7774.911017,1130.443698
Cell 10 SE 2013,2000,237,12723318.93,1692,9201,7509,7177.797468,1474.251103
Cell 10 SW 2011/12,2000,238,12777003.82,674,9056,8382,5476.676471,2275.582988
Cell 10-A 2011/12,2000,237,12723318.93,1913,8867,6954,6914.337553,1717.016944
Cell 11 NE 2011/12,2000,235,12615949.15,2154,8432,6278,6805.434043,1274.120572
Cell 11 NW 2013,2000,238,12777003.82,2793,8837,6044,6882.193277,1290.525063
Cell 11 SW 2013,2000,237,12723318.93,5576,8621,3045,7677.759494,648.1698327
Cell 12 2013,2000,234,12562264.26,4090,8348,4258,7240.837607,641.3055588
Cell 13 2013,2000,236,12669634.04,2057,8109,6052,6209.288136,1276.519733
Cell 14 2013,2000,237,12723318.93,7328,8702,1374,8196.227848,232.0759342
Cell 15 2013,2000,236,12669634.04,6458,8429,1971,7691.199153,385.644429
Cell 15-A 2013,2000,237,12723318.93,6875,8556,1681,7815.691983,335.1747357
Cell 16 2013,2000,234,12562264.26,6616,8737,2121,7922.790598,373.0326098
Cell 17 NW 2011/12,2000,234,12562264.26,4129,9942,5813,7649.209402,816.0113193
Cell 17 NW 2013,2000,235,12615949.15,-1875,8482,10357,5393.680851,2944.960099
Cell 17 SE 2013,2000,236,12669634.04,2565,8886,6321,7774.911017,1130.443698
Cell 17 SW 2013,2000,236,12669634.04,2084,8738,6654,7580.834746,942.3526108
Cell 18 2011/12,2000,236,12669634.04,1353,9982,8629,5262.622881,2776.455751
Cell 18 NE 2013,2000,235,12615949.15,1542,8757,7215,6883.451064,1674.08363
Cell 18 NW 2013,2000,235,12615949.15,791,8763,7972,4048.32766,2442.573956
Cell 18 SE 2013,2000,235,12615949.15,2154,8432,6278,6805.434043,1274.120572
Cell 18 SSE 2013,2000,235,12615949.15,2391,8976,6585,7276.331915,1136.887667
Cell 19 NW 2013,2000,235,12615949.15,5797,8641,2844,7812.519149,439.9334605
Cell 2 2011/12,2000,234,12562264.26,1985,8722,6737,6479.017094,1452.109985
Cell 2 NE 2013,2000,234,12562264.26,620,8528,7908,6765.628205,1409.445158
Cell 2 SW 2013,2000,235,12615949.15,6317,8455,2138,7774.646809,274.8219825
Cell 20 2013,2000,236,12669634.04,5331,9773,4442,7733.029661,766.4568956
Cell 21 2013,2000,237,12723318.93,3295,8808,5513,6830.008439,1267.586547
Cell 22 2013,2000,237,12723318.93,6954,8354,1400,7791.953586,286.2144197
Cell 23 2013,2000,239,12830688.71,7564,8761,1197,8355.694561,213.0263769
Cell 24 2013,2000,233,12508579.37,7239,8673,1434,8069.493562,276.8184066
Cell 25 NE 2013,2000,233,12508579.37,1499,8920,7421,6739.83691,1796.031878
Cell 25 SE 2013,2000,238,12777003.82,674,9056,8382,5476.676471,2275.582988
Cell 26 NE 2013,2000,238,12777003.82,1752,9388,7636,6847.260504,1473.746349
Cell 26 NNW 2013,2000,237,12723318.93,2518,8595,6077,7539,957.8211693
Cell 26 NW 2013,2000,237,12723318.93,1913,8867,6954,6914.337553,1717.016944
Cell 27 NW 2013,2000,233,12508579.37,1860,8427,6567,6769.450644,1484.772279
Cell 28 2013,2000,239,12830688.71,1551,8736,7185,5985.046025,1881.181551
Cell 29 2013,2000,238,12777003.82,4438,8481,4043,7260.983193,756.4804894
Cell 3 NE 2013,2000,236,12669634.04,382,8813,8431,7429.118644,1104.937821
Cell 3 NW 2013,2000,236,12669634.04,2353,8383,6030,7072.322034,895.3861574
Cell 30 2013,2000,234,12562264.26,7166,8566,1400,7913.910256,245.867617
Cell 31 2013,2000,236,12669634.04,6954,8676,1722,8196.838983,361.3218662
Cell 32 2013,2000,236,12669634.04,6896,8771,1875,8222.529661,368.3674864
Cell 33 NE 2013,2000,234,12562264.26,4129,9942,5813,7649.209402,816.0113193
Cell 33 SE 2013,2000,238,12777003.82,1919,9302,7383,6308.441176,1802.55702
Cell 33 SW 2013,2000,237,12723318.93,93,9332,9239,4161.544304,2551.110296
Cell 34 N 2013,2000,237,12723318.93,2353,8038,5685,7031.421941,958.166436
Cell 34 NW 2013,2000,236,12669634.04,3632,8258,4626,7276.610169,784.2388411
Cell 34 SE 2013,2000,236,12669634.04,1868,8173,6305,7000.423729,1407.206157
Cell 35 2013,2000,239,12830688.71,1256,9982,8726,5748.23431,2605.809673
Cell 37 2013,2000,233,12508579.37,7013,8401,1388,7792.497854,235.6253687
Cell 38 2013,2000,235,12615949.15,6700,8802,2102,8151.53617,329.1779991
Cell 39 2013,2000,238,12777003.82,6953,8941,1988,8320.432773,315.4414702
Cell 4 2013,2000,235,12615949.15,5853,8050,2197,7525.995745,349.0466712
Cell 40 NE 2013,2000,238,12777003.82,-1724,9795,11519,5010.193277,2764.660159
Cell 41 N 2013,2000,236,12669634.04,-1538,8839,10377,7124.65678,1477.45311
Cell 41 NW 2013,2000,235,12615949.15,-1813,9615,11428,6255.093617,2483.311956
Cell 42 NW 2013,2000,235,12615949.15,951,8824,7873,4935.004255,2593.675159
Cell 43 2013,2000,237,12723318.93,1570,8712,7142,6747.907173,1382.29522
Cell 44 2013,2000,239,12830688.71,6268,8369,2101,7665.828452,402.8062647
Cell 45 2013,2000,235,12615949.15,6943,8316,1373,7721.046809,240.8938893
Cell 47 2013,2000,237,12723318.93,5907,8457,2550,7608.852321,386.7494519
Cell 48 2013,2000,234,12562264.26,6270,8505,2235,7813.264957,384.8240889
Cell 49 2013,2000,239,12830688.71,5782,8754,2972,7335.225941,500.958645
Cell 5 2011/12 Summer,2000,235,12615949.15,2084,8738,6654,7581.974468,944.1931642
Cell 5 2013,2000,236,12669634.04,5910,8688,2778,7785.991525,584.531255
Cell 50 2013,2000,235,12615949.15,6475,8387,1912,7712.646809,323.5751068
Cell 51 2013,2000,239,12830688.71,6731,8796,2065,7799.108787,473.8574683
Cell 52 2013,2000,236,12669634.04,6795,8273,1478,7580.372881,246.9656806
Cell 53 2013,2000,235,12615949.15,6025,8149,2124,7524.66383,493.9888897
Cell 54 2013,2000,235,12615949.15,7248,8766,1518,8278.348936,336.1970888
Cell 55 2013,2000,237,12723318.93,6994,8870,1876,8215.299578,370.1000876
Cell 56 2013,2000,236,12669634.04,6685,8100,1415,7379.402542,247.7955243
Cell 57 2013,2000,234,12562264.26,6083,8208,2125,7306.991453,397.8589385
Cell 58 2013,2000,237,12723318.93,7428,8699,1271,8135.666667,260.1373758
Cell 59 2013,2000,237,12723318.93,6615,8100,1485,7389.85654,261.7806045
Cell 6 2011/12,2000,234,12562264.26,4465,8418,3953,7603.952991,647.9674285
Cell 6 2013,2000,233,12508579.37,6362,8640,2278,7955.446352,378.8831882
Cell 6 NE 2011/12,2000,236,12669634.04,2001,8280,6279,7178.927966,1179.253487
Cell 6 NW 2011/12,2000,237,12723318.93,1692,9201,7509,7177.797468,1474.251103
Cell 6 SW 2011/12,2000,235,12615949.15,1588,8683,7095,6849.642553,1594.55542
Cell 60 2013,2000,236,12669634.04,5586,8138,2552,7207.504237,406.2209937
Cell 61 2013,2000,233,12508579.37,5983,8395,2412,7589.901288,449.5888094
Cell 7 2013,2000,237,12723318.93,5706,9084,3378,8337.004219,412.5999533
Cell 9 NW 2013,2000,233,12508579.37,-736,9468,10204,5592.751073,2414.205102
Cell 9 SE 2013,2000,235,12615949.15,-1842,9827,11669,6470.66383,2074.428482
Cell 9 SW 2013,2000,236,12669634.04,-1428,9827,11255,5830.978814,2059.739058
Cell R1,2000,241,12938058.49,1417,8189,6772,6838.995851,1251.588148
Cell R10,2000,235,12615949.15,5853,8050,2197,7525.995745,349.0466712
Cell R100,2000,235,12615949.15,6475,8387,1912,7712.646809,323.5751068
Cell R101,2000,234,12562264.26,7150,8618,1468,8084.91453,235.0952734
Cell R104,2000,234,12562264.26,7538,8756,1218,7935.846154,156.8841434
Cell R105,2000,235,12615949.15,6025,8149,2124,7524.66383,493.9888897
Cell R106,2000,235,12615949.15,3466,8573,5107,7360.944681,757.3404369
Cell R107,2000,235,12615949.15,7248,8766,1518,8278.348936,336.1970888
Cell R11,2000,236,12669634.04,5910,8688,2778,7785.991525,584.531255
Cell R111,2000,236,12669634.04,1981,8627,6646,7408.055085,1355.922611
Cell R112,2000,237,12723318.93,6780,8378,1598,7485.561181,304.0223202
Cell R113,2000,234,12562264.26,6083,8208,2125,7306.991453,397.8589385
Cell R114,2000,237,12723318.93,7428,8699,1271,8135.666667,260.1373758
Cell R117,2000,235,12615949.15,6799,9347,2548,7736.578723,501.2207705
Cell R118,2000,236,12669634.04,6685,8100,1415,7379.402542,247.7955243
Cell R119,2000,235,12615949.15,6083,7689,1606,6964.680851,324.9090417
Cell R120,2000,241,12938058.49,5201,8401,3200,7668.506224,525.5348599
Cell R121,2000,236,12669634.04,6706,8579,1873,7972.381356,328.7068118
Cell R123,2000,236,12669634.04,6999,8137,1138,7493.707627,202.2641211
Cell R124,2000,237,12723318.93,6309,8138,1829,7326.265823,342.1861848
Cell R125,2000,238,12777003.82,2390,8098,5708,6850.39916,1175.250231
Cell R126,2000,236,12669634.04,5338,8395,3057,7459.944915,626.855288
Cell R15,2000,236,12669634.04,-1957,8429,10386,6044.012712,1998.661252
Cell R16,2000,234,12562264.26,-736,9468,10204,5621.534188,2407.626574
Cell R17,2000,235,12615949.15,3600,8510,4910,7234.438298,949.365853
Cell R18,2000,240,12884373.6,2793,8837,6044,6867.25,1286.065847
Cell R19,2000,233,12508579.37,6507,8050,1543,7564.270386,270.5976216
Cell R20,2000,236,12669634.04,4285,8190,3905,7150.762712,758.1893762
Cell R21,2000,237,12723318.93,6858,8521,1663,7876.78903,355.5738896
Cell R22,2000,237,12723318.93,7328,8702,1374,8196.227848,232.0759342
Cell R24,2000,235,12615949.15,-1875,8482,10357,5393.680851,2944.960099
Cell R25,2000,235,12615949.15,791,8763,7972,4048.32766,2442.573956
Cell R26,2000,236,12669634.04,1692,9201,7509,7198.042373,1423.306501
Cell R27,2000,235,12615949.15,5797,8641,2844,7812.519149,439.9334605
Cell R28,2000,235,12615949.15,1629,9768,8139,6365.259574,1680.412856
Cell R29,2000,236,12669634.04,5331,9773,4442,7733.029661,766.4568956
Cell R30,2000,236,12669634.04,5971,8476,2505,7626.911017,477.2257626
Cell R31,2000,236,12669634.04,5511,8498,2987,7853.542373,486.8978967
Cell R35,2000,235,12615949.15,2084,8738,6654,7581.974468,944.1931642
Cell R36,2000,236,12669634.04,2565,8886,6321,7774.911017,1130.443698
Cell R37,2000,235,12615949.15,2154,8432,6278,6805.434043,1274.120572
Cell R38,2000,238,12777003.82,5517,8825,3308,7583.088235,375.0059784
Cell R39,2000,234,12562264.26,3953,9211,5258,7448.452991,1008.561864
Cell R40,2000,237,12723318.93,3295,8808,5513,6830.008439,1267.586547
Cell R46,2000,238,12777003.82,448,9056,8608,4485.693277,2553.516273
Cell R47,2000,237,12723318.93,1913,8867,6954,6914.337553,1717.016944
Cell R48,2000,238,12777003.82,1752,9388,7636,6847.260504,1473.746349
Cell R49,2000,233,12508579.37,1860,8427,6567,6769.450644,1484.772279
Cell R5,2000,237,12723318.93,-1970,7872,9842,5740.687764,1989.056396
Cell R50,2000,240,12884373.6,1551,8736,7185,5982.291667,1877.7412
Cell R51,2000,236,12669634.04,4438,8481,4043,7253.440678,762.3452446
Cell R52,2000,235,12615949.15,6476,8564,2088,7600.680851,352.2816998
Cell R53,2000,236,12669634.04,3421,8206,4785,7407.389831,608.2463544
Cell R54,2000,235,12615949.15,6954,8676,1722,8197.710638,361.8421328
Cell R58,2000,236,12669634.04,766,9901,9135,5869.631356,2673.933381
Cell R59,2000,234,12562264.26,4129,9942,5813,7649.209402,816.0113193
Cell R6,2000,235,12615949.15,6317,8455,2138,7774.646809,274.8219825
Cell R60,2000,236,12669634.04,3632,8258,4626,7276.610169,784.2388411
Cell R61,2000,239,12830688.71,1256,9982,8726,5748.23431,2605.809673
Cell R62,2000,236,12669634.04,1029,9348,8319,4932.050847,2189.932542
Cell R63,2000,236,12669634.04,2817,8394,5577,7291.639831,811.1782297
Cell R64,2000,237,12723318.93,6585,8112,1527,7690.160338,262.162702
Cell R65,2000,234,12562264.26,7166,8566,1400,7913.910256,245.867617
Cell R66,2000,239,12830688.71,7476,8798,1322,8415.468619,245.5896117
Cell R69,2000,237,12723318.93,93,9332,9239,4161.544304,2551.110296
Cell R7,2000,236,12669634.04,2353,8383,6030,7072.322034,895.3861574
Cell R70,2000,238,12777003.82,1919,9302,7383,6308.441176,1802.55702
Cell R71,2000,235,12615949.15,1868,8173,6305,6996.92766,1409.17393
Cell R72,2000,236,12669634.04,396,9343,8947,3895.165254,2459.593263
Cell R73,2000,235,12615949.15,3016,8681,5665,7650.297872,712.2810022
Cell R74,2000,235,12615949.15,4611,9230,4619,7233.897872,806.7601599
Cell R75,2000,233,12508579.37,7013,8401,1388,7792.497854,235.6253687
Cell R76,2000,240,12884373.6,6807,8790,1983,8188.595833,332.5458727
Cell R77,2000,235,12615949.15,6700,8802,2102,8151.53617,329.1779991
Cell R8,2000,236,12669634.04,-384,8813,9197,7400.021186,1424.29844
Cell R80,2000,238,12777003.82,-1724,9795,11519,5010.193277,2764.660159
Cell R81,2000,234,12562264.26,6788,8677,1889,7814.811966,219.0303586
Cell R82,2000,235,12615949.15,951,8824,7873,4935.004255,2593.675159
Cell R83,2000,238,12777003.82,922,8490,7568,6278.319328,1905.282431
Cell R84,2000,235,12615949.15,1376,8712,7336,4818.531915,2210.081235
Cell R85,2000,238,12777003.82,1570,8712,7142,6726.903361,1416.7804
Cell R86,2000,236,12669634.04,6214,8291,2077,7496.042373,329.1369015
Cell R87,2000,234,12562264.26,6943,8316,1373,7724.209402,236.4897202
Cell R9,2000,239,12830688.71,2998,8436,5438,7353.853556,622.7207339
Cell R90,2000,237,12723318.93,5907,8457,2550,7608.852321,386.7494519
Cell R91,2000,234,12562264.26,6270,8505,2235,7813.264957,384.8240889
Cell R92,2000,238,12777003.82,1249,9683,8434,3853.617647,2517.688546
Cell R93,2000,239,12830688.71,5782,8754,2972,7335.225941,500.958645
Cell R97,2000,236,12669634.04,2140,8980,6840,7368.830508,1306.515085
Cell R98,2000,235,12615949.15,6729,8234,1505,7705.217021,346.965287
Cell R99,2000,236,12669634.04,6795,8273,1478,7580.372881,246.9656806
Cell S102,2000,235,12615949.15,6740,8632,1892,8010.2,441.8443338
Cell S108,2000,237,12723318.93,6994,8870,1876,8215.299578,370.1000876
Cell S13,2000,236,12669634.04,6446,8867,2421,8097.987288,469.0000857
Cell S14,2000,236,12669634.04,5706,9084,3378,8335.419492,412.7528063
Cell S2,2000,233,12508579.37,6362,8640,2278,7955.446352,378.8831882
Cell S23,2000,236,12669634.04,7742,8753,1011,8445.724576,199.8660897
Cell S32,2000,238,12777003.82,6934,8721,1787,8097.743697,354.0684034
Cell S33,2000,236,12669634.04,6875,8556,1681,7816.080508,335.8308409
Cell S34,2000,233,12508579.37,7239,8673,1434,8069.493562,276.8184066
Cell S41,2000,237,12723318.93,7064,8404,1340,7776.291139,265.9448954
Cell S42,2000,239,12830688.71,7564,8761,1197,8355.694561,213.0263769
Cell S44,2000,239,12830688.71,7448,8667,1219,8063.891213,279.4263188
Cell S56,2000,235,12615949.15,5634,8697,3063,7851.706383,525.6061981
Cell S67,2000,237,12723318.93,6896,8771,1875,8223.586498,367.9478813
Cell S78,2000,237,12723318.93,6953,8941,1988,8319.801688,315.9562919
Cell S88,2000,236,12669634.04,6375,8657,2282,7940.889831,529.0719615
Cell S94,2000,236,12669634.04,7045,8935,1890,8115.381356,345.8255884
Cell S95,2000,240,12884373.6,6731,8796,2065,7797.470833,473.5467497
W287,2000,236,12669634.04,1259,8994,7735,4338.694915,1733.490688
W295,2000,234,12562264.26,3281,8300,5019,7083.649573,1118.843762
W338,2000,237,12723318.93,2000,9138,7138,6567.147679,1644.758454
W342,2000,239,12830688.71,1482,7842,6360,5730.301255,1825.399222
W345,2000,235,12615949.15,4595,7917,3322,7327.680851,610.4592797
W387,2000,234,12562264.26,2015,8209,6194,5978.316239,1964.459529
W393,2000,234,12562264.26,3144,8536,5392,7415.247863,633.733253
W440,2000,237,12723318.93,1908,8295,6387,6098.324895,1595.281029
W441,2000,235,12615949.15,4856,8537,3681,7600.344681,355.7549066
W445,2000,237,12723318.93,5065,7904,2839,7093.345992,495.245963
W500,2000,237,12723318.93,1512,8445,6933,6216.312236,2081.119494
1,2250,295,15837042.55,3920,8455,4535,7734.932203,414.2887253
2,2250,298,15998097.22,1985,8722,6737,6462.258389,1437.868794
3,2250,297,15944412.33,6485,8004,1519,7566.636364,252.9520305
4,2250,298,15998097.22,3928,8190,4262,7145.667785,652.6768374
5,2250,299,16051782.11,-1428,8738,10166,7336.983278,1435.357391
6,2250,298,15998097.22,3909,8418,4509,7554.59396,751.4651636
7,2250,299,16051782.11,4090,8348,4258,7248.32107,658.7761308
8,2250,298,15998097.22,2057,8165,6108,6448.489933,1251.640138
9,2250,299,16051782.11,6954,8354,1400,7812.010033,303.4052279
10,2250,298,15998097.22,674,8920,8246,6646.325503,1941.624767
11,2250,302,16212836.78,1059,9388,8329,6616.046358,1705.919231
12,2250,300,16105467,1551,8736,7185,5873.993333,1874.795688
13,2250,300,16105467,4438,8481,4043,7188.836667,781.6382688
14,2250,299,16051782.11,5965,8680,2715,8045.866221,527.1529724
16,2250,301,16159151.89,93,9332,9239,4157.780731,2587.015628
17,2250,297,15944412.33,3632,8258,4626,7302.131313,751.4000263
18,2250,296,15890727.44,1256,9982,8726,4875.368243,2792.939406
19,2250,304,16320206.56,1029,9348,8319,4751.842105,2264.485481
20,2250,298,15998097.22,6478,8401,1923,7799.181208,253.8695975
21,2250,297,15944412.33,6656,8802,2146,8131.515152,343.7608311
22,2250,296,15890727.44,-1894,9795,11689,4888.307432,2932.59006
23,2250,293,15729672.77,951,8824,7873,4982.692833,2573.202594
24,2250,300,16105467,5635,8505,2870,7789.14,425.676654
25,2250,293,15729672.77,5782,8754,2972,7357.013652,513.9978152
26,2250,300,16105467,6943,8547,1604,7712.17,266.3192966
27,2250,300,16105467,6729,8234,1505,7693.906667,345.2041009
28,2250,301,16159151.89,6025,8149,2124,7550.275748,464.6794348
29,2250,298,15998097.22,6327,8387,2060,7684.885906,362.9542935
31,2250,299,16051782.11,6423,8681,2258,7679.943144,284.6324746
32,2250,298,15998097.22,6083,8208,2125,7273.748322,396.0929918
33,2250,299,16051782.11,6685,8445,1760,7390.719064,256.2139078
34,2250,297,15944412.33,5586,8364,2778,7156.521886,478.6256352
10A,2250,300,16105467,1913,8867,6954,6964.743333,1712.534787
10NE,2250,298,15998097.22,1589,8621,7032,7347.983221,1312.590789
10NW,2250,301,16159151.89,2565,8886,6321,7654.700997,1280.606923
10SW,2250,302,16212836.78,674,9056,8382,5226.639073,2364.141244
11NE,2250,295,15837042.55,2154,8432,6278,6805.169492,1323.048557
11NW,2250,297,15944412.33,628,8976,8348,6902.993266,1742.036358
11SE,2250,299,16051782.11,1716,8463,6747,6658.772575,1518.035536
17NW,2250,298,15998097.22,3119,9942,6823,7608.778523,980.884051
17SE,2250,299,16051782.11,1868,8240,6372,7057.752508,1355.582477
17SW,2250,302,16212836.78,-199,9716,9915,6155.31457,1864.031795
22S,2250,301,16159151.89,-1724,9795,11519,4781.554817,2847.341246
23S,2250,300,16105467,1090,7597,6507,3007.57,1461.300642
24S,2250,302,16212836.78,5635,8505,2870,7776.589404,450.3013968
27A,2250,298,15998097.22,1447,8980,7533,6383.761745,2209.515379
2A,2250,297,15944412.33,1607,8837,7230,6581.727273,1629.134629
5NE,2250,299,16051782.11,-1842,9827,11669,6433.09699,1995.596096
5NW,2250,297,15944412.33,-1842,9827,11669,5734.26936,2093.221885
5SE,2250,298,15998097.22,791,9784,8993,4251.04698,2559.964572
6NE,2250,295,15837042.55,2001,8280,6279,7026.115254,1365.687539
6NW,2250,294,15783357.66,1692,9201,7509,7060.29932,1615.730788
6SW,2250,301,16159151.89,1542,8717,7175,6826.049834,1720.245648
Cell 1 2011/12,2250,295,15837042.55,3920,8455,4535,7734.932203,414.2887253
Cell 1 SW 2013,2250,300,16105467,-1957,8429,10386,5900.633333,2030.932971
Cell 10 2011/12,2250,298,15998097.22,674,8920,8246,6646.325503,1941.624767
Cell 10 NE 2011/12,2250,298,15998097.22,1589,8621,7032,7347.983221,1312.590789
Cell 10 NW 2011/12,2250,301,16159151.89,2565,8886,6321,7654.700997,1280.606923
Cell 10 SE 2013,2250,294,15783357.66,1692,9201,7509,7060.29932,1615.730788
Cell 10 SW 2011/12,2250,302,16212836.78,674,9056,8382,5226.639073,2364.141244
Cell 10-A 2011/12,2250,300,16105467,1913,8867,6954,6964.743333,1712.534787
Cell 11 NE 2011/12,2250,295,15837042.55,2154,8432,6278,6805.169492,1323.048557
Cell 11 NW 2013,2250,297,15944412.33,1985,8837,6852,6732.13468,1440.694827
Cell 11 SW 2013,2250,299,16051782.11,5576,8980,3404,7726.334448,620.3552563
Cell 12 2013,2250,299,16051782.11,4090,8348,4258,7247.160535,658.8324737
Cell 13 2013,2250,299,16051782.11,2057,8165,6108,6283.230769,1318.695615
Cell 14 2013,2250,297,15944412.33,7328,8702,1374,8197.747475,231.2311222
Cell 15 2013,2250,297,15944412.33,6458,8429,1971,7739.212121,406.8831748
Cell 15-A 2013,2250,299,16051782.11,6875,8590,1715,7822.993311,360.2386611
Cell 16 2013,2250,299,16051782.11,6616,8737,2121,7916.26087,379.0836322
Cell 17 NW 2011/12,2250,298,15998097.22,3119,9942,6823,7608.778523,980.884051
Cell 17 NW 2013,2250,295,15837042.55,-1875,8626,10501,5491.501695,2786.93648
Cell 17 SE 2013,2250,301,16159151.89,2565,8886,6321,7654.700997,1280.606923
Cell 17 SW 2013,2250,300,16105467,123,8738,8615,7385.566667,1310.59565
Cell 18 2011/12,2250,296,15890727.44,1256,9982,8726,4875.368243,2792.939406
Cell 18 NE 2013,2250,298,15998097.22,1542,8757,7215,6792.194631,1765.766431
Cell 18 NW 2013,2250,297,15944412.33,791,9784,8993,4021.414141,2516.367469
Cell 18 SE 2013,2250,295,15837042.55,2154,8432,6278,6805.169492,1323.048557
Cell 18 SSE 2013,2250,299,16051782.11,1185,9027,7842,7079.675585,1469.910649
Cell 19 NW 2013,2250,299,16051782.11,4884,8641,3757,7822.090301,489.1479199
Cell 2 2011/12,2250,298,15998097.22,1985,8722,6737,6462.258389,1437.868794
Cell 2 NE 2013,2250,300,16105467,-1502,8656,10158,6534.4,1646.27065
Cell 2 SW 2013,2250,298,15998097.22,3920,8455,4535,7735.402685,413.6086877
Cell 20 2013,2250,297,15944412.33,3611,9773,6162,7714.555556,808.6208347
Cell 21 2013,2250,299,16051782.11,3295,8808,5513,6907.411371,1204.802822
Cell 22 2013,2250,301,16159151.89,6954,8354,1400,7805.584718,274.3195089
Cell 23 2013,2250,294,15783357.66,7372,8761,1389,8326.020408,235.9761596
Cell 24 2013,2250,297,15944412.33,7239,8673,1434,8057.380471,281.0016716
Cell 25 NE 2013,2250,297,15944412.33,674,8920,8246,6664.59596,1919.146887
Cell 25 SE 2013,2250,302,16212836.78,674,9056,8382,5226.639073,2364.141244
Cell 26 NE 2013,2250,302,16212836.78,1059,9388,8329,6616.046358,1705.919231
Cell 26 NNW 2013,2250,298,15998097.22,1589,8621,7032,7347.983221,1312.590789
Cell 26 NW 2013,2250,298,15998097.22,1913,8867,6954,6961.013423,1717.332126
Cell 27 NW 2013,2250,299,16051782.11,1716,8463,6747,6658.772575,1518.035536
Cell 28 2013,2250,300,16105467,1551,8736,7185,5873.993333,1874.795688
Cell 29 2013,2250,298,15998097.22,4438,8481,4043,7189,784.2292373
Cell 3 NE 2013,2250,297,15944412.33,-384,8813,9197,7398.942761,1215.806742
Cell 3 NW 2013,2250,297,15944412.33,2353,8383,6030,7030.542088,952.2286347
Cell 30 2013,2250,297,15944412.33,7166,8567,1401,7920,249.8905215
Cell 31 2013,2250,300,16105467,6954,8720,1766,8211.42,356.5452897
Cell 32 2013,2250,301,16159151.89,6707,8771,2064,8219.003322,381.4430503
Cell 33 NE 2013,2250,299,16051782.11,3119,9942,6823,7611.488294,980.359044
Cell 33 SE 2013,2250,302,16212836.78,-199,9716,9915,6155.31457,1864.031795
Cell 33 SW 2013,2250,299,16051782.11,93,9332,9239,3960.83612,2549.690726
Cell 34 N 2013,2250,299,16051782.11,2115,8045,5930,6913.32107,1162.210412
Cell 34 NW 2013,2250,297,15944412.33,3632,8258,4626,7302.131313,751.4000263
Cell 34 SE 2013,2250,296,15890727.44,1868,8240,6372,7052.945946,1360.521307
Cell 35 2013,2250,293,15729672.77,1256,9982,8726,5511.709898,2710.499571
Cell 37 2013,2250,297,15944412.33,6478,8401,1923,7806.06734,251.4585242
Cell 38 2013,2250,301,16159151.89,6656,8802,2146,8139.943522,341.1552975
Cell 39 2013,2250,299,16051782.11,6953,8941,1988,8320.849498,310.1534857
Cell 4 2013,2250,301,16159151.89,5853,8350,2497,7519.923588,348.0221059
Cell 40 NE 2013,2250,293,15729672.77,-1724,9795,11519,4994.249147,2732.431902
Cell 41 N 2013,2250,300,16105467,-1538,8839,10377,7078.17,1488.905368
Cell 41 NW 2013,2250,295,15837042.55,-1813,9615,11428,6216.962712,2495.146518
Cell 42 NW 2013,2250,301,16159151.89,-10,8824,8834,4744.358804,2633.088712
Cell 43 2013,2250,301,16159151.89,1570,8712,7142,6635.186047,1586.854062
Cell 44 2013,2250,301,16159151.89,6268,8369,2101,7646.44186,414.1553476
Cell 45 2013,2250,300,16105467,6943,8547,1604,7712.513333,266.3311031
Cell 47 2013,2250,299,16051782.11,4551,9694,5143,7584.558528,523.0762548
Cell 48 2013,2250,300,16105467,5635,8505,2870,7775.84,451.6307648
Cell 49 2013,2250,293,15729672.77,5782,8754,2972,7357.013652,513.9978152
Cell 5 2011/12 Summer,2250,300,16105467,123,8738,8615,7385.566667,1310.59565
Cell 5 2013,2250,298,15998097.22,5910,8688,2778,7804.187919,565.6844565
Cell 50 2013,2250,298,15998097.22,6327,8387,2060,7684.885906,362.9542935
Cell 51 2013,2250,300,16105467,6731,8796,2065,7848.883333,458.397371
Cell 52 2013,2250,299,16051782.11,6795,8273,1478,7596.491639,259.3731363
Cell 53 2013,2250,301,16159151.89,6025,8149,2124,7550.275748,464.6794348
Cell 54 2013,2250,299,16051782.11,6996,8774,1778,8241.762542,367.5560437
Cell 55 2013,2250,298,15998097.22,6994,8870,1876,8190.59396,383.6284288
Cell 56 2013,2250,300,16105467,6685,8445,1760,7387.656667,255.9230329
Cell 57 2013,2250,299,16051782.11,6083,8208,2125,7273.240803,395.5271182
Cell 58 2013,2250,299,16051782.11,7428,8699,1271,8129.755853,256.1797366
Cell 59 2013,2250,296,15890727.44,6193,8526,2333,7376.996622,284.212241
Cell 6 2011/12,2250,298,15998097.22,3909,8418,4509,7554.59396,751.4651636
Cell 6 2013,2250,299,16051782.11,5628,8640,3012,7915.839465,451.8719751
Cell 6 NE 2011/12,2250,295,15837042.55,2001,8280,6279,7026.115254,1365.687539
Cell 6 NW 2011/12,2250,294,15783357.66,1692,9201,7509,7060.29932,1615.730788
Cell 6 SW 2011/12,2250,301,16159151.89,1542,8717,7175,6826.049834,1720.245648
Cell 60 2013,2250,301,16159151.89,5586,8138,2552,7223.787375,455.5682676
Cell 61 2013,2250,299,16051782.11,5600,8405,2805,7593.672241,472.1229783
Cell 7 2013,2250,300,16105467,5706,9125,3419,8381.336667,392.0853266
Cell 9 NW 2013,2250,299,16051782.11,-1020,9468,10488,5615.839465,2376.454723
Cell 9 SE 2013,2250,299,16051782.11,-1842,9827,11669,6433.09699,1995.596096
Cell 9 SW 2013,2250,296,15890727.44,-1842,9827,11669,5732.516892,2096.53723
Cell R1,2250,293,15729672.77,1313,8189,6876,6664.129693,1431.652823
Cell R10,2250,301,16159151.89,5853,8350,2497,7519.923588,348.0221059
Cell R100,2250,297,15944412.33,6327,8387,2060,7684.084175,363.3012908
Cell R101,2250,299,16051782.11,6836,8618,1782,8042.317726,265.5269942
Cell R104,2250,300,16105467,7069,8784,1715,7951.73,206.1216722
Cell R105,2250,302,16212836.78,6025,8149,2124,7549.546358,464.0820208
Cell R106,2250,299,16051782.11,2072,8587,6515,7205.979933,1013.745009
Cell R107,2250,299,16051782.11,6996,8774,1778,8241.762542,367.5560437
Cell R11,2250,298,15998097.22,5910,8688,2778,7804.187919,565.6844565
Cell R111,2250,301,16159151.89,1717,8680,6963,7286.116279,1525.982377
Cell R112,2250,298,15998097.22,6780,8378,1598,7510.439597,310.4976921
Cell R113,2250,299,16051782.11,6083,8208,2125,7273.240803,395.5271182
Cell R114,2250,299,16051782.11,7428,8699,1271,8129.755853,256.1797366
Cell R117,2250,297,15944412.33,6799,9347,2548,7763.585859,514.7374018
Cell R118,2250,300,16105467,6685,8445,1760,7387.656667,255.9230329
Cell R119,2250,301,16159151.89,6083,7837,1754,7002.372093,351.4291105
Cell R120,2250,293,15729672.77,5201,8401,3200,7666.883959,531.6388149
Cell R121,2250,301,16159151.89,6706,8579,1873,7988.272425,315.9969072
Cell R123,2250,302,16212836.78,6615,8137,1522,7481.781457,212.9165304
Cell R124,2250,297,15944412.33,6309,8138,1829,7307.737374,358.1829354
Cell R125,2250,302,16212836.78,2390,8373,5983,6825.956954,1194.421845
Cell R126,2250,299,16051782.11,4872,8395,3523,7379.187291,651.7103495
Cell R15,2250,300,16105467,-1957,8429,10386,5900.633333,2030.932971
Cell R16,2250,297,15944412.33,-1020,9468,10488,5651.498316,2343.083706
Cell R17,2250,297,15944412.33,3387,8510,5123,7141.515152,1072.447395
Cell R18,2250,300,16105467,1985,8837,6852,6721.606667,1448.564972
Cell R19,2250,297,15944412.33,5274,8330,3056,7526.858586,326.1455133
Cell R20,2250,297,15944412.33,4285,8294,4009,7150.915825,748.7639981
Cell R21,2250,299,16051782.11,6858,8521,1663,7856.200669,350.6740569
Cell R22,2250,297,15944412.33,7328,8702,1374,8197.747475,231.2311222
Cell R24,2250,295,15837042.55,-1875,8626,10501,5491.501695,2786.93648
Cell R25,2250,297,15944412.33,791,9784,8993,4021.414141,2516.367469
Cell R26,2250,300,16105467,1692,9201,7509,7087.723333,1569.663737
Cell R27,2250,298,15998097.22,5797,8641,2844,7831.949664,459.3513746
Cell R28,2250,301,16159151.89,1617,9768,8151,6333.518272,1749.705979
Cell R29,2250,297,15944412.33,3611,9773,6162,7714.555556,808.6208347
Cell R30,2250,300,16105467,5971,8476,2505,7596.263333,484.2900997
Cell R31,2250,299,16051782.11,5511,8498,2987,7844.257525,461.7188809
Cell R35,2250,300,16105467,123,8738,8615,7385.566667,1310.59565
Cell R36,2250,301,16159151.89,2565,8886,6321,7654.700997,1280.606923
Cell R37,2250,295,15837042.55,2154,8432,6278,6805.169492,1323.048557
Cell R38,2250,301,16159151.89,3945,8825,4880,7493.302326,570.4153802
Cell R39,2250,299,16051782.11,3909,9211,5302,7451.083612,996.683116
Cell R40,2250,299,16051782.11,3295,8808,5513,6907.411371,1204.802822
Cell R46,2250,298,15998097.22,448,9056,8608,4590.137584,2544.78167
Cell R47,2250,300,16105467,1913,8867,6954,6964.743333,1712.534787
Cell R48,2250,302,16212836.78,1059,9388,8329,6616.046358,1705.919231
Cell R49,2250,298,15998097.22,1716,8463,6747,6655.308725,1519.400343
Cell R5,2250,294,15783357.66,-1970,7872,9842,5716.482993,1943.021456
Cell R50,2250,300,16105467,1551,8736,7185,5873.993333,1874.795688
Cell R51,2250,299,16051782.11,3815,8481,4666,7178.448161,806.8699877
Cell R52,2250,300,16105467,6476,8564,2088,7618.69,363.9169327
Cell R53,2250,299,16051782.11,3421,8206,4785,7409.29097,613.9505163
Cell R54,2250,300,16105467,6954,8720,1766,8211.42,356.5452897
Cell R58,2250,298,15998097.22,648,9901,9253,5503.687919,2662.722849
Cell R59,2250,299,16051782.11,3119,9942,6823,7608.408027,979.2632891
Cell R6,2250,298,15998097.22,3920,8455,4535,7735.402685,413.6086877
Cell R60,2250,298,15998097.22,3632,8258,4626,7303.681208,750.6136208
Cell R61,2250,293,15729672.77,1256,9982,8726,5511.709898,2710.499571
Cell R62,2250,297,15944412.33,1029,9348,8319,4699.114478,2275.761065
Cell R63,2250,297,15944412.33,1618,8394,6776,7189.983165,979.4937174
Cell R64,2250,300,16105467,3906,8157,4251,7677.94,388.1085541
Cell R65,2250,297,15944412.33,7166,8567,1401,7920,249.8905215
Cell R66,2250,302,16212836.78,7476,8798,1322,8433.357616,235.7133416
Cell R69,2250,299,16051782.11,93,9332,9239,3960.83612,2549.690726
Cell R7,2250,297,15944412.33,2353,8383,6030,7030.542088,952.2286347
Cell R70,2250,302,16212836.78,-199,9716,9915,6155.31457,1864.031795
Cell R71,2250,296,15890727.44,1868,8240,6372,7052.945946,1360.521307
Cell R72,2250,297,15944412.33,396,9343,8947,3988.861953,2453.351049
Cell R73,2250,299,16051782.11,2201,8790,6589,7483.9699,1002.817003
Cell R74,2250,299,16051782.11,1908,9341,7433,7178.364548,1064.191343
Cell R75,2250,298,15998097.22,6478,8401,1923,7805.610738,251.1595581
Cell R76,2250,302,16212836.78,6807,8790,1983,8189.854305,320.9652433
Cell R77,2250,300,16105467,6656,8802,2146,8140.023333,341.7206112
Cell R8,2250,300,16105467,-384,8813,9197,7359.826667,1391.828547
Cell R80,2250,293,15729672.77,-1724,9795,11519,4994.249147,2732.431902
Cell R81,2250,299,16051782.11,5973,8677,2704,7760.093645,316.9227847
Cell R82,2250,300,16105467,-10,8824,8834,4755.696667,2630.128133
Cell R83,2250,298,15998097.22,922,8649,7727,6059.355705,2159.362513
Cell R84,2250,299,16051782.11,1376,8712,7336,4674.752508,2229.738545
Cell R85,2250,300,16105467,1570,8712,7142,6632.88,1588.993023
Cell R86,2250,299,16051782.11,6214,8291,2077,7480.41806,341.7797739
Cell R87,2250,300,16105467,6943,8547,1604,7712.513333,266.3311031
Cell R9,2250,293,15729672.77,382,8436,8054,7361.167235,739.9270945
Cell R90,2250,299,16051782.11,4551,9694,5143,7584.558528,523.0762548
Cell R91,2250,300,16105467,5635,8505,2870,7775.84,451.6307648
Cell R92,2250,298,15998097.22,1249,9683,8434,3648.580537,2415.90691
Cell R93,2250,293,15729672.77,5782,8754,2972,7357.013652,513.9978152
Cell R97,2250,300,16105467,1998,8980,6982,7157.496667,1480.273014
Cell R98,2250,300,16105467,6729,8234,1505,7693.906667,345.2041009
Cell R99,2250,299,16051782.11,6795,8273,1478,7598.979933,260.734375
Cell S102,2250,296,15890727.44,6740,8632,1892,8002.706081,465.3977499
Cell S108,2250,298,15998097.22,6994,8870,1876,8190.59396,383.6284288
Cell S13,2250,297,15944412.33,6446,8867,2421,8093.747475,473.1728141
Cell S14,2250,300,16105467,5706,9125,3419,8381.336667,392.0853266
Cell S2,2250,298,15998097.22,5628,8640,3012,7915.993289,452.6216993
Cell S23,2250,299,16051782.11,7384,8753,1369,8428.832776,218.1397916
Cell S32,2250,298,15998097.22,6934,8721,1787,8092.892617,361.2018741
Cell S33,2250,299,16051782.11,6875,8590,1715,7822.993311,360.2386611
Cell S34,2250,297,15944412.33,7239,8673,1434,8057.380471,281.0016716
Cell S41,2250,299,16051782.11,6917,8404,1487,7786.434783,260.2533977
Cell S42,2250,295,15837042.55,7372,8761,1389,8325.545763,235.7163991
Cell S44,2250,300,16105467,7394,8667,1273,8080.48,292.5359059
Cell S56,2250,299,16051782.11,5634,8793,3159,7899.314381,523.0403031
Cell S67,2250,301,16159151.89,6707,8771,2064,8219.003322,381.4430503
Cell S78,2250,299,16051782.11,6953,8941,1988,8320.849498,310.1534857
Cell S88,2250,301,16159151.89,6375,8657,2282,7989.903654,508.4095983
Cell S94,2250,301,16159151.89,7045,8935,1890,8121.518272,342.9299549
Cell S95,2250,300,16105467,6731,8796,2065,7848.883333,458.397371
W287,2250,297,15944412.33,1259,8994,7735,4194.309764,1716.452513
W295,2250,299,16051782.11,3037,8421,5384,7083.454849,1123.139666
W338,2250,294,15783357.66,1448,9138,7690,6372.180272,1826.639472
W342,2250,295,15837042.55,1482,7842,6360,5649.810169,1889.501438
W345,2250,301,16159151.89,3814,7917,4103,7305.388704,678.7123815
W387,2250,298,15998097.22,1191,8209,7018,5825.318792,2066.472087
W393,2250,297,15944412.33,3144,8537,5393,7372.942761,747.5621164
W440,2250,298,15998097.22,1780,8295,6515,6072.530201,1650.476929
W441,2250,300,16105467,3781,8537,4756,7572.566667,443.7607376
W445,2250,294,15783357.66,4655,8446,3791,7069.119048,541.3998385
W500,2250,297,15944412.33,1427,8445,7018,6105.292929,2131.948177
1,2500,368,19756039.52,3920,8455,4535,7681.339674,580.9629341
2,2500,364,19541299.96,1985,8722,6737,6471.195055,1413.987425
3,2500,369,19809724.41,6406,8046,1640,7560.168022,279.0673666
4,2500,371,19917094.19,3928,8190,4262,7125.059299,675.811914
5,2500,366,19648669.74,-1428,8738,10166,7063.166667,1850.612188
6,2500,367,19702354.63,3356,8418,5062,7530.978202,816.1260018
7,2500,367,19702354.63,3975,9768,5793,7240.06267,696.0999011
8,2500,368,19756039.52,2057,8165,6108,6482.913043,1273.129695
9,2500,368,19756039.52,6954,8354,1400,7828.038043,294.9986987
10,2500,366,19648669.74,674,8920,8246,6566.535519,2011.712899
11,2500,372,19970779.08,1059,9388,8329,6397.424731,1886.33849
12,2500,376,20185518.64,1494,8736,7242,5713.292553,1947.096508
13,2500,373,20024463.97,3815,8481,4666,7104.772118,839.2077006
14,2500,368,19756039.52,5965,8680,2715,8058.557065,499.8286957
16,2500,371,19917094.19,93,9332,9239,3999.237197,2559.590096
17,2500,371,19917094.19,1623,8300,6677,7323.703504,764.0259542
18,2500,366,19648669.74,1023,9982,8959,4622.530055,2745.24693
19,2500,366,19648669.74,1029,9348,8319,4654.31694,2329.174953
20,2500,370,19863409.3,6095,8401,2306,7788.094595,287.2601123
21,2500,369,19809724.41,6613,8802,2189,8134.937669,350.1838293
22,2500,367,19702354.63,-1894,9795,11689,4762.313351,2935.402268
23,2500,369,19809724.41,-10,8824,8834,4732.97832,2651.053527
24,2500,372,19970779.08,5635,8505,2870,7741.852151,468.5782284
25,2500,367,19702354.63,3522,9040,5518,7337.13079,584.9591889
26,2500,367,19702354.63,6943,8547,1604,7719.839237,276.4313136
27,2500,366,19648669.74,6729,8323,1594,7707.437158,334.3961365
28,2500,366,19648669.74,5711,8149,2438,7564.584699,454.6011008
29,2500,372,19970779.08,6325,8711,2386,7659.27957,396.3528925
31,2500,367,19702354.63,6423,8681,2258,7669.389646,300.0346995
32,2500,367,19702354.63,4215,8212,3997,7220.498638,478.5564856
33,2500,372,19970779.08,6685,8445,1760,7394.827957,266.0102017
34,2500,367,19702354.63,5586,8364,2778,7216.299728,493.905343
10A,2500,372,19970779.08,1337,8867,7530,6918.782258,1740.317268
10NE,2500,371,19917094.19,1167,8673,7506,7202.530997,1586.280578
10NW,2500,366,19648669.74,2565,8886,6321,7564.939891,1373.113924
10SW,2500,373,20024463.97,628,9056,8428,5112.340483,2427.981095
11NE,2500,366,19648669.74,2154,8438,6284,6749.215847,1385.656616
11NW,2500,370,19863409.3,108,9328,9220,6731.783784,1973.87944
11SE,2500,366,19648669.74,1716,8463,6747,6517.464481,1581.229486
17NW,2500,367,19702354.63,3119,9942,6823,7603.297003,977.3935012
17SE,2500,367,19702354.63,1868,8841,6973,7081.179837,1368.86506
17SW,2500,372,19970779.08,-1250,9795,11045,5888.857527,2107.438228
22S,2500,366,19648669.74,-1724,9795,11519,4699.737705,2833.908612
23S,2500,376,20185518.64,1090,8095,7005,3156.640957,1551.292855
24S,2500,367,19702354.63,5471,8505,3034,7741.283379,481.1732271
27A,2500,372,19970779.08,1447,8980,7533,6353.448925,2172.978981
2A,2500,370,19863409.3,1607,8837,7230,6509.705405,1689.85036
5NE,2500,368,19756039.52,-1842,9827,11669,6300.657609,1991.646929
5NW,2500,364,19541299.96,-1842,9827,11669,5667.637363,2144.011126
5SE,2500,372,19970779.08,791,9784,8993,4065.717742,2542.850906
6NE,2500,367,19702354.63,2001,8280,6279,6943.708447,1436.638286
6NW,2500,366,19648669.74,1692,9201,7509,6986.259563,1693.629135
6SW,2500,366,19648669.74,1542,8757,7215,6797.153005,1817.507599
Cell 1 2011/12,2500,368,19756039.52,3920,8455,4535,7681.339674,580.9629341
Cell 1 SW 2013,2500,372,19970779.08,-1957,8948,10905,5771.080645,2091.97218
Cell 10 2011/12,2500,366,19648669.74,674,8920,8246,6566.535519,2011.712899
Cell 10 NE 2011/12,2500,371,19917094.19,1167,8673,7506,7202.530997,1586.280578
Cell 10 NW 2011/12,2500,366,19648669.74,2565,8886,6321,7564.939891,1373.113924
Cell 10 SE 2013,2500,366,19648669.74,1692,9201,7509,6986.259563,1693.629135
Cell 10 SW 2011/12,2500,373,20024463.97,628,9056,8428,5112.340483,2427.981095
Cell 10-A 2011/12,2500,372,19970779.08,1337,8867,7530,6918.782258,1740.317268
Cell 11 NE 2011/12,2500,366,19648669.74,2154,8438,6284,6749.215847,1385.656616
Cell 11 NW 2013,2500,371,19917094.19,1950,8837,6887,6670.797844,1489.078586
Cell 11 SW 2013,2500,370,19863409.3,5576,8980,3404,7763.048649,596.648892
Cell 12 2013,2500,367,19702354.63,3975,9768,5793,7240.06267,696.0999011
Cell 13 2013,2500,371,19917094.19,2057,8165,6108,6354.002695,1334.182154
Cell 14 2013,2500,370,19863409.3,7328,8702,1374,8186.802703,236.1155729
Cell 15 2013,2500,368,19756039.52,6458,8429,1971,7764.32337,414.6333717
Cell 15-A 2013,2500,366,19648669.74,6875,8590,1715,7827.953552,374.1508353
Cell 16 2013,2500,365,19594984.85,6616,8737,2121,7908.057534,384.4006322
Cell 17 NW 2011/12,2500,367,19702354.63,3119,9942,6823,7603.297003,977.3935012
Cell 17 NW 2013,2500,366,19648669.74,-1875,8626,10501,5571.068306,2636.190311
Cell 17 SE 2013,2500,366,19648669.74,2565,8886,6321,7564.939891,1373.113924
Cell 17 SW 2013,2500,371,19917094.19,-1428,8738,10166,7119.827493,1717.630162
Cell 18 2011/12,2500,366,19648669.74,1023,9982,8959,4622.530055,2745.24693
Cell 18 NE 2013,2500,371,19917094.19,1542,8757,7215,6700.967655,1890.854794
Cell 18 NW 2013,2500,366,19648669.74,791,9784,8993,3905.601093,2513.105505
Cell 18 SE 2013,2500,366,19648669.74,2154,8438,6284,6749.215847,1385.656616
Cell 18 SSE 2013,2500,367,19702354.63,465,9027,8562,6793.60218,1780.263898
Cell 19 NW 2013,2500,367,19702354.63,4884,8641,3757,7795.520436,551.7385443
Cell 2 2011/12,2500,364,19541299.96,1985,8722,6737,6471.195055,1413.987425
Cell 2 NE 2013,2500,366,19648669.74,-1502,8656,10158,6371.259563,1747.345381
Cell 2 SW 2013,2500,367,19702354.63,3920,8455,4535,7681.008174,581.7191401
Cell 20 2013,2500,372,19970779.08,3611,9773,6162,7677.967742,851.9097862
Cell 21 2013,2500,371,19917094.19,3295,8808,5513,6931.876011,1178.033242
Cell 22 2013,2500,366,19648669.74,6954,8354,1400,7809.36612,268.1288683
Cell 23 2013,2500,367,19702354.63,7372,8761,1389,8298.839237,255.2392558
Cell 24 2013,2500,367,19702354.63,7239,8682,1443,8071.049046,286.8356398
Cell 25 NE 2013,2500,368,19756039.52,674,8920,8246,6558.288043,2022.594979
Cell 25 SE 2013,2500,373,20024463.97,628,9056,8428,5112.340483,2427.981095
Cell 26 NE 2013,2500,372,19970779.08,1059,9388,8329,6397.424731,1886.33849
Cell 26 NNW 2013,2500,370,19863409.3,1167,8673,7506,7201.791892,1588.358957
Cell 26 NW 2013,2500,372,19970779.08,1337,8867,7530,6918.782258,1740.317268
Cell 27 NW 2013,2500,366,19648669.74,1716,8463,6747,6517.464481,1581.229486
Cell 28 2013,2500,376,20185518.64,1494,8736,7242,5713.292553,1947.096508
Cell 29 2013,2500,372,19970779.08,3815,8481,4666,7106.147849,840.5222085
Cell 3 NE 2013,2500,368,19756039.52,-384,8813,9197,7394.535326,1185.244982
Cell 3 NW 2013,2500,368,19756039.52,2353,8528,6175,6958.57337,1041.486795
Cell 30 2013,2500,367,19702354.63,7166,8641,1475,7931.321526,263.7332588
Cell 31 2013,2500,372,19970779.08,6954,8747,1793,8224.701613,356.0279071
Cell 32 2013,2500,366,19648669.74,6169,8858,2689,8216.445355,395.3027283
Cell 33 NE 2013,2500,367,19702354.63,3119,9942,6823,7603.297003,977.3935012
Cell 33 SE 2013,2500,372,19970779.08,-1250,9795,11045,5888.857527,2107.438228
Cell 33 SW 2013,2500,371,19917094.19,93,9332,9239,3756.576819,2515.834684
Cell 34 N 2013,2500,371,19917094.19,2115,8825,6710,6922.336927,1181.14754
Cell 34 NW 2013,2500,370,19863409.3,1623,8300,6677,7323.767568,765.0567299
Cell 34 SE 2013,2500,368,19756039.52,1868,8452,6584,7078.25,1363.578862
Cell 35 2013,2500,367,19702354.63,879,9982,9103,5244.427793,2794.595221
Cell 37 2013,2500,367,19702354.63,6478,8401,1923,7800.493188,264.6691613
Cell 38 2013,2500,372,19970779.08,6613,8802,2189,8137.145161,345.8452407
Cell 39 2013,2500,371,19917094.19,6692,8941,2249,8317.679245,304.5856663
Cell 4 2013,2500,367,19702354.63,5853,8350,2497,7519.509537,349.1023433
Cell 40 NE 2013,2500,367,19702354.63,-1894,9795,11689,4939.452316,2761.774883
Cell 41 N 2013,2500,371,19917094.19,-1538,8839,10377,7023.239892,1551.574845
Cell 41 NW 2013,2500,368,19756039.52,-1813,9615,11428,6118.432065,2594.416024
Cell 42 NW 2013,2500,372,19970779.08,-10,8824,8834,4615.510753,2660.904693
Cell 43 2013,2500,373,20024463.97,1570,8712,7142,6615.436997,1611.088162
Cell 44 2013,2500,372,19970779.08,5923,8369,2446,7611.819892,434.8954668
Cell 45 2013,2500,365,19594984.85,6943,8547,1604,7719.490411,277.0879649
Cell 47 2013,2500,371,19917094.19,2310,9694,7384,7444.849057,882.880042
Cell 48 2013,2500,368,19756039.52,5471,8505,3034,7743.831522,480.5052525
Cell 49 2013,2500,367,19702354.63,3522,9040,5518,7337.13079,584.9591889
Cell 5 2011/12 Summer,2500,370,19863409.3,-1428,8738,10166,7120.383784,1719.916341
Cell 5 2013,2500,369,19809724.41,5910,8688,2778,7833.723577,545.5975561
Cell 50 2013,2500,372,19970779.08,6325,8711,2386,7659.27957,396.3528925
Cell 51 2013,2500,376,20185518.64,6731,8796,2065,7884.393617,442.7569027
Cell 52 2013,2500,371,19917094.19,6647,8273,1626,7616.932615,274.722557
Cell 53 2013,2500,366,19648669.74,5711,8149,2438,7564.584699,454.6011008
Cell 54 2013,2500,367,19702354.63,6996,8961,1965,8205.247956,404.7699937
Cell 55 2013,2500,368,19756039.52,6386,8870,2484,8160.611413,406.0061021
Cell 56 2013,2500,372,19970779.08,6685,8445,1760,7394.827957,266.0102017
Cell 57 2013,2500,365,19594984.85,4215,8212,3997,7220.528767,479.859417
Cell 58 2013,2500,368,19756039.52,7428,8699,1271,8121.461957,254.4417881
Cell 59 2013,2500,365,19594984.85,6193,8596,2403,7388.567123,302.2357676
Cell 6 2011/12,2500,367,19702354.63,3356,8418,5062,7530.978202,816.1260018
Cell 6 2013,2500,367,19702354.63,5628,8640,3012,7892.144414,441.1411983
Cell 6 NE 2011/12,2500,367,19702354.63,2001,8280,6279,6943.708447,1436.638286
Cell 6 NW 2011/12,2500,366,19648669.74,1692,9201,7509,6986.259563,1693.629135
Cell 6 SW 2011/12,2500,366,19648669.74,1542,8757,7215,6797.153005,1817.507599
Cell 60 2013,2500,372,19970779.08,5586,8364,2778,7244.975806,477.0914927
Cell 61 2013,2500,367,19702354.63,5600,8405,2805,7588.168937,473.1498531
Cell 7 2013,2500,373,20024463.97,5706,9125,3419,8404.319035,370.4262635
Cell 9 NW 2013,2500,365,19594984.85,-1020,9468,10488,5589.665753,2364.596707
Cell 9 SE 2013,2500,369,19809724.41,-1842,9827,11669,6297.826558,1989.687716
Cell 9 SW 2013,2500,363,19487615.07,-1842,9827,11669,5662.341598,2144.583549
Cell R1,2500,369,19809724.41,1313,8189,6876,6483.582656,1632.263653
Cell R10,2500,366,19648669.74,5853,8350,2497,7519.603825,349.574267
Cell R100,2500,372,19970779.08,6325,8711,2386,7659.27957,396.3528925
Cell R101,2500,367,19702354.63,6475,8618,2143,7989.302452,319.2512759
Cell R104,2500,367,19702354.63,7069,8852,1783,7947.697548,234.5116174
Cell R105,2500,366,19648669.74,5711,8149,2438,7564.584699,454.6011008
Cell R106,2500,367,19702354.63,2072,8587,6515,7082.013624,1199.606265
Cell R107,2500,367,19702354.63,6996,8961,1965,8205.247956,404.7699937
Cell R11,2500,369,19809724.41,5910,8688,2778,7833.723577,545.5975561
Cell R111,2500,366,19648669.74,1717,8899,7182,7185.333333,1659.199813
Cell R112,2500,368,19756039.52,6780,8378,1598,7534.307065,316.6790152
Cell R113,2500,366,19648669.74,4215,8212,3997,7220.603825,479.2055685
Cell R114,2500,368,19756039.52,7428,8699,1271,8121.461957,254.4417881
Cell R117,2500,366,19648669.74,6799,9347,2548,7761.721311,513.2531347
Cell R118,2500,371,19917094.19,6685,8445,1760,7395,266.3477957
Cell R119,2500,366,19648669.74,5485,7858,2373,7014.986339,373.2294703
Cell R120,2500,369,19809724.41,5201,8401,3200,7635.452575,563.4124864
Cell R121,2500,366,19648669.74,6706,8633,1927,8010.005464,313.2280546
Cell R123,2500,366,19648669.74,6615,8834,2219,7482.185792,241.3076023
Cell R124,2500,371,19917094.19,6044,8138,2094,7305.474394,369.8863543
Cell R125,2500,372,19970779.08,2277,8373,6096,6775.185484,1213.013884
Cell R126,2500,371,19917094.19,3613,8395,4782,7347.522911,676.6139387
Cell R15,2500,372,19970779.08,-1957,8948,10905,5771.080645,2091.97218
Cell R16,2500,368,19756039.52,-1020,9468,10488,5593.663043,2359.458095
Cell R17,2500,369,19809724.41,2816,8510,5694,7157.631436,1104.381434
Cell R18,2500,376,20185518.64,1950,8837,6887,6635.699468,1519.573727
Cell R19,2500,367,19702354.63,5198,8330,3132,7498.073569,371.5117691
Cell R20,2500,370,19863409.3,3928,8304,4376,7123.194595,790.9744554
Cell R21,2500,370,19863409.3,6858,8521,1663,7844.47027,344.6986234
Cell R22,2500,370,19863409.3,7328,8702,1374,8186.802703,236.1155729
Cell R24,2500,365,19594984.85,-1875,8626,10501,5564.775342,2637.052326
Cell R25,2500,366,19648669.74,791,9784,8993,3905.601093,2513.105505
Cell R26,2500,366,19648669.74,1692,9201,7509,7012.956284,1625.870062
Cell R27,2500,367,19702354.63,4884,8641,3757,7795.520436,551.7385443
Cell R28,2500,366,19648669.74,1617,9768,8151,6265.710383,1834.829375
Cell R29,2500,372,19970779.08,3611,9773,6162,7677.967742,851.9097862
Cell R30,2500,366,19648669.74,5971,8476,2505,7588.147541,487.9443275
Cell R31,2500,372,19970779.08,5511,8498,2987,7819.69086,473.4137675
Cell R35,2500,370,19863409.3,-1428,8738,10166,7120.383784,1719.916341
Cell R36,2500,366,19648669.74,2565,8886,6321,7564.939891,1373.113924
Cell R37,2500,366,19648669.74,2154,8438,6284,6749.215847,1385.656616
Cell R38,2500,372,19970779.08,1592,8825,7233,7291.333333,1042.522271
Cell R39,2500,367,19702354.63,2264,9211,6947,7429.13079,1001.280335
Cell R40,2500,371,19917094.19,3295,8808,5513,6931.876011,1178.033242
Cell R46,2500,371,19917094.19,448,9056,8608,4709.506739,2520.927951
Cell R47,2500,372,19970779.08,1337,8867,7530,6918.782258,1740.317268
Cell R48,2500,372,19970779.08,1059,9388,8329,6397.424731,1886.33849
Cell R49,2500,366,19648669.74,1716,8463,6747,6517.464481,1581.229486
Cell R5,2500,366,19648669.74,-1970,8349,10319,5717.060109,1919.363082
Cell R50,2500,376,20185518.64,1494,8736,7242,5713.292553,1947.096508
Cell R51,2500,370,19863409.3,3815,8481,4666,7103.621622,846.3934377
Cell R52,2500,371,19917094.19,3955,8651,4696,7609.787062,444.8317656
Cell R53,2500,369,19809724.41,3421,8408,4987,7416.96206,600.2119894
Cell R54,2500,372,19970779.08,6954,8747,1793,8224.701613,356.0279071
Cell R58,2500,367,19702354.63,648,9901,9253,5238.106267,2621.300233
Cell R59,2500,367,19702354.63,3119,9942,6823,7603.297003,977.3935012
Cell R6,2500,366,19648669.74,3920,8455,4535,7683.84153,579.9788785
Cell R60,2500,370,19863409.3,1623,8300,6677,7323.767568,765.0567299
Cell R61,2500,367,19702354.63,879,9982,9103,5244.427793,2794.595221
Cell R62,2500,371,19917094.19,1029,9348,8319,4523.652291,2325.011982
Cell R63,2500,369,19809724.41,1202,8394,7192,6984.601626,1367.175494
Cell R64,2500,368,19756039.52,3349,8188,4839,7651.475543,482.9064119
Cell R65,2500,367,19702354.63,7166,8641,1475,7931.321526,263.7332588
Cell R66,2500,373,20024463.97,7476,8798,1322,8438.691689,230.0408493
Cell R69,2500,371,19917094.19,93,9332,9239,3756.576819,2515.834684
Cell R7,2500,368,19756039.52,2353,8528,6175,6958.57337,1041.486795
Cell R70,2500,372,19970779.08,-1250,9795,11045,5888.857527,2107.438228
Cell R71,2500,369,19809724.41,1868,8452,6584,7081.9729,1363.601446
Cell R72,2500,368,19756039.52,396,9343,8947,4235.391304,2535.033021
Cell R73,2500,372,19970779.08,1727,9342,7615,7281.123656,1343.007436
Cell R74,2500,367,19702354.63,1899,9341,7442,7057.370572,1269.826618
Cell R75,2500,367,19702354.63,6478,8401,1923,7800.493188,264.6691613
Cell R76,2500,373,20024463.97,6807,8790,1983,8175.80429,316.3461754
Cell R77,2500,373,20024463.97,6613,8802,2189,8136.560322,345.5654801
Cell R8,2500,366,19648669.74,-384,8813,9197,7359.155738,1308.400362
Cell R80,2500,367,19702354.63,-1894,9795,11689,4939.452316,2761.774883
Cell R81,2500,367,19702354.63,4012,8677,4665,7702.694823,470.9575723
Cell R82,2500,372,19970779.08,-10,8824,8834,4615.510753,2660.904693
Cell R83,2500,372,19970779.08,857,8664,7807,5854.916667,2352.299334
Cell R84,2500,367,19702354.63,1376,8712,7336,4585.376022,2271.478919
Cell R85,2500,374,20078148.86,1570,8712,7142,6603.05615,1626.603945
Cell R86,2500,367,19702354.63,6214,8291,2077,7466.945504,362.6770916
Cell R87,2500,365,19594984.85,6943,8547,1604,7719.490411,277.0879649
Cell R9,2500,367,19702354.63,382,8436,8054,7368.26158,749.6989167
Cell R90,2500,370,19863409.3,2310,9694,7384,7443.875676,883.8734933
Cell R91,2500,368,19756039.52,5471,8505,3034,7743.831522,480.5052525
Cell R92,2500,372,19970779.08,1249,9683,8434,3505.473118,2311.644959
Cell R93,2500,367,19702354.63,3522,9040,5518,7337.13079,584.9591889
Cell R97,2500,372,19970779.08,1668,8980,7312,6918.526882,1785.67693
Cell R98,2500,366,19648669.74,6729,8323,1594,7707.437158,334.3961365
Cell R99,2500,371,19917094.19,6647,8273,1626,7616.932615,274.722557
Cell S102,2500,368,19756039.52,6731,8730,1999,8008.717391,475.4147177
Cell S108,2500,368,19756039.52,6386,8870,2484,8160.611413,406.0061021
Cell S13,2500,371,19917094.19,6446,8867,2421,8110.25876,465.6932379
Cell S14,2500,373,20024463.97,5706,9125,3419,8404.319035,370.4262635
Cell S2,2500,367,19702354.63,5628,8640,3012,7892.144414,441.1411983
Cell S23,2500,366,19648669.74,6546,8842,2296,8389.710383,269.6372249
Cell S32,2500,372,19970779.08,6934,8938,2004,8098.271505,351.6297371
Cell S33,2500,366,19648669.74,6875,8590,1715,7830.068306,374.6421874
Cell S34,2500,367,19702354.63,7239,8682,1443,8071.049046,286.8356398
Cell S41,2500,371,19917094.19,6917,8404,1487,7793.938005,256.0208548
Cell S42,2500,367,19702354.63,7372,8761,1389,8298.839237,255.2392558
Cell S44,2500,372,19970779.08,7369,8667,1298,8090.892473,290.1867664
Cell S56,2500,371,19917094.19,5634,8793,3159,7924.299191,509.3529688
Cell S67,2500,367,19702354.63,6169,8858,2689,8217,394.9063836
Cell S78,2500,371,19917094.19,6692,8941,2249,8317.679245,304.5856663
Cell S88,2500,366,19648669.74,6375,8915,2540,8040.234973,489.5581084
Cell S94,2500,366,19648669.74,7045,8935,1890,8124.688525,338.7175609
Cell S95,2500,376,20185518.64,6731,8796,2065,7884.393617,442.7569027
W287,2500,368,19756039.52,1259,8994,7735,4100.111413,1701.72033
W295,2500,367,19702354.63,3037,8540,5503,7117.029973,1115.493245
W338,2500,366,19648669.74,1193,9138,7945,6126.620219,2033.06605
W342,2500,367,19702354.63,1482,7842,6360,5591.217984,1911.073274
W345,2500,366,19648669.74,3814,7945,4131,7331.046448,658.8684625
W387,2500,367,19702354.63,1191,8271,7080,5757.299728,2147.02248
W393,2500,368,19756039.52,3144,8537,5393,7279.92663,843.1277964
W440,2500,371,19917094.19,1742,8295,6553,5945.132075,1713.265244
W441,2500,366,19648669.74,3781,8537,4756,7483.571038,593.3755887
W445,2500,366,19648669.74,4655,8446,3791,7049.161202,574.4105543
W500,2500,368,19756039.52,1427,8445,7018,5972.404891,2163.831818
1,2750,446,23943460.94,2583,8455,5872,7582.441704,839.1422617
2,2750,444,23836091.16,1985,8837,6852,6472.93018,1423.066201
3,2750,446,23943460.94,6406,8046,1640,7553.336323,292.2631713
4,2750,449,24104515.61,2251,8294,6043,7122.908686,774.20526
5,2750,449,24104515.61,-1555,8738,10293,6823.282851,2143.536699
6,2750,446,23943460.94,3113,8576,5463,7532.269058,837.2426875
7,2750,444,23836091.16,2164,9768,7604,7187.768018,876.4512021
8,2750,447,23997145.83,2057,8165,6108,6529.304251,1282.822692
9,2750,448,24050830.72,6954,8543,1589,7846.470982,288.6660655
10,2750,446,23943460.94,674,8920,8246,6487.908072,2074.480892
11,2750,448,24050830.72,1059,9388,8329,6217.638393,1987.727662
12,2750,448,24050830.72,1494,8736,7242,5539.973214,2040.525045
13,2750,449,24104515.61,3795,8481,4686,7041.959911,894.172638
14,2750,447,23997145.83,5965,8680,2715,8067.136465,467.8945958
16,2750,447,23997145.83,93,9339,9246,4025.322148,2539.059776
17,2750,448,24050830.72,1623,8768,7145,7345.214286,766.1404743
18,2750,445,23889776.05,879,9982,9103,4364.52809,2719.322497
19,2750,450,24158200.5,1029,9348,8319,4565.251111,2384.363867
20,2750,448,24050830.72,6008,8401,2393,7782.4375,307.4120455
21,2750,445,23889776.05,6613,8802,2189,8135.568539,350.0399501
22,2750,443,23782406.27,-1894,9795,11689,4718.724605,2898.007988
23,2750,437,23460296.93,-10,8824,8834,4557.951945,2701.228753
24,2750,448,24050830.72,5069,8505,3436,7674.408482,549.7964766
25,2750,438,23513981.82,1836,9040,7204,7175.26484,983.9656128
26,2750,447,23997145.83,6943,8547,1604,7728.789709,286.8936627
27,2750,448,24050830.72,6729,8323,1594,7718.328125,331.5033828
28,2750,447,23997145.83,5711,8161,2450,7564.375839,439.4669103
29,2750,448,24050830.72,5222,8711,3489,7634.198661,452.9088754
31,2750,446,23943460.94,6423,8681,2258,7658.984305,315.2599216
32,2750,446,23943460.94,3327,8225,4898,7132.713004,674.7964338
33,2750,448,24050830.72,6685,8754,2069,7413.669643,285.3350909
34,2750,444,23836091.16,5586,8364,2778,7256.513514,496.4970467
10A,2750,446,23943460.94,1337,8867,7530,6835.710762,1804.317931
10NE,2750,447,23997145.83,1167,8673,7506,7053.268456,1764.6413
10NW,2750,447,23997145.83,2565,9005,6440,7490.574944,1398.651435
10SW,2750,445,23889776.05,448,9581,9133,5018.204494,2485.61552
11NE,2750,440,23621351.6,1837,8709,6872,6739.825,1446.94165
11NW,2750,448,24050830.72,-195,9328,9523,6530.279018,2177.597979
11SE,2750,446,23943460.94,1716,8463,6747,6391.94843,1636.374498
17NW,2750,447,23997145.83,1186,9942,8756,7504.299776,1174.502665
17SE,2750,447,23997145.83,1336,8841,7505,7019.212528,1480.009918
17SW,2750,448,24050830.72,-1250,9795,11045,5753.299107,2163.049821
22S,2750,447,23997145.83,-1894,9795,11689,4604.161074,2864.023191
23S,2750,448,24050830.72,1090,8095,7005,3230.149554,1579.588898
24S,2750,446,23943460.94,5069,8860,3791,7675.58296,556.5009568
27A,2750,448,24050830.72,1284,8980,7696,6379.357143,2128.968131
2A,2750,447,23997145.83,1607,8837,7230,6401.738255,1749.314341
5NE,2750,446,23943460.94,-1842,9827,11669,6094.717489,2037.248963
5NW,2750,444,23836091.16,-1842,9827,11669,5619.238739,2171.114525
5SE,2750,446,23943460.94,791,9784,8993,3936.717489,2532.635717
6NE,2750,438,23513981.82,1985,8563,6578,6916.803653,1504.430069
6NW,2750,438,23513981.82,1394,9201,7807,6882.006849,1811.354478
6SW,2750,445,23889776.05,1210,8757,7547,6744.368539,1936.294351
Cell 1 2011/12,2750,446,23943460.94,2583,8455,5872,7582.441704,839.1422617
Cell 1 SW 2013,2750,448,24050830.72,-1970,8948,10918,5653.435268,2143.78374
Cell 10 2011/12,2750,446,23943460.94,674,8920,8246,6487.908072,2074.480892
Cell 10 NE 2011/12,2750,447,23997145.83,1167,8673,7506,7053.268456,1764.6413
Cell 10 NW 2011/12,2750,447,23997145.83,2565,9005,6440,7490.574944,1398.651435
Cell 10 SE 2013,2750,438,23513981.82,1394,9201,7807,6882.006849,1811.354478
Cell 10 SW 2011/12,2750,445,23889776.05,448,9581,9133,5018.204494,2485.61552
Cell 10-A 2011/12,2750,446,23943460.94,1337,8867,7530,6835.710762,1804.317931
Cell 11 NE 2011/12,2750,440,23621351.6,1837,8709,6872,6739.825,1446.94165
Cell 11 NW 2013,2750,447,23997145.83,1607,8837,7230,6599.930649,1551.429437
Cell 11 SW 2013,2750,449,24104515.61,5576,8980,3404,7777.158129,580.2056961
Cell 12 2013,2750,447,23997145.83,2154,9768,7614,7166.49217,934.6073763
Cell 13 2013,2750,449,24104515.61,2057,8165,6108,6373.064588,1377.635348
Cell 14 2013,2750,448,24050830.72,7250,8702,1452,8169.006696,254.2986898
Cell 15 2013,2750,446,23943460.94,6458,8604,2146,7807.369955,421.2656245
Cell 15-A 2013,2750,449,24104515.61,6875,8590,1715,7843.458797,384.8772155
Cell 16 2013,2750,446,23943460.94,6616,8737,2121,7916.347534,382.7631518
Cell 17 NW 2011/12,2750,447,23997145.83,1186,9942,8756,7504.299776,1174.502665
Cell 17 NW 2013,2750,440,23621351.6,-1875,8918,10793,5652.85,2520.661015
Cell 17 SE 2013,2750,446,23943460.94,2565,9005,6440,7497.450673,1392.652068
Cell 17 SW 2013,2750,448,24050830.72,-1555,8738,10293,6867.470982,2062.587564
Cell 18 2011/12,2750,445,23889776.05,879,9982,9103,4364.52809,2719.322497
Cell 18 NE 2013,2750,448,24050830.72,1412,8757,7345,6692.198661,1970.676153
Cell 18 NW 2013,2750,443,23782406.27,791,9784,8993,3807.747178,2497.635613
Cell 18 SE 2013,2750,440,23621351.6,1837,8709,6872,6739.825,1446.94165
Cell 18 SSE 2013,2750,444,23836091.16,428,9034,8606,6515.718468,2011.312557
Cell 19 NW 2013,2750,445,23889776.05,4884,9386,4502,7796.391011,559.046596
Cell 2 2011/12,2750,444,23836091.16,1985,8837,6852,6472.93018,1423.066201
Cell 2 NE 2013,2750,446,23943460.94,-1502,8656,10158,6195.717489,1849.964866
Cell 2 SW 2013,2750,445,23889776.05,2583,8455,5872,7593.38427,807.674558
Cell 20 2013,2750,448,24050830.72,3611,9773,6162,7669.174107,825.2465763
Cell 21 2013,2750,450,24158200.5,2443,8808,6365,6935.157778,1159.660795
Cell 22 2013,2750,445,23889776.05,6954,8354,1400,7801.469663,268.8743445
Cell 23 2013,2750,438,23513981.82,7233,8761,1528,8279.76484,270.5227089
Cell 24 2013,2750,445,23889776.05,7239,8801,1562,8087.94382,293.4696646
Cell 25 NE 2013,2750,444,23836091.16,674,8920,8246,6500.921171,2067.991548
Cell 25 SE 2013,2750,445,23889776.05,448,9581,9133,5018.204494,2485.61552
Cell 26 NE 2013,2750,447,23997145.83,1059,9388,8329,6216.158837,1989.703398
Cell 26 NNW 2013,2750,447,23997145.83,1167,8673,7506,7053.268456,1764.6413
Cell 26 NW 2013,2750,446,23943460.94,1337,8867,7530,6835.710762,1804.317931
Cell 27 NW 2013,2750,445,23889776.05,1716,8463,6747,6390.435955,1637.900665
Cell 28 2013,2750,448,24050830.72,1494,8736,7242,5539.973214,2040.525045
Cell 29 2013,2750,450,24158200.5,3795,8481,4686,7043.653333,893.8990596
Cell 3 NE 2013,2750,448,24050830.72,-384,8813,9197,7371.352679,1175.342549
Cell 3 NW 2013,2750,447,23997145.83,2353,8633,6280,6913.362416,1118.159663
Cell 30 2013,2750,445,23889776.05,7166,8690,1524,7944.826966,276.1304271
Cell 31 2013,2750,448,24050830.72,6896,8747,1851,8235.189732,357.9793143
Cell 32 2013,2750,446,23943460.94,6169,8858,2689,8213.580717,402.9681596
Cell 33 NE 2013,2750,447,23997145.83,1186,9942,8756,7504.299776,1174.502665
Cell 33 SE 2013,2750,447,23997145.83,-1250,9795,11045,5745.217002,2158.700548
Cell 33 SW 2013,2750,450,24158200.5,93,9332,9239,3726.271111,2532.735106
Cell 34 N 2013,2750,450,24158200.5,2115,8825,6710,6946.484444,1209.942025
Cell 34 NW 2013,2750,448,24050830.72,1623,8768,7145,7345.214286,766.1404743
Cell 34 SE 2013,2750,447,23997145.83,1336,8841,7505,7044.534676,1444.453161
Cell 35 2013,2750,437,23460296.93,879,9982,9103,5072.478261,2810.164496
Cell 37 2013,2750,443,23782406.27,6008,8401,2393,7784.839729,303.4241443
Cell 38 2013,2750,448,24050830.72,6613,8802,2189,8138.723214,351.0152357
Cell 39 2013,2750,450,24158200.5,6692,8941,2249,8314.195556,301.2439056
Cell 4 2013,2750,445,23889776.05,5853,8386,2533,7516.988764,353.5728234
Cell 40 NE 2013,2750,438,23513981.82,-1894,9795,11689,4944.810502,2750.806032
Cell 41 N 2013,2750,447,23997145.83,-1616,8839,10455,6947.487696,1737.390707
Cell 41 NW 2013,2750,446,23943460.94,-1813,9615,11428,6060.195067,2609.066334
Cell 42 NW 2013,2750,448,24050830.72,-10,8824,8834,4429.183036,2716.201639
Cell 43 2013,2750,447,23997145.83,1376,8712,7336,6551.955257,1679.159928
Cell 44 2013,2750,447,23997145.83,5923,8369,2446,7600.498881,429.8607229
Cell 45 2013,2750,446,23943460.94,6943,8547,1604,7727.746637,286.36722
Cell 47 2013,2750,450,24158200.5,1385,9694,8309,7188,1334.600093
Cell 48 2013,2750,445,23889776.05,5069,8860,3791,7680.269663,549.2595826
Cell 49 2013,2750,438,23513981.82,1836,9040,7204,7175.26484,983.9656128
Cell 5 2011/12 Summer,2750,448,24050830.72,-1555,8738,10293,6867.470982,2062.587564
Cell 5 2013,2750,447,23997145.83,5910,8688,2778,7850.458613,535.291292
Cell 50 2013,2750,448,24050830.72,5222,8711,3489,7634.198661,452.9088754
Cell 51 2013,2750,448,24050830.72,6731,8796,2065,7899.839286,434.0980603
Cell 52 2013,2750,448,24050830.72,6647,8303,1656,7630.475446,276.1368455
Cell 53 2013,2750,447,23997145.83,5711,8161,2450,7564.375839,439.4669103
Cell 54 2013,2750,446,23943460.94,6282,8961,2679,8160.634529,441.2199187
Cell 55 2013,2750,447,23997145.83,6068,8870,2802,8111.257271,450.9989941
Cell 56 2013,2750,448,24050830.72,6685,8754,2069,7410.397321,284.3077875
Cell 57 2013,2750,444,23836091.16,3327,8225,4898,7129.635135,675.3700602
Cell 58 2013,2750,447,23997145.83,7428,8699,1271,8123.237136,248.9507775
Cell 59 2013,2750,445,23889776.05,6193,8624,2431,7403.292135,324.6091376
Cell 6 2011/12,2750,446,23943460.94,3113,8576,5463,7532.269058,837.2426875
Cell 6 2013,2750,446,23943460.94,5628,8640,3012,7880.343049,432.6356769
Cell 6 NE 2011/12,2750,438,23513981.82,1985,8563,6578,6916.803653,1504.430069
Cell 6 NW 2011/12,2750,438,23513981.82,1394,9201,7807,6882.006849,1811.354478
Cell 6 SW 2011/12,2750,445,23889776.05,1210,8757,7547,6744.368539,1936.294351
Cell 60 2013,2750,448,24050830.72,5586,8364,2778,7261.395089,465.0938151
Cell 61 2013,2750,446,23943460.94,5600,8517,2917,7574.692825,502.1823024
Cell 7 2013,2750,446,23943460.94,5706,9125,3419,8393.887892,358.1671717
Cell 9 NW 2013,2750,444,23836091.16,-1084,9468,10552,5484.896396,2419.993351
Cell 9 SE 2013,2750,446,23943460.94,-1842,9827,11669,6094.717489,2037.248963
Cell 9 SW 2013,2750,445,23889776.05,-1842,9827,11669,5614.982022,2170.527753
Cell R1,2750,437,23460296.93,1313,8189,6876,6341.089245,1763.466614
Cell R10,2750,446,23943460.94,5853,8386,2533,7517.336323,353.2523125
Cell R100,2750,448,24050830.72,5222,8711,3489,7634.198661,452.9088754
Cell R101,2750,446,23943460.94,6475,8618,2143,7952.073991,336.3481159
Cell R104,2750,447,23997145.83,4368,8852,4484,7908.373602,386.5693677
Cell R105,2750,447,23997145.83,5711,8161,2450,7564.375839,439.4669103
Cell R106,2750,445,23889776.05,1866,8657,6791,6999.892135,1331.098922
Cell R107,2750,446,23943460.94,6282,8961,2679,8160.634529,441.2199187
Cell R11,2750,447,23997145.83,5910,8688,2778,7850.458613,535.291292
Cell R111,2750,447,23997145.83,1626,9365,7739,7132.290828,1713.34654
Cell R112,2750,447,23997145.83,6732,8378,1646,7546.995526,319.9945749
Cell R113,2750,444,23836091.16,3327,8225,4898,7129.635135,675.3700602
Cell R114,2750,447,23997145.83,7428,8699,1271,8123.237136,248.9507775
Cell R117,2750,443,23782406.27,6767,9347,2580,7733.699774,513.7663984
Cell R118,2750,447,23997145.83,6685,8754,2069,7409.854586,284.3937134
Cell R119,2750,446,23943460.94,4417,7858,3441,7013.217489,439.9729555
Cell R120,2750,437,23460296.93,4695,8451,3756,7601.19222,598.7378713
Cell R121,2750,447,23997145.83,6706,8633,1927,8016.302013,305.2203305
Cell R123,2750,448,24050830.72,6615,9039,2424,7485.430804,296.4776471
Cell R124,2750,448,24050830.72,5586,8364,2778,7297.669643,392.0188108
Cell R125,2750,448,24050830.72,2277,8373,6096,6729.272321,1256.335001
Cell R126,2750,448,24050830.72,3613,8395,4782,7308.466518,725.7108176
Cell R15,2750,448,24050830.72,-1970,8948,10918,5653.435268,2143.78374
Cell R16,2750,444,23836091.16,-1084,9468,10552,5496.916667,2409.109324
Cell R17,2750,448,24050830.72,1969,8720,6751,7179.417411,1152.815744
Cell R18,2750,448,24050830.72,1607,8837,7230,6579.886161,1571.792456
Cell R19,2750,443,23782406.27,1504,9275,7771,7451.24605,586.4447541
Cell R20,2750,447,23997145.83,3037,8547,5510,7089.519016,852.561013
Cell R21,2750,449,24104515.61,6327,8521,2194,7827.211581,355.0147364
Cell R22,2750,448,24050830.72,7250,8702,1452,8169.006696,254.2986898
Cell R24,2750,440,23621351.6,-1875,8918,10793,5652.85,2520.661015
Cell R25,2750,443,23782406.27,791,9784,8993,3807.747178,2497.635613
Cell R26,2750,446,23943460.94,1394,9201,7807,6909.098655,1772.661343
Cell R27,2750,445,23889776.05,4884,9386,4502,7796.391011,559.046596
Cell R28,2750,447,23997145.83,1617,9768,8151,6243.147651,1885.958965
Cell R29,2750,448,24050830.72,3611,9773,6162,7669.174107,825.2465763
Cell R30,2750,446,23943460.94,5971,8476,2505,7571.477578,495.0411707
Cell R31,2750,447,23997145.83,5511,8498,2987,7807.187919,471.2369515
Cell R35,2750,448,24050830.72,-1555,8738,10293,6867.470982,2062.587564
Cell R36,2750,446,23943460.94,2565,9005,6440,7490.775785,1400.212114
Cell R37,2750,441,23675036.49,1675,8709,7034,6728.340136,1465.240451
Cell R38,2750,446,23943460.94,1450,8825,7375,7121.914798,1267.321833
Cell R39,2750,445,23889776.05,1920,9211,7291,7300.680899,1197.229015
Cell R40,2750,450,24158200.5,2443,8808,6365,6935.157778,1159.660795
Cell R46,2750,446,23943460.94,448,9056,8608,4766.017937,2533.478703
Cell R47,2750,446,23943460.94,1337,8867,7530,6835.710762,1804.317931
Cell R48,2750,446,23943460.94,1059,9388,8329,6221.46861,1988.766837
Cell R49,2750,445,23889776.05,1716,8463,6747,6390.435955,1637.900665
Cell R5,2750,439,23567666.71,-1970,8349,10319,5686.312073,1931.683581
Cell R50,2750,448,24050830.72,1494,8736,7242,5539.973214,2040.525045
Cell R51,2750,448,24050830.72,3795,8481,4686,7047.138393,892.5887429
Cell R52,2750,448,24050830.72,3955,8651,4696,7594.575893,483.1758299
Cell R53,2750,448,24050830.72,3421,8408,4987,7420.294643,569.8085031
Cell R54,2750,448,24050830.72,6896,8747,1851,8235.189732,357.9793143
Cell R58,2750,447,23997145.83,385,9901,9516,4951.624161,2612.410001
Cell R59,2750,447,23997145.83,1186,9942,8756,7504.299776,1174.502665
Cell R6,2750,445,23889776.05,2583,8455,5872,7593.38427,807.674558
Cell R60,2750,447,23997145.83,1623,8768,7145,7344.527964,766.8593981
Cell R61,2750,437,23460296.93,879,9982,9103,5072.478261,2810.164496
Cell R62,2750,448,24050830.72,1029,9348,8319,4435.529018,2358.748194
Cell R63,2750,448,24050830.72,1093,8394,7301,6854.703125,1545.769106
Cell R64,2750,447,23997145.83,3349,8200,4851,7634.154362,528.7065902
Cell R65,2750,446,23943460.94,7166,8690,1524,7944.132287,276.2097045
Cell R66,2750,446,23943460.94,7476,8798,1322,8435.719731,227.6992055
Cell R69,2750,450,24158200.5,93,9332,9239,3726.271111,2532.735106
Cell R7,2750,447,23997145.83,2353,8633,6280,6913.362416,1118.159663
Cell R70,2750,447,23997145.83,-1250,9795,11045,5745.217002,2158.700548
Cell R71,2750,447,23997145.83,1336,8841,7505,7044.534676,1444.453161
Cell R72,2750,448,24050830.72,192,9343,9151,4440.705357,2631.521569
Cell R73,2750,447,23997145.83,1298,9342,8044,7053.671141,1662.464548
Cell R74,2750,446,23943460.94,1465,9341,7876,6856.143498,1582.131097
Cell R75,2750,444,23836091.16,6008,8401,2393,7784.891892,303.0842463
Cell R76,2750,448,24050830.72,6807,8790,1983,8162.935268,313.3971875
Cell R77,2750,447,23997145.83,6613,8802,2189,8137.919463,350.9956153
Cell R8,2750,448,24050830.72,-384,8813,9197,7375.299107,1254.839912
Cell R80,2750,438,23513981.82,-1894,9795,11689,4944.810502,2750.806032
Cell R81,2750,447,23997145.83,1940,8677,6737,7561.583893,848.3891732
Cell R82,2750,447,23997145.83,-10,8824,8834,4436.416107,2714.925085
Cell R83,2750,448,24050830.72,422,8664,8242,5717.087054,2481.275545
Cell R84,2750,446,23943460.94,1376,8712,7336,4590.627803,2294.517865
Cell R85,2750,447,23997145.83,1376,8712,7336,6551.955257,1679.159928
Cell R86,2750,447,23997145.83,6066,8291,2225,7450.36689,382.5149376
Cell R87,2750,446,23943460.94,6943,8547,1604,7727.746637,286.36722
Cell R9,2750,437,23460296.93,382,8558,8176,7370.228833,791.1953404
Cell R90,2750,450,24158200.5,1385,9694,8309,7188,1334.600093
Cell R91,2750,445,23889776.05,5069,8860,3791,7679.930337,549.5088652
Cell R92,2750,449,24104515.61,1249,9683,8434,3519.926503,2295.103231
Cell R93,2750,438,23513981.82,1836,9040,7204,7175.26484,983.9656128
Cell R97,2750,448,24050830.72,1284,8980,7696,6751.241071,1940.887184
Cell R98,2750,447,23997145.83,6729,8323,1594,7720.203579,329.4913933
Cell R99,2750,448,24050830.72,6647,8303,1656,7630.475446,276.1368455
Cell S102,2750,447,23997145.83,6731,8730,1999,8005.982103,471.4432025
Cell S108,2750,447,23997145.83,6068,8870,2802,8111.257271,450.9989941
Cell S13,2750,449,24104515.61,6446,8867,2421,8122.786192,463.2691846
Cell S14,2750,446,23943460.94,5706,9125,3419,8393.887892,358.1671717
Cell S2,2750,446,23943460.94,5628,8640,3012,7880.343049,432.6356769
Cell S23,2750,449,24104515.61,6351,8842,2491,8342.706013,353.4315809
Cell S32,2750,449,24104515.61,6934,8938,2004,8098.991091,342.7995316
Cell S33,2750,449,24104515.61,6875,8590,1715,7843.458797,384.8772155
Cell S34,2750,446,23943460.94,7239,8801,1562,8088.215247,293.1963916
Cell S41,2750,449,24104515.61,6917,8459,1542,7787.688196,262.9146141
Cell S42,2750,438,23513981.82,7233,8761,1528,8279.76484,270.5227089
Cell S44,2750,447,23997145.83,7369,8667,1298,8107.724832,284.1924827
Cell S56,2750,447,23997145.83,5634,8793,3159,7927.008949,510.3490405
Cell S67,2750,447,23997145.83,6169,8858,2689,8214.024609,402.6263075
Cell S78,2750,450,24158200.5,6692,8941,2249,8314.195556,301.2439056
Cell S88,2750,446,23943460.94,6375,8915,2540,8068.446188,467.043286
Cell S94,2750,447,23997145.83,7045,8935,1890,8129.948546,331.2225332
Cell S95,2750,448,24050830.72,6731,8796,2065,7899.839286,434.0980603
W287,2750,446,23943460.94,1259,8994,7735,4087,1741.621773
W295,2750,446,23943460.94,1997,8540,6543,7117.82287,1128.473636
W338,2750,438,23513981.82,1152,9777,8625,5851.223744,2243.034011
W342,2750,437,23460296.93,1482,8020,6538,5562.340961,1949.471807
W345,2750,447,23997145.83,3814,7945,4131,7354.733781,646.1758914
W387,2750,444,23836091.16,1191,8593,7402,5703.195946,2257.336972
W393,2750,444,23836091.16,3144,8807,5663,7162.027027,1010.185294
W440,2750,445,23889776.05,1722,8342,6620,5790.08764,1817.966078
W441,2750,446,23943460.94,3682,8537,4855,7412.91704,686.7324463
W445,2750,438,23513981.82,4655,8446,3791,7034.006849,595.8963529
W500,2750,447,23997145.83,1427,8499,7072,5878.986577,2188.154822
1,3000,531,28506676.59,2583,8498,5915,7564.094162,886.3850422
2,3000,531,28506676.59,1985,8837,6852,6462.018832,1440.888971
3,3000,530,28452991.7,6406,8059,1653,7555.384906,301.7233754
4,3000,530,28452991.7,2251,8547,6296,7123.792453,817.5789422
5,3000,528,28345621.92,-1680,8738,10418,6672.712121,2227.604111
6,3000,529,28399306.81,3113,8641,5528,7534.848771,864.1299348
7,3000,530,28452991.7,1629,9768,8139,7140.611321,1066.961869
8,3000,531,28506676.59,2057,8202,6145,6541.926554,1321.46351
9,3000,531,28506676.59,6954,8692,1738,7862.440678,289.2307314
10,3000,528,28345621.92,674,8920,8246,6472.318182,2095.019994
11,3000,534,28667731.26,1059,9388,8329,6037.340824,2104.343231
12,3000,537,28828785.93,1184,9569,8385,5354.834264,2158.205314
13,3000,534,28667731.26,2159,8575,6416,6957.735955,1028.926372
14,3000,531,28506676.59,5965,8680,2715,8075.256121,445.9230026
16,3000,534,28667731.26,93,9339,9246,4177.400749,2608.109552
17,3000,530,28452991.7,1444,8768,7324,7346.056604,807.8396211
18,3000,531,28506676.59,879,9982,9103,4256.297552,2683.140021
19,3000,528,28345621.92,716,9348,8632,4519.751894,2394.845848
20,3000,531,28506676.59,6008,8451,2443,7772.647834,310.5898742
21,3000,531,28506676.59,6613,8802,2189,8143.749529,338.37484
22,3000,531,28506676.59,-1894,9795,11689,4668.193974,2852.143098
23,3000,526,28238252.14,-10,8824,8834,4396.802281,2740.774406
24,3000,533,28614046.37,5069,8860,3791,7646.484053,565.1437067
25,3000,529,28399306.81,1682,9040,7358,7079.99811,1133.72797
26,3000,529,28399306.81,6943,8547,1604,7751.340265,300.4783859
27,3000,530,28452991.7,6629,8395,1766,7736.143396,329.5655605
28,3000,527,28291937.03,5711,8250,2539,7559.058824,433.8079288
29,3000,530,28452991.7,3827,8711,4884,7585.943396,538.8164288
31,3000,529,28399306.81,6423,8899,2476,7656.47259,329.1905231
32,3000,530,28452991.7,2166,8225,6059,7011.235849,928.3356415
33,3000,534,28667731.26,6685,8754,2069,7419.29588,298.6552735
34,3000,532,28560361.48,5586,8364,2778,7283.635338,487.4547931
10A,3000,534,28667731.26,1227,9255,8028,6650.938202,1942.092556
10NE,3000,530,28452991.7,979,8867,7888,6912.007547,1880.321097
10NW,3000,527,28291937.03,2565,9005,6440,7449.840607,1397.573332
10SW,3000,536,28775101.04,448,9581,9133,5012.309701,2516.751482
11NE,3000,531,28506676.59,1675,8976,7301,6705.338983,1567.675656
11NW,3000,531,28506676.59,-195,9328,9523,6356.647834,2325.643154
11SE,3000,529,28399306.81,1304,8574,7270,6273.773157,1737.736397
17NW,3000,529,28399306.81,567,9942,9375,7363.506616,1379.259223
17SE,3000,530,28452991.7,1120,8841,7721,6932.209434,1583.093965
17SW,3000,534,28667731.26,-1894,9795,11689,5570.576779,2248.53979
22S,3000,526,28238252.14,-1894,9795,11689,4540.665399,2885.145374
23S,3000,537,28828785.93,1090,8227,7137,3362.558659,1739.862756
24S,3000,528,28345621.92,5069,8860,3791,7649.520833,568.3395868
27A,3000,533,28614046.37,1284,8980,7696,6416.050657,2096.180432
2A,3000,530,28452991.7,1607,8837,7230,6344.975472,1775.290383
5NE,3000,530,28452991.7,-1842,9827,11669,5814.854717,2110.638052
5NW,3000,531,28506676.59,-1842,9827,11669,5574.920904,2215.242695
5SE,3000,532,28560361.48,791,9784,8993,3834.483083,2522.479803
6NE,3000,529,28399306.81,1985,8722,6737,6873.809074,1563.57751
6NW,3000,528,28345621.92,1394,9201,7807,6756.992424,1955.92858
6SW,3000,529,28399306.81,1210,8757,7547,6714.504726,1988.801171
Cell 1 2011/12,3000,531,28506676.59,2583,8498,5915,7564.094162,886.3850422
Cell 1 SW 2013,3000,533,28614046.37,-1970,8948,10918,5600.577861,2150.36889
Cell 10 2011/12,3000,528,28345621.92,674,8920,8246,6472.318182,2095.019994
Cell 10 NE 2011/12,3000,530,28452991.7,979,8867,7888,6912.007547,1880.321097
Cell 10 NW 2011/12,3000,527,28291937.03,2565,9005,6440,7449.840607,1397.573332
Cell 10 SE 2013,3000,528,28345621.92,1394,9201,7807,6756.992424,1955.92858
Cell 10 SW 2011/12,3000,536,28775101.04,448,9581,9133,5012.309701,2516.751482
Cell 10-A 2011/12,3000,534,28667731.26,1227,9255,8028,6650.938202,1942.092556
Cell 11 NE 2011/12,3000,531,28506676.59,1675,8976,7301,6705.338983,1567.675656
Cell 11 NW 2013,3000,531,28506676.59,1607,8837,7230,6525.555556,1578.153915
Cell 11 SW 2013,3000,530,28452991.7,4580,8980,4400,7774.801887,587.4069757
Cell 12 2013,3000,529,28399306.81,1629,9768,8139,7140.854442,1068.090493
Cell 13 2013,3000,532,28560361.48,2057,8165,6108,6390.291353,1418.206636
Cell 14 2013,3000,532,28560361.48,7250,8702,1452,8165.216165,260.8855442
Cell 15 2013,3000,532,28560361.48,6095,8667,2572,7833.513158,440.1884057
Cell 15-A 2013,3000,530,28452991.7,5452,8590,3138,7846.1,420.499213
Cell 16 2013,3000,528,28345621.92,6616,8737,2121,7924.170455,383.7313085
Cell 17 NW 2011/12,3000,529,28399306.81,567,9942,9375,7363.506616,1379.259223
Cell 17 NW 2013,3000,528,28345621.92,-1875,8918,10793,5681.176136,2459.549651
Cell 17 SE 2013,3000,527,28291937.03,2565,9005,6440,7449.840607,1397.573332
Cell 17 SW 2013,3000,534,28667731.26,-1680,8738,10418,6696.305243,2200.867451
Cell 18 2011/12,3000,531,28506676.59,879,9982,9103,4256.297552,2683.140021
Cell 18 NE 2013,3000,531,28506676.59,1210,8757,7547,6636.438795,2079.710099
Cell 18 NW 2013,3000,531,28506676.59,791,9784,8993,3720.20339,2473.692959
Cell 18 SE 2013,3000,530,28452991.7,1675,8976,7301,6712,1561.628618
Cell 18 SSE 2013,3000,530,28452991.7,108,9328,9220,6240.498113,2216.057429
Cell 19 NW 2013,3000,530,28452991.7,4465,9386,4921,7771.739623,627.6065497
Cell 2 2011/12,3000,531,28506676.59,1985,8837,6852,6462.018832,1440.888971
Cell 2 NE 2013,3000,524,28130882.36,-1502,8656,10158,6150.582061,1877.676644
Cell 2 SW 2013,3000,530,28452991.7,2583,8498,5915,7564.660377,887.1249161
Cell 20 2013,3000,531,28506676.59,3058,9773,6715,7631.386064,845.9699788
Cell 21 2013,3000,531,28506676.59,2443,8808,6365,6930.798493,1162.122083
Cell 22 2013,3000,528,28345621.92,6954,8372,1418,7805.219697,267.8771786
Cell 23 2013,3000,530,28452991.7,7011,8915,1904,8248.481132,310.5596844
Cell 24 2013,3000,531,28506676.59,6649,8848,2199,8090.499058,312.9325142
Cell 25 NE 2013,3000,528,28345621.92,674,8920,8246,6472.318182,2095.019994
Cell 25 SE 2013,3000,535,28721416.15,448,9581,9133,5013.514019,2518.948181
Cell 26 NE 2013,3000,534,28667731.26,1059,9388,8329,6037.340824,2104.343231
Cell 26 NNW 2013,3000,530,28452991.7,979,8867,7888,6912.007547,1880.321097
Cell 26 NW 2013,3000,534,28667731.26,1227,9255,8028,6650.938202,1942.092556
Cell 27 NW 2013,3000,529,28399306.81,1304,8574,7270,6273.773157,1737.736397
Cell 28 2013,3000,537,28828785.93,1184,9569,8385,5354.834264,2158.205314
Cell 29 2013,3000,532,28560361.48,2159,8575,6416,6956.360902,1028.063009
Cell 3 NE 2013,3000,531,28506676.59,-384,8813,9197,7334.693032,1176.304578
Cell 3 NW 2013,3000,530,28452991.7,620,8633,8013,6837.566038,1268.493741
Cell 30 2013,3000,530,28452991.7,7166,8690,1524,7952.516981,281.8089087
Cell 31 2013,3000,534,28667731.26,6896,8747,1851,8241.85206,357.8236423
Cell 32 2013,3000,527,28291937.03,6169,8858,2689,8213.440228,390.21071
Cell 33 NE 2013,3000,529,28399306.81,567,9942,9375,7363.506616,1379.259223
Cell 33 SE 2013,3000,534,28667731.26,-1894,9795,11689,5570.576779,2248.53979
Cell 33 SW 2013,3000,529,28399306.81,93,9341,9248,3798.73913,2563.692248
Cell 34 N 2013,3000,530,28452991.7,2115,8825,6710,6976.141509,1187.109286
Cell 34 NW 2013,3000,530,28452991.7,1444,8768,7324,7346.056604,807.8396211
Cell 34 SE 2013,3000,531,28506676.59,1120,8841,7721,6933.427495,1581.851162
Cell 35 2013,3000,529,28399306.81,879,9982,9103,4859.534972,2829.751723
Cell 37 2013,3000,530,28452991.7,6008,8451,2443,7777.692453,305.9333658
Cell 38 2013,3000,533,28614046.37,6613,8802,2189,8142.981238,341.5343093
Cell 39 2013,3000,531,28506676.59,6692,8941,2249,8316.892655,300.0035118
Cell 4 2013,3000,529,28399306.81,5853,8537,2684,7506.206049,376.8271042
Cell 40 NE 2013,3000,528,28345621.92,-1894,9795,11689,4980.501894,2744.981334
Cell 41 N 2013,3000,534,28667731.26,-1813,8839,10652,6919.926966,1836.465967
Cell 41 NW 2013,3000,531,28506676.59,-1894,9615,11509,5975.629002,2612.17292
Cell 42 NW 2013,3000,534,28667731.26,-10,8824,8834,4351.818352,2748.342311
Cell 43 2013,3000,537,28828785.93,1376,8712,7336,6475.623836,1726.070164
Cell 44 2013,3000,534,28667731.26,5923,8413,2490,7571.687266,452.4107352
Cell 45 2013,3000,528,28345621.92,6943,8547,1604,7751.5,300.7403554
Cell 47 2013,3000,530,28452991.7,1034,9694,8660,6926.341509,1711.703483
Cell 48 2013,3000,529,28399306.81,5069,8860,3791,7649.268431,567.8880016
Cell 49 2013,3000,529,28399306.81,1682,9040,7358,7079.99811,1133.72797
Cell 5 2011/12 Summer,3000,534,28667731.26,-1680,8738,10418,6696.305243,2200.867451
Cell 5 2013,3000,529,28399306.81,5334,8688,3354,7862.1569,544.9957805
Cell 50 2013,3000,531,28506676.59,3827,8711,4884,7584.832392,538.9161266
Cell 51 2013,3000,538,28882470.82,6731,8796,2065,7906.187732,433.5562805
Cell 52 2013,3000,530,28452991.7,6566,8435,1869,7630.209434,294.6378453
Cell 53 2013,3000,527,28291937.03,5711,8250,2539,7559.058824,433.8079288
Cell 54 2013,3000,530,28452991.7,6123,8961,2838,8123.171698,483.6478162
Cell 55 2013,3000,531,28506676.59,6068,8870,2802,8071.148776,489.9927999
Cell 56 2013,3000,534,28667731.26,6685,8754,2069,7419.661049,298.3127448
Cell 57 2013,3000,531,28506676.59,2166,8225,6059,7010.902072,927.492922
Cell 58 2013,3000,531,28506676.59,7428,8699,1271,8120.158192,250.7542397
Cell 59 2013,3000,530,28452991.7,6193,8713,2520,7423.332075,352.2637133
Cell 6 2011/12,3000,529,28399306.81,3113,8641,5528,7534.848771,864.1299348
Cell 6 2013,3000,529,28399306.81,5628,8640,3012,7878.916824,422.1644345
Cell 6 NE 2011/12,3000,529,28399306.81,1985,8722,6737,6873.809074,1563.57751
Cell 6 NW 2011/12,3000,528,28345621.92,1394,9201,7807,6756.992424,1955.92858
Cell 6 SW 2011/12,3000,529,28399306.81,1210,8757,7547,6714.504726,1988.801171
Cell 60 2013,3000,534,28667731.26,5586,8364,2778,7277.835206,450.5391724
Cell 61 2013,3000,529,28399306.81,5338,8573,3235,7551.986767,534.3995144
Cell 7 2013,3000,536,28775101.04,5706,9125,3419,8359.156716,376.2145576
Cell 9 NW 2013,3000,529,28399306.81,-1842,9468,11310,5396.232514,2428.440036
Cell 9 SE 2013,3000,530,28452991.7,-1842,9827,11669,5814.854717,2110.638052
Cell 9 SW 2013,3000,530,28452991.7,-1842,9827,11669,5572.584906,2216.678066
Cell R1,3000,521,27969827.69,1313,8189,6876,6227.539347,1860.476014
Cell R10,3000,528,28345621.92,5853,8537,2684,7505.895833,377.1162892
Cell R100,3000,531,28506676.59,3827,8711,4884,7584.832392,538.9161266
Cell R101,3000,530,28452991.7,6475,8618,2143,7926.964151,360.9456195
Cell R104,3000,526,28238252.14,3619,8852,5233,7838.576046,588.4831511
Cell R105,3000,527,28291937.03,5711,8250,2539,7559.058824,433.8079288
Cell R106,3000,530,28452991.7,1693,8657,6964,6969.586792,1411.412121
Cell R107,3000,530,28452991.7,6123,8961,2838,8123.171698,483.6478162
Cell R11,3000,529,28399306.81,5334,8688,3354,7862.1569,544.9957805
Cell R111,3000,526,28238252.14,1626,9474,7848,7068.268061,1768.275414
Cell R112,3000,531,28506676.59,6512,8378,1866,7564.333333,328.0589091
Cell R113,3000,531,28506676.59,2166,8225,6059,7010.902072,927.492922
Cell R114,3000,531,28506676.59,7428,8699,1271,8120.158192,250.7542397
Cell R117,3000,531,28506676.59,6694,9347,2653,7721.131827,510.8493698
Cell R118,3000,534,28667731.26,6685,8754,2069,7419.661049,298.3127448
Cell R119,3000,528,28345621.92,3604,7890,4286,6992.871212,542.7307239
Cell R120,3000,527,28291937.03,4695,8451,3756,7579.867173,601.2241256
Cell R121,3000,531,28506676.59,6706,8663,1957,8033.623352,301.0253309
Cell R123,3000,526,28238252.14,6615,9136,2521,7504.473384,339.1053739
Cell R124,3000,531,28506676.59,5586,8364,2778,7290.246704,415.2616462
Cell R125,3000,534,28667731.26,2277,8373,6096,6685.801498,1278.536642
Cell R126,3000,531,28506676.59,3613,8405,4792,7293.365348,760.3301631
Cell R15,3000,533,28614046.37,-1970,8948,10918,5600.577861,2150.36889
Cell R16,3000,530,28452991.7,-1842,9468,11310,5398.24717,2426.590669
Cell R17,3000,531,28506676.59,1969,8720,6751,7218.892655,1191.593251
Cell R18,3000,540,28989840.6,1607,8837,7230,6511.07037,1600.064593
Cell R19,3000,531,28506676.59,1504,9275,7771,7400.404896,797.5167792
Cell R20,3000,532,28560361.48,2251,8547,6296,7089.210526,921.7600323
Cell R21,3000,530,28452991.7,6327,8521,2194,7808.628302,367.6050018
Cell R22,3000,532,28560361.48,7250,8702,1452,8165.216165,260.8855442
Cell R24,3000,528,28345621.92,-1875,8918,10793,5681.176136,2459.549651
Cell R25,3000,531,28506676.59,791,9784,8993,3720.20339,2473.692959
Cell R26,3000,524,28130882.36,1394,9201,7807,6792.629771,1892.144039
Cell R27,3000,530,28452991.7,4465,9386,4921,7771.739623,627.6065497
Cell R28,3000,527,28291937.03,1476,9768,8292,6194.318786,1952.161319
Cell R29,3000,531,28506676.59,3058,9773,6715,7631.386064,845.9699788
Cell R30,3000,527,28291937.03,5971,8476,2505,7562.762808,502.9356992
Cell R31,3000,534,28667731.26,5511,8498,2987,7800.745318,476.3327633
Cell R35,3000,532,28560361.48,-1680,8738,10418,6711.265038,2191.167267
Cell R36,3000,527,28291937.03,2565,9005,6440,7449.840607,1397.573332
Cell R37,3000,531,28506676.59,1675,8976,7301,6705.338983,1567.675656
Cell R38,3000,534,28667731.26,1447,8825,7378,6949.363296,1440.734571
Cell R39,3000,528,28345621.92,1920,9211,7291,7174.496212,1292.946733
Cell R40,3000,531,28506676.59,2443,8808,6365,6930.798493,1162.122083
Cell R46,3000,532,28560361.48,448,9056,8608,4786.37406,2568.604356
Cell R47,3000,534,28667731.26,1227,9255,8028,6650.938202,1942.092556
Cell R48,3000,534,28667731.26,1059,9388,8329,6037.340824,2104.343231
Cell R49,3000,529,28399306.81,1304,8574,7270,6273.773157,1737.736397
Cell R5,3000,529,28399306.81,-1970,8349,10319,5671.359168,1934.960074
Cell R50,3000,537,28828785.93,1184,9569,8385,5354.834264,2158.205314
Cell R51,3000,534,28667731.26,2159,8575,6416,6963.636704,1015.047627
Cell R52,3000,532,28560361.48,3917,8651,4734,7555.392857,591.6419851
Cell R53,3000,530,28452991.7,3421,8408,4987,7432.962264,544.722528
Cell R54,3000,534,28667731.26,6896,8747,1851,8241.85206,357.8236423
Cell R58,3000,529,28399306.81,273,9901,9628,4816.869565,2597.708475
Cell R59,3000,529,28399306.81,567,9942,9375,7363.506616,1379.259223
Cell R6,3000,530,28452991.7,2583,8498,5915,7564.660377,887.1249161
Cell R60,3000,530,28452991.7,1444,8768,7324,7346.056604,807.8396211
Cell R61,3000,529,28399306.81,879,9982,9103,4859.534972,2829.751723
Cell R62,3000,531,28506676.59,716,9348,8632,4390.875706,2387.1639
Cell R63,3000,530,28452991.7,716,8394,7678,6754.332075,1621.222727
Cell R64,3000,531,28506676.59,3349,8335,4986,7632.52919,524.7805214
Cell R65,3000,529,28399306.81,7166,8690,1524,7952.100189,281.9118958
Cell R66,3000,536,28775101.04,7476,8798,1322,8425.242537,221.4928845
Cell R69,3000,530,28452991.7,93,9341,9248,3807.10566,2568.491064
Cell R7,3000,530,28452991.7,620,8633,8013,6837.566038,1268.493741
Cell R70,3000,534,28667731.26,-1894,9795,11689,5570.576779,2248.53979
Cell R71,3000,531,28506676.59,1120,8841,7721,6933.427495,1581.851162
Cell R72,3000,531,28506676.59,-10,9343,9353,4686.500942,2711.771987
Cell R73,3000,533,28614046.37,1203,9342,8139,6835.15197,1901.69087
Cell R74,3000,530,28452991.7,1366,9341,7975,6762.701887,1720.035506
Cell R75,3000,531,28506676.59,6008,8451,2443,7775.998117,308.124119
Cell R76,3000,535,28721416.15,6807,8790,1983,8145.157009,310.5049575
Cell R77,3000,534,28667731.26,6613,8802,2189,8143.237828,341.2657887
Cell R8,3000,528,28345621.92,-384,8813,9197,7391.354167,1187.241094
Cell R80,3000,528,28345621.92,-1894,9795,11689,4980.501894,2744.981334
Cell R81,3000,529,28399306.81,1326,9507,8181,7391.36862,1218.580206
Cell R82,3000,534,28667731.26,-10,8824,8834,4351.818352,2748.342311
Cell R83,3000,532,28560361.48,422,8755,8333,5610.274436,2530.629361
Cell R84,3000,530,28452991.7,1308,8712,7404,4536.143396,2291.425879
Cell R85,3000,537,28828785.93,1376,8712,7336,6475.623836,1726.070164
Cell R86,3000,530,28452991.7,6066,8291,2225,7438.983019,407.005551
Cell R87,3000,528,28345621.92,6943,8547,1604,7751.5,300.7403554
Cell R9,3000,529,28399306.81,382,8558,8176,7388.393195,758.5415493
Cell R90,3000,531,28506676.59,1034,9694,8660,6916.947269,1723.712413
Cell R91,3000,529,28399306.81,5069,8860,3791,7649.268431,567.8880016
Cell R92,3000,532,28560361.48,1249,9683,8434,3569.691729,2295.501252
Cell R93,3000,529,28399306.81,1682,9040,7358,7079.99811,1133.72797
Cell R97,3000,534,28667731.26,1284,8980,7696,6683.779026,1979.633161
Cell R98,3000,529,28399306.81,6629,8395,1766,7736.018904,329.8644615
Cell R99,3000,530,28452991.7,6566,8435,1869,7630.209434,294.6378453
Cell S102,3000,532,28560361.48,6731,8730,1999,8019.084586,458.2755787
Cell S108,3000,531,28506676.59,6068,8870,2802,8071.148776,489.9927999
Cell S13,3000,531,28506676.59,6084,9033,2949,8117.666667,480.9910085
Cell S14,3000,536,28775101.04,5706,9125,3419,8359.156716,376.2145576
Cell S2,3000,529,28399306.81,5628,8640,3012,7878.916824,422.1644345
Cell S23,3000,529,28399306.81,6351,8842,2491,8323.425331,355.6966255
Cell S32,3000,531,28506676.59,6902,8938,2036,8092.717514,353.3972483
Cell S33,3000,529,28399306.81,5536,8590,3054,7850.625709,407.796958
Cell S34,3000,531,28506676.59,6649,8848,2199,8090.499058,312.9325142
Cell S41,3000,529,28399306.81,6917,8462,1545,7781.646503,275.1839629
Cell S42,3000,530,28452991.7,7011,8915,1904,8248.481132,310.5596844
Cell S44,3000,532,28560361.48,7369,8801,1432,8121.913534,287.4868288
Cell S56,3000,531,28506676.59,5634,8793,3159,7926.715631,501.9753636
Cell S67,3000,527,28291937.03,6169,8858,2689,8213.440228,390.21071
Cell S78,3000,531,28506676.59,6692,8941,2249,8316.892655,300.0035118
Cell S88,3000,528,28345621.92,6375,8915,2540,8083.299242,450.9068319
Cell S94,3000,528,28345621.92,7045,8935,1890,8129.92803,321.7251122
Cell S95,3000,537,28828785.93,6731,8796,2065,7906.223464,433.9589851
W287,3000,532,28560361.48,880,8994,8114,4087.898496,1775.313665
W295,3000,530,28452991.7,1997,8618,6621,7140.032075,1136.171352
W338,3000,528,28345621.92,1098,9843,8745,5597.734848,2374.491302
W342,3000,529,28399306.81,1473,8020,6547,5491.113422,1966.633504
W345,3000,527,28291937.03,3814,7945,4131,7383.039848,614.9035687
W387,3000,529,28399306.81,1191,8593,7402,5697.793951,2344.132427
W393,3000,530,28452991.7,1670,8897,7227,7054.730189,1195.567577
W440,3000,532,28560361.48,1502,8342,6840,5653.733083,1927.756523
W441,3000,528,28345621.92,3682,8537,4855,7359.587121,750.9626877
W445,3000,528,28345621.92,4554,8446,3892,7001.979167,647.9919285
W500,3000,530,28452991.7,1427,8499,7072,5818.375472,2177.022223
1,3250,621,33338316.69,2583,8637,6054,7530.68599,918.5869353
2,3250,619,33230946.91,1985,8837,6852,6478.300485,1441.510467
3,3250,626,33606741.14,5274,8200,2926,7551.50639,328.4635315
4,3250,625,33553056.25,2251,8547,6296,7126.7296,849.9505108
5,3250,625,33553056.25,-1875,8738,10613,6624.9456,2238.976724
6,3250,624,33499371.36,3113,8743,5630,7519.810897,894.9282897
7,3250,620,33284631.8,1629,9768,8139,7099.058065,1134.599702
8,3250,625,33553056.25,2057,8838,6781,6569.3088,1336.221505
9,3250,626,33606741.14,6717,8692,1975,7878.468051,295.446821
10,3250,624,33499371.36,628,9522,8894,6451.520833,2124.15259
11,3250,622,33392001.58,913,9388,8475,5867.692926,2192.402036
12,3250,619,33230946.91,1148,9569,8421,5246.011309,2224.554031
13,3250,623,33445686.47,2159,8808,6649,6941.35313,1070.380887
14,3250,625,33553056.25,4900,8680,3780,8074.0144,459.3383709
16,3250,620,33284631.8,93,9814,9721,4273.216129,2691.538234
17,3250,625,33553056.25,-471,9026,9497,7330.76,945.7515412
18,3250,620,33284631.8,879,9982,9103,4244.262903,2667.114027
19,3250,624,33499371.36,716,9348,8632,4520.987179,2411.457955
20,3250,625,33553056.25,6008,8451,2443,7767.8368,310.420508
21,3250,623,33445686.47,6613,8802,2189,8147.4687,331.9650167
22,3250,621,33338316.69,-1894,9795,11689,4647.483092,2845.278414
23,3250,622,33392001.58,-10,8824,8834,4285.562701,2743.756972
24,3250,624,33499371.36,4161,8860,4699,7607.69391,600.7726763
25,3250,621,33338316.69,1682,9040,7358,7014.228663,1238.742439
26,3250,622,33392001.58,6943,8547,1604,7771.131833,304.1948341
27,3250,624,33499371.36,4664,8395,3731,7739.008013,352.3040439
28,3250,625,33553056.25,5711,8250,2539,7551.2336,442.644576
29,3250,624,33499371.36,3827,8711,4884,7578.974359,550.4284339
31,3250,625,33553056.25,6423,9365,2942,7661.9488,343.3841845
32,3250,621,33338316.69,2166,8225,6059,6913.173913,1105.649385
33,3250,623,33445686.47,6615,8786,2171,7422.170144,311.8430789
34,3250,620,33284631.8,5586,8364,2778,7292.217742,473.3746038
10A,3250,622,33392001.58,1227,9581,8354,6492.16881,2081.524148
10NE,3250,625,33553056.25,312,8867,8555,6710.7808,2035.568518
10NW,3250,625,33553056.25,1117,9005,7888,7324.7216,1508.746749
10SW,3250,621,33338316.69,448,9915,9467,4990.386473,2531.331237
11NE,3250,620,33284631.8,1675,8976,7301,6743.851613,1564.741487
11NW,3250,624,33499371.36,-195,9328,9523,6135.102564,2435.069438
11SE,3250,624,33499371.36,1133,8574,7441,6163.575321,1891.3151
17NW,3250,621,33338316.69,273,9971,9698,7185.584541,1675.984327
17SE,3250,622,33392001.58,850,8841,7991,6846.766881,1669.042231
17SW,3250,622,33392001.58,-1894,9795,11689,5480.458199,2337.337026
22S,3250,625,33553056.25,-1894,9795,11689,4472.4048,2863.467136
23S,3250,619,33230946.91,1090,8227,7137,3415.072698,1773.935464
24S,3250,624,33499371.36,4161,8860,4699,7604.810897,607.0195363
27A,3250,625,33553056.25,1284,8980,7696,6461.0384,2075.332626
2A,3250,625,33553056.25,1571,8837,7266,6308.9568,1786.456415
5NE,3250,622,33392001.58,-1842,9827,11669,5531.643087,2189.201033
5NW,3250,618,33177262.02,-1842,9827,11669,5522.394822,2280.911183
5SE,3250,624,33499371.36,791,9784,8993,3822.572115,2522.847089
6NE,3250,622,33392001.58,1697,8722,7025,6857.345659,1613.053486
6NW,3250,619,33230946.91,1394,9201,7807,6649.631664,2014.949162
6SW,3250,624,33499371.36,1210,8757,7547,6658.580128,2062.23677
Cell 1 2011/12,3250,621,33338316.69,2583,8637,6054,7530.68599,918.5869353
Cell 1 SW 2013,3250,623,33445686.47,-1970,8948,10918,5473.760835,2188.272719
Cell 10 2011/12,3250,624,33499371.36,628,9522,8894,6451.520833,2124.15259
Cell 10 NE 2011/12,3250,625,33553056.25,312,8867,8555,6710.7808,2035.568518
Cell 10 NW 2011/12,3250,625,33553056.25,1117,9005,7888,7324.7216,1508.746749
Cell 10 SE 2013,3250,619,33230946.91,1394,9201,7807,6649.631664,2014.949162
Cell 10 SW 2011/12,3250,621,33338316.69,448,9915,9467,4990.386473,2531.331237
Cell 10-A 2011/12,3250,622,33392001.58,1227,9581,8354,6492.16881,2081.524148
Cell 11 NE 2011/12,3250,620,33284631.8,1675,8976,7301,6743.851613,1564.741487
Cell 11 NW 2013,3250,626,33606741.14,1607,8837,7230,6480.976038,1598.353873
Cell 11 SW 2013,3250,625,33553056.25,2315,9386,7071,7724.2288,684.2030649
Cell 12 2013,3250,623,33445686.47,1629,9768,8139,7101.434992,1132.628742
Cell 13 2013,3250,626,33606741.14,2057,8838,6781,6452.031949,1412.937409
Cell 14 2013,3250,626,33606741.14,7153,8702,1549,8153.519169,275.0770391
Cell 15 2013,3250,622,33392001.58,5348,8667,3319,7854.130225,455.6121186
Cell 15-A 2013,3250,627,33660426.03,5452,8600,3148,7859.8437,422.8131366
Cell 16 2013,3250,624,33499371.36,6616,8737,2121,7933.160256,386.8679212
Cell 17 NW 2011/12,3250,621,33338316.69,273,9971,9698,7185.584541,1675.984327
Cell 17 NW 2013,3250,622,33392001.58,-1875,8918,10793,5745.87299,2401.453421
Cell 17 SE 2013,3250,625,33553056.25,1117,9005,7888,7324.7216,1508.746749
Cell 17 SW 2013,3250,622,33392001.58,-1875,8738,10613,6608.628617,2229.315616
Cell 18 2011/12,3250,620,33284631.8,879,9982,9103,4244.262903,2667.114027
Cell 18 NE 2013,3250,623,33445686.47,1210,8939,7729,6625.17496,2114.490489
Cell 18 NW 2013,3250,620,33284631.8,791,9784,8993,3727.66129,2457.645257
Cell 18 SE 2013,3250,621,33338316.69,1675,8976,7301,6746.47182,1564.841788
Cell 18 SSE 2013,3250,620,33284631.8,-195,9388,9583,6045.859677,2342.502097
Cell 19 NW 2013,3250,622,33392001.58,3484,9386,5902,7693.05627,754.5240712
Cell 2 2011/12,3250,619,33230946.91,1985,8837,6852,6478.300485,1441.510467
Cell 2 NE 2013,3250,623,33445686.47,-1502,8656,10158,6143.070626,1900.480824
Cell 2 SW 2013,3250,620,33284631.8,2583,8637,6054,7529.595161,918.9254571
Cell 20 2013,3250,626,33606741.14,2387,9773,7386,7542.907348,958.0640812
Cell 21 2013,3250,625,33553056.25,2443,8808,6365,6940.1216,1170.476054
Cell 22 2013,3250,624,33499371.36,6954,8372,1418,7814.320513,266.1502007
Cell 23 2013,3250,620,33284631.8,6899,8915,2016,8232.183871,326.8988623
Cell 24 2013,3250,620,33284631.8,6649,8848,2199,8098.796774,321.668519
Cell 25 NE 2013,3250,624,33499371.36,628,9522,8894,6451.520833,2124.15259
Cell 25 SE 2013,3250,621,33338316.69,448,9915,9467,4990.386473,2531.331237
Cell 26 NE 2013,3250,622,33392001.58,913,9388,8475,5867.692926,2192.402036
Cell 26 NNW 2013,3250,624,33499371.36,312,8867,8555,6715.230769,2034.159062
Cell 26 NW 2013,3250,622,33392001.58,1227,9581,8354,6492.16881,2081.524148
Cell 27 NW 2013,3250,624,33499371.36,1133,8574,7441,6163.575321,1891.3151
Cell 28 2013,3250,619,33230946.91,1148,9569,8421,5246.011309,2224.554031
Cell 29 2013,3250,625,33553056.25,2159,8808,6649,6941.5936,1069.770528
Cell 3 NE 2013,3250,624,33499371.36,-384,8813,9197,7307.516026,1172.183891
Cell 3 NW 2013,3250,620,33284631.8,620,8633,8013,6821.946774,1330.055254
Cell 30 2013,3250,619,33230946.91,7166,8690,1524,7956.49273,289.6467034
Cell 31 2013,3250,622,33392001.58,6896,8747,1851,8239.699357,365.0259709
Cell 32 2013,3250,625,33553056.25,6169,8858,2689,8204.6768,385.9548963
Cell 33 NE 2013,3250,621,33338316.69,273,9971,9698,7185.584541,1675.984327
Cell 33 SE 2013,3250,622,33392001.58,-1894,9795,11689,5480.458199,2337.337026
Cell 33 SW 2013,3250,625,33553056.25,93,9655,9562,4005.832,2665.694258
Cell 34 N 2013,3250,625,33553056.25,2115,8825,6710,6969.872,1181.823933
Cell 34 NW 2013,3250,625,33553056.25,-471,9026,9497,7330.76,945.7515412
Cell 34 SE 2013,3250,622,33392001.58,850,8841,7991,6867.05627,1641.231195
Cell 35 2013,3250,620,33284631.8,879,9982,9103,4778.124194,2820.871611
Cell 37 2013,3250,624,33499371.36,6008,8451,2443,7769.152244,305.067039
Cell 38 2013,3250,621,33338316.69,6613,8802,2189,8145.10467,333.7729762
Cell 39 2013,3250,627,33660426.03,6692,8941,2249,8322.786284,298.4813111
Cell 4 2013,3250,624,33499371.36,5794,8537,2743,7493.150641,397.8759306
Cell 40 NE 2013,3250,621,33338316.69,-1894,9795,11689,5031.275362,2722.830011
Cell 41 N 2013,3250,621,33338316.69,-1813,8839,10652,6864.003221,1976.861145
Cell 41 NW 2013,3250,621,33338316.69,-1894,9615,11509,5877.694042,2638.68747
Cell 42 NW 2013,3250,620,33284631.8,-10,8824,8834,4224.45,2748.628164
Cell 43 2013,3250,620,33284631.8,1376,8712,7336,6409.104839,1795.808441
Cell 44 2013,3250,622,33392001.58,5923,8413,2490,7556.040193,474.6916074
Cell 45 2013,3250,624,33499371.36,6943,8547,1604,7772.240385,304.4244779
Cell 47 2013,3250,625,33553056.25,784,9694,8910,6709.4992,1922.293991
Cell 48 2013,3250,623,33445686.47,4161,8860,4699,7603.640449,611.8687338
Cell 49 2013,3250,621,33338316.69,1682,9040,7358,7014.228663,1238.742439
Cell 5 2011/12 Summer,3250,623,33445686.47,-1875,8738,10613,6608.895666,2227.535676
Cell 5 2013,3250,624,33499371.36,5041,8746,3705,7863.689103,579.188576
Cell 50 2013,3250,624,33499371.36,3827,8711,4884,7578.974359,550.4284339
Cell 51 2013,3250,620,33284631.8,6731,8796,2065,7915.880645,435.6288061
Cell 52 2013,3250,626,33606741.14,5812,8435,2623,7633.789137,312.184466
Cell 53 2013,3250,624,33499371.36,5711,8250,2539,7550.685897,442.7874563
Cell 54 2013,3250,621,33338316.69,6123,8961,2838,8098.47504,496.43026
Cell 55 2013,3250,626,33606741.14,6068,8870,2802,8034.50639,507.8547132
Cell 56 2013,3250,622,33392001.58,6615,8786,2171,7425.413183,315.5276365
Cell 57 2013,3250,621,33338316.69,2166,8225,6059,6912.344605,1105.57457
Cell 58 2013,3250,625,33553056.25,6812,8749,1937,8113.1408,261.0724577
Cell 59 2013,3250,620,33284631.8,6193,8834,2641,7431.417742,376.3075115
Cell 6 2011/12,3250,624,33499371.36,3113,8743,5630,7519.810897,894.9282897
Cell 6 2013,3250,626,33606741.14,5628,8675,3047,7907.830671,414.8258306
Cell 6 NE 2011/12,3250,622,33392001.58,1697,8722,7025,6857.345659,1613.053486
Cell 6 NW 2011/12,3250,619,33230946.91,1394,9201,7807,6649.631664,2014.949162
Cell 6 SW 2011/12,3250,624,33499371.36,1210,8757,7547,6658.580128,2062.23677
Cell 60 2013,3250,619,33230946.91,5586,8364,2778,7288.610662,436.7910987
Cell 61 2013,3250,626,33606741.14,4872,8765,3893,7542.511182,567.856806
Cell 7 2013,3250,619,33230946.91,5706,9125,3419,8304.256866,450.8205374
Cell 9 NW 2013,3250,625,33553056.25,-1842,9468,11310,5351.2672,2429.04829
Cell 9 SE 2013,3250,623,33445686.47,-1842,9827,11669,5525.611557,2192.609482
Cell 9 SW 2013,3250,618,33177262.02,-1842,9827,11669,5522.394822,2280.911183
Cell R1,3250,621,33338316.69,1268,8189,6921,6087.241546,1979.160277
Cell R10,3250,624,33499371.36,5794,8537,2743,7493.277244,397.9520632
Cell R100,3250,624,33499371.36,3827,8711,4884,7578.974359,550.4284339
Cell R101,3250,622,33392001.58,6325,8618,2293,7906.797428,376.4156782
Cell R104,3250,624,33499371.36,1719,8852,7133,7651.347756,1080.360101
Cell R105,3250,624,33499371.36,5711,8250,2539,7550.685897,442.7874563
Cell R106,3250,620,33284631.8,1693,8657,6964,6966.116129,1436.81972
Cell R107,3250,621,33338316.69,6123,8961,2838,8098.47504,496.43026
Cell R11,3250,624,33499371.36,5041,8746,3705,7863.689103,579.188576
Cell R111,3250,624,33499371.36,1626,9474,7848,7031.963141,1776.799941
Cell R112,3250,625,33553056.25,6507,8378,1871,7575.1536,329.339434
Cell R113,3250,621,33338316.69,2166,8225,6059,6912.344605,1105.57457
Cell R114,3250,625,33553056.25,6812,8749,1937,8113.1408,261.0724577
Cell R117,3250,620,33284631.8,5706,9347,3641,7716.46129,532.1742621
Cell R118,3250,622,33392001.58,6615,8786,2171,7425.413183,315.5276365
Cell R119,3250,624,33499371.36,2251,7890,5639,6947.116987,683.312415
Cell R120,3250,621,33338316.69,4695,8451,3756,7555.025765,611.3772257
Cell R121,3250,624,33499371.36,6706,8663,1957,8038,296.4120486
Cell R123,3250,625,33553056.25,6615,9136,2521,7519.592,377.7186868
Cell R124,3250,626,33606741.14,5586,8364,2778,7276.420128,444.0239907
Cell R125,3250,622,33392001.58,2277,8373,6096,6655.824759,1265.804087
Cell R126,3250,624,33499371.36,3613,8451,4838,7304.698718,758.541986
Cell R15,3250,622,33392001.58,-1970,8948,10918,5470.172026,2188.198379
Cell R16,3250,621,33338316.69,-1842,9468,11310,5370.489533,2426.032527
Cell R17,3250,624,33499371.36,1969,9201,7232,7269.254808,1211.112819
Cell R18,3250,616,33069892.24,1607,8837,7230,6472.375,1616.080557
Cell R19,3250,619,33230946.91,1457,9275,7818,7330.518578,1015.732164
Cell R20,3250,626,33606741.14,2251,8547,6296,7092.701278,946.7518248
Cell R21,3250,626,33606741.14,5302,8610,3308,7779.666134,421.5197577
Cell R22,3250,626,33606741.14,7153,8702,1549,8153.519169,275.0770391
Cell R24,3250,622,33392001.58,-1875,8918,10793,5745.87299,2401.453421
Cell R25,3250,619,33230946.91,791,9784,8993,3723.373183,2457.311017
Cell R26,3250,622,33392001.58,1394,9201,7807,6701.78135,1977.032343
Cell R27,3250,622,33392001.58,3484,9386,5902,7693.05627,754.5240712
Cell R28,3250,625,33553056.25,1476,9768,8292,6173.0064,2000.116695
Cell R29,3250,626,33606741.14,2387,9773,7386,7542.907348,958.0640812
Cell R30,3250,624,33499371.36,5246,8476,3230,7562.777244,511.7350076
Cell R31,3250,623,33445686.47,5511,8498,2987,7806.789727,475.5047794
Cell R35,3250,623,33445686.47,-1875,8738,10613,6608.895666,2227.535676
Cell R36,3250,625,33553056.25,1117,9005,7888,7324.7216,1508.746749
Cell R37,3250,621,33338316.69,1675,8976,7301,6744.600644,1563.592361
Cell R38,3250,622,33392001.58,1447,8825,7378,6761.073955,1638.017046
Cell R39,3250,620,33284631.8,1920,9211,7291,7098.717742,1312.559184
Cell R40,3250,625,33553056.25,2443,8808,6365,6940.1216,1170.476054
Cell R46,3250,624,33499371.36,448,9056,8608,4854.560897,2585.793653
Cell R47,3250,622,33392001.58,1227,9581,8354,6492.16881,2081.524148
Cell R48,3250,622,33392001.58,913,9388,8475,5867.692926,2192.402036
Cell R49,3250,624,33499371.36,1133,8574,7441,6163.575321,1891.3151
Cell R5,3250,620,33284631.8,-1970,8349,10319,5662.114516,1939.919931
Cell R50,3250,619,33230946.91,1148,9569,8421,5246.011309,2224.554031
Cell R51,3250,623,33445686.47,2159,8808,6649,6944.722311,1058.083906
Cell R52,3250,624,33499371.36,2761,8651,5890,7504.839744,667.6093783
Cell R53,3250,624,33499371.36,3421,8408,4987,7456.375,519.2672479
Cell R54,3250,622,33392001.58,6896,8747,1851,8239.699357,365.0259709
Cell R58,3250,623,33445686.47,273,9901,9628,4756.184591,2575.61634
Cell R59,3250,621,33338316.69,273,9971,9698,7185.584541,1675.984327
Cell R6,3250,620,33284631.8,2583,8637,6054,7529.595161,918.9254571
Cell R60,3250,624,33499371.36,-471,9026,9497,7334.057692,942.9117936
Cell R61,3250,620,33284631.8,879,9982,9103,4778.124194,2820.871611
Cell R62,3250,624,33499371.36,716,9348,8632,4374.581731,2398.792165
Cell R63,3250,626,33606741.14,716,8394,7678,6674.298722,1663.528355
Cell R64,3250,624,33499371.36,3349,8335,4986,7616.600962,523.0370256
Cell R65,3250,619,33230946.91,7166,8690,1524,7956.49273,289.6467034
Cell R66,3250,622,33392001.58,7476,8798,1322,8417.562701,216.1394433
Cell R69,3250,625,33553056.25,93,9655,9562,4005.832,2665.694258
Cell R7,3250,620,33284631.8,620,8633,8013,6821.946774,1330.055254
Cell R70,3250,622,33392001.58,-1894,9795,11689,5480.458199,2337.337026
Cell R71,3250,623,33445686.47,850,8841,7991,6861.515249,1645.725794
Cell R72,3250,626,33606741.14,-10,9343,9353,4804.71885,2757.295024
Cell R73,3250,622,33392001.58,1203,9829,8626,6599.294212,2114.431185
Cell R74,3250,622,33392001.58,1342,9341,7999,6679.09164,1846.415556
Cell R75,3250,622,33392001.58,6008,8451,2443,7769.856913,305.684589
Cell R76,3250,622,33392001.58,6807,8790,1983,8128.319936,307.7358645
Cell R77,3250,621,33338316.69,6613,8802,2189,8145.10467,333.7729762
Cell R8,3250,624,33499371.36,-384,8813,9197,7398.559295,1152.547767
Cell R80,3250,621,33338316.69,-1894,9795,11689,5031.275362,2722.830011
Cell R81,3250,621,33338316.69,676,9507,8831,7205.621578,1531.539494
Cell R82,3250,620,33284631.8,-10,8824,8834,4224.45,2748.628164
Cell R83,3250,625,33553056.25,422,8755,8333,5511.2272,2560.850217
Cell R84,3250,621,33338316.69,1302,8712,7410,4577.94525,2291.869248
Cell R85,3250,620,33284631.8,1376,8712,7336,6409.104839,1795.808441
Cell R86,3250,622,33392001.58,6066,8399,2333,7436.05627,413.3176278
Cell R87,3250,624,33499371.36,6943,8547,1604,7772.240385,304.4244779
Cell R9,3250,620,33284631.8,382,8813,8431,7390.229032,788.9221184
Cell R90,3250,625,33553056.25,784,9694,8910,6709.4992,1922.293991
Cell R91,3250,622,33392001.58,4161,8860,4699,7606.946945,606.7734699
Cell R92,3250,625,33553056.25,1249,9683,8434,3612.2784,2275.170183
Cell R93,3250,621,33338316.69,1682,9040,7358,7014.228663,1238.742439
Cell R97,3250,621,33338316.69,1284,9077,7793,6636.115942,1995.968587
Cell R98,3250,624,33499371.36,4664,8395,3731,7739.008013,352.3040439
Cell R99,3250,626,33606741.14,5812,8435,2623,7633.789137,312.184466
Cell S102,3250,622,33392001.58,6731,8935,2204,8034.680064,450.8530345
Cell S108,3250,626,33606741.14,6068,8870,2802,8034.50639,507.8547132
Cell S13,3250,626,33606741.14,6084,9045,2961,8119.948882,481.4485404
Cell S14,3250,620,33284631.8,5706,9125,3419,8304.098387,450.4740818
Cell S2,3250,625,33553056.25,5628,8675,3047,7907.024,414.6666722
Cell S23,3250,625,33553056.25,6351,8842,2491,8293.1392,372.2391637
Cell S32,3250,626,33606741.14,5805,8938,3133,8068.728435,375.2689979
Cell S33,3250,625,33553056.25,5452,8600,3148,7859.6096,423.3803562
Cell S34,3250,621,33338316.69,6649,8848,2199,8098.357488,321.5954907
Cell S41,3250,626,33606741.14,6907,8751,1844,7780.543131,279.0510773
Cell S42,3250,620,33284631.8,6899,8915,2016,8232.183871,326.8988623
Cell S44,3250,624,33499371.36,7369,8857,1488,8135.612179,290.634524
Cell S56,3250,623,33445686.47,5634,8793,3159,7912.70947,515.9343974
Cell S67,3250,625,33553056.25,6169,8858,2689,8204.6768,385.9548963
Cell S78,3250,625,33553056.25,6692,8941,2249,8322.2768,298.7930471
Cell S88,3250,626,33606741.14,6375,8915,2540,8095.761981,435.6511148
Cell S94,3250,626,33606741.14,7045,8935,1890,8123.974441,317.2416651
Cell S95,3250,619,33230946.91,6731,8796,2065,7916.723748,435.4748281
W287,3250,624,33499371.36,817,8994,8177,4089.073718,1822.532408
W295,3250,621,33338316.69,1997,8825,6828,7156.921095,1148.631435
W338,3250,619,33230946.91,1098,9843,8745,5316.466882,2467.785183
W342,3250,620,33284631.8,1473,8109,6636,5490.066129,1970.027811
W345,3250,624,33499371.36,3683,7950,4267,7397.915064,609.1142193
W387,3250,620,33284631.8,1191,8728,7537,5669.703226,2416.416584
W393,3250,621,33338316.69,1670,8897,7227,6938.494364,1389.467308
W440,3250,624,33499371.36,1429,8342,6913,5522.012821,2010.704726
W441,3250,624,33499371.36,3682,8537,4855,7343.641026,746.0821769
W445,3250,620,33284631.8,4029,8470,4441,6970.791935,683.1351897
W500,3250,624,33499371.36,1427,8822,7395,5843.586538,2118.684245
1,3500,719,38599435.91,2583,8637,6054,7532.726008,893.0264268
2,3500,721,38706805.69,1950,8837,6887,6483.944521,1445.895206
3,3500,718,38545751.02,5274,8200,2926,7544.087744,348.9598701
4,3500,720,38653120.8,2251,8547,6296,7124.316667,906.023603
5,3500,722,38760490.58,-1875,8738,10613,6594.970914,2201.844064
6,3500,726,38975230.14,2647,8743,6096,7457.491736,1008.723898
7,3500,723,38814175.47,1629,9768,8139,7070.966805,1180.134443
8,3500,720,38653120.8,2057,8838,6781,6600.975,1360.361508
9,3500,720,38653120.8,6717,8692,1975,7888.811111,302.584975
10,3500,724,38867860.36,628,9581,8953,6452.366022,2158.472523
11,3500,726,38975230.14,623,9388,8765,5758.977961,2245.999209
12,3500,726,38975230.14,1148,9569,8421,5072.250689,2282.797843
13,3500,722,38760490.58,2159,8808,6649,6930.904432,1106.138252
14,3500,719,38599435.91,4900,8680,3780,8061.78025,491.430677
16,3500,724,38867860.36,93,9814,9721,4424.870166,2769.482835
17,3500,720,38653120.8,-471,9366,9837,7297.781944,1042.333875
18,3500,723,38814175.47,854,9982,9128,4288.966805,2686.849643
19,3500,718,38545751.02,716,9348,8632,4507.119777,2412.970532
20,3500,720,38653120.8,6008,8451,2443,7769.202778,306.7512981
21,3500,725,38921545.25,6613,8802,2189,8151.982069,324.0088606
22,3500,724,38867860.36,-1894,9795,11689,4637.016575,2840.600816
23,3500,723,38814175.47,-10,8824,8834,4239.789765,2728.87542
24,3500,722,38760490.58,2610,8860,6250,7538.655125,735.148114
25,3500,725,38921545.25,1648,9040,7392,6974.886897,1308.902349
26,3500,724,38867860.36,6380,8547,2167,7782.85221,315.7387793
27,3500,722,38760490.58,4664,8487,3823,7733.319945,403.4386804
28,3500,722,38760490.58,5711,8294,2583,7547.811634,438.7881927
29,3500,721,38706805.69,3827,8711,4884,7593.267684,546.3983642
31,3500,726,38975230.14,6423,9474,3051,7666.913223,356.4047007
32,3500,722,38760490.58,1694,8225,6531,6838.764543,1210.816459
33,3500,723,38814175.47,6193,8892,2699,7441.854772,356.0954884
34,3500,724,38867860.36,5586,8364,2778,7292.585635,454.6520916
10A,3500,723,38814175.47,1226,9581,8355,6369.070539,2171.160453
10NE,3500,720,38653120.8,312,8867,8555,6513.556944,2185.689032
10NW,3500,723,38814175.47,1117,9005,7888,7211.546335,1627.80216
10SW,3500,723,38814175.47,448,9915,9467,5073.64592,2540.426247
11NE,3500,726,38975230.14,1675,8976,7301,6766.157025,1553.168329
11NW,3500,718,38545751.02,-195,9328,9523,5994.640669,2497.184588
11SE,3500,724,38867860.36,1133,9388,8255,6056.064917,2012.935191
17NW,3500,723,38814175.47,258,9971,9713,6950.196404,1953.118177
17SE,3500,719,38599435.91,850,8841,7991,6728.890125,1787.609809
17SW,3500,725,38921545.25,-1894,9795,11689,5437.393103,2400.003549
22S,3500,723,38814175.47,-1894,9795,11689,4453.150761,2830.494077
23S,3500,726,38975230.14,1090,9322,8232,3444.750689,1799.117559
24S,3500,723,38814175.47,2610,8860,6250,7528.813278,749.5574515
27A,3500,722,38760490.58,1284,8980,7696,6519.355956,2058.152281
2A,3500,718,38545751.02,1571,8837,7266,6322.810585,1783.520623
5NE,3500,720,38653120.8,-1842,9827,11669,5262.495833,2268.936727
5NW,3500,721,38706805.69,-1846,9827,11673,5503.38835,2312.517545
5SE,3500,723,38814175.47,791,9784,8993,3828.069156,2489.996142
6NE,3500,724,38867860.36,1697,8722,7025,6871.328729,1616.417906
6NW,3500,725,38921545.25,1394,9201,7807,6555.471724,2078.837681
6SW,3500,719,38599435.91,1204,8939,7735,6616.763561,2110.977771
Cell 1 2011/12,3500,719,38599435.91,2583,8637,6054,7532.726008,893.0264268
Cell 1 SW 2013,3500,722,38760490.58,-1970,8948,10918,5378.16205,2209.271837
Cell 10 2011/12,3500,724,38867860.36,628,9581,8953,6452.366022,2158.472523
Cell 10 NE 2011/12,3500,720,38653120.8,312,8867,8555,6513.556944,2185.689032
Cell 10 NW 2011/12,3500,723,38814175.47,1117,9005,7888,7211.546335,1627.80216
Cell 10 SE 2013,3500,725,38921545.25,1394,9201,7807,6555.471724,2078.837681
Cell 10 SW 2011/12,3500,723,38814175.47,448,9915,9467,5073.64592,2540.426247
Cell 10-A 2011/12,3500,723,38814175.47,1226,9581,8355,6369.070539,2171.160453
Cell 11 NE 2011/12,3500,726,38975230.14,1675,8976,7301,6766.157025,1553.168329
Cell 11 NW 2013,3500,717,38492066.13,1607,8837,7230,6446.818689,1621.360796
Cell 11 SW 2013,3500,719,38599435.91,1884,9386,7502,7621.37274,927.2974402
Cell 12 2013,3500,722,38760490.58,1629,9768,8139,7072.452909,1182.489999
Cell 13 2013,3500,719,38599435.91,2057,8838,6781,6494.140473,1430.63957
Cell 14 2013,3500,719,38599435.91,7061,8702,1641,8137.756606,289.6559429
Cell 15 2013,3500,721,38706805.69,5348,8667,3319,7860.080444,466.6861802
Cell 15-A 2013,3500,721,38706805.69,5452,8620,3168,7871.088766,422.7377554
Cell 16 2013,3500,725,38921545.25,6616,8789,2173,7950.82069,386.5808221
Cell 17 NW 2011/12,3500,723,38814175.47,258,9971,9713,6950.196404,1953.118177
Cell 17 NW 2013,3500,727,39028915.03,-1875,8918,10793,5824.378267,2337.557339
Cell 17 SE 2013,3500,723,38814175.47,1117,9005,7888,7211.546335,1627.80216
Cell 17 SW 2013,3500,723,38814175.47,-1875,8738,10613,6590.493776,2190.213735
Cell 18 2011/12,3500,723,38814175.47,854,9982,9128,4288.966805,2686.849643
Cell 18 NE 2013,3500,720,38653120.8,1204,8939,7735,6546.925,2178.775119
Cell 18 NW 2013,3500,723,38814175.47,791,9784,8993,3726.289073,2437.768132
Cell 18 SE 2013,3500,725,38921545.25,1675,8976,7301,6764.605517,1553.676802
Cell 18 SSE 2013,3500,722,38760490.58,-195,9388,9583,5887.65651,2429.652456
Cell 19 NW 2013,3500,720,38653120.8,3010,9386,6376,7605.948611,900.0810852
Cell 2 2011/12,3500,721,38706805.69,1950,8837,6887,6483.944521,1445.895206
Cell 2 NE 2013,3500,723,38814175.47,-1502,8957,10459,6181.901798,1891.219962
Cell 2 SW 2013,3500,719,38599435.91,2583,8637,6054,7534.456189,893.2940279
Cell 20 2013,3500,717,38492066.13,1847,9773,7926,7424.938633,1153.692931
Cell 21 2013,3500,719,38599435.91,2443,8808,6365,6968.225313,1156.604797
Cell 22 2013,3500,724,38867860.36,6899,8416,1517,7820.895028,265.7956938
Cell 23 2013,3500,725,38921545.25,6899,8915,2016,8205.736552,338.7259999
Cell 24 2013,3500,724,38867860.36,6649,8848,2199,8095.042818,334.2982294
Cell 25 NE 2013,3500,726,38975230.14,628,9581,8953,6448.707989,2162.420671
Cell 25 SE 2013,3500,723,38814175.47,448,9915,9467,5073.64592,2540.426247
Cell 26 NE 2013,3500,726,38975230.14,623,9388,8765,5758.977961,2245.999209
Cell 26 NNW 2013,3500,720,38653120.8,312,8867,8555,6513.556944,2185.689032
Cell 26 NW 2013,3500,723,38814175.47,1226,9581,8355,6369.070539,2171.160453
Cell 27 NW 2013,3500,724,38867860.36,1133,9388,8255,6056.064917,2012.935191
Cell 28 2013,3500,727,39028915.03,1148,9569,8421,5067.115543,2285.419516
Cell 29 2013,3500,720,38653120.8,2159,8808,6649,6934.169444,1105.910193
Cell 3 NE 2013,3500,718,38545751.02,-384,8813,9197,7298.093315,1151.443903
Cell 3 NW 2013,3500,719,38599435.91,134,8633,8499,6806.133519,1405.672349
Cell 30 2013,3500,724,38867860.36,7100,8690,1590,7961.703039,301.4224957
Cell 31 2013,3500,725,38921545.25,5965,8924,2959,8240.048276,375.7173063
Cell 32 2013,3500,723,38814175.47,5823,8955,3132,8193.593361,408.2562461
Cell 33 NE 2013,3500,723,38814175.47,258,9971,9713,6950.196404,1953.118177
Cell 33 SE 2013,3500,726,38975230.14,-1894,9795,11689,5442.11157,2401.712821
Cell 33 SW 2013,3500,719,38599435.91,-127,9814,9941,4191.489569,2768.526275
Cell 34 N 2013,3500,719,38599435.91,2059,8825,6766,6907.588317,1274.586325
Cell 34 NW 2013,3500,719,38599435.91,-471,9366,9837,7297.723227,1043.057283
Cell 34 SE 2013,3500,720,38653120.8,850,8841,7991,6734.758333,1784.40937
Cell 35 2013,3500,723,38814175.47,879,9982,9103,4745.275242,2788.158596
Cell 37 2013,3500,724,38867860.36,6008,8451,2443,7766.598066,306.4679691
Cell 38 2013,3500,724,38867860.36,6613,8802,2189,8151.374309,324.113175
Cell 39 2013,3500,720,38653120.8,6692,8960,2268,8336.168056,296.1043188
Cell 4 2013,3500,722,38760490.58,5794,8537,2743,7486.753463,412.8798329
Cell 40 NE 2013,3500,724,38867860.36,-1894,9795,11689,4994.95442,2733.327152
Cell 41 N 2013,3500,725,38921545.25,-1813,9615,11428,6867.223448,1977.062153
Cell 41 NW 2013,3500,720,38653120.8,-1894,9615,11509,5799.9,2695.659455
Cell 42 NW 2013,3500,724,38867860.36,-10,9754,9764,4201.339779,2760.614476
Cell 43 2013,3500,725,38921545.25,1376,8712,7336,6326.675862,1877.682966
Cell 44 2013,3500,724,38867860.36,5923,8413,2490,7546.843923,470.9321563
Cell 45 2013,3500,723,38814175.47,6651,8547,1896,7785.773167,312.6333271
Cell 47 2013,3500,719,38599435.91,784,9694,8910,6547.115438,2041.292339
Cell 48 2013,3500,721,38706805.69,2610,8860,6250,7529.457698,750.02462
Cell 49 2013,3500,725,38921545.25,1648,9040,7392,6974.886897,1308.902349
Cell 5 2011/12 Summer,3500,722,38760490.58,-1875,8738,10613,6593.228532,2190.496077
Cell 5 2013,3500,720,38653120.8,5041,8746,3705,7869.156944,585.1366854
Cell 50 2013,3500,721,38706805.69,3827,8711,4884,7593.267684,546.3983642
Cell 51 2013,3500,727,39028915.03,6731,8796,2065,7935.878955,432.6596156
Cell 52 2013,3500,720,38653120.8,2668,8435,5767,7601.731944,485.8263797
Cell 53 2013,3500,723,38814175.47,5711,8294,2583,7547.839557,438.48528
Cell 54 2013,3500,721,38706805.69,5938,8961,3023,8079.194175,518.6558575
Cell 55 2013,3500,721,38706805.69,6068,8870,2802,8010.269071,518.8514385
Cell 56 2013,3500,725,38921545.25,6193,8892,2699,7442.315862,355.7237608
Cell 57 2013,3500,722,38760490.58,1694,8225,6531,6842.972299,1202.672409
Cell 58 2013,3500,719,38599435.91,6812,8759,1947,8101.66064,284.77453
Cell 59 2013,3500,724,38867860.36,6193,9039,2846,7433.662983,390.009629
Cell 6 2011/12,3500,726,38975230.14,2647,8743,6096,7457.491736,1008.723898
Cell 6 2013,3500,726,38975230.14,5628,8675,3047,7942.309917,414.0441534
Cell 6 NE 2011/12,3500,724,38867860.36,1697,8722,7025,6871.328729,1616.417906
Cell 6 NW 2011/12,3500,725,38921545.25,1394,9201,7807,6555.471724,2078.837681
Cell 6 SW 2011/12,3500,719,38599435.91,1204,8939,7735,6616.763561,2110.977771
Cell 60 2013,3500,724,38867860.36,5586,8364,2778,7288.287293,439.2351122
Cell 61 2013,3500,726,38975230.14,3613,8796,5183,7535.666667,607.5049449
Cell 7 2013,3500,726,38975230.14,5706,9125,3419,8241.641873,522.4774276
Cell 9 NW 2013,3500,724,38867860.36,-1842,9468,11310,5348.843923,2408.68703
Cell 9 SE 2013,3500,720,38653120.8,-1842,9827,11669,5262.495833,2268.936727
Cell 9 SW 2013,3500,721,38706805.69,-1846,9827,11673,5500.104022,2312.328285
Cell R1,3500,723,38814175.47,1268,8189,6921,5997.02213,2028.600585
Cell R10,3500,722,38760490.58,5794,8537,2743,7486.753463,412.8798329
Cell R100,3500,722,38760490.58,3827,8711,4884,7593.293629,546.0202853
Cell R101,3500,721,38706805.69,6325,8642,2317,7889.997226,387.4671191
Cell R104,3500,723,38814175.47,1639,8852,7213,7484.080221,1388.800531
Cell R105,3500,723,38814175.47,5711,8294,2583,7547.839557,438.48528
Cell R106,3500,724,38867860.36,1693,8904,7211,6991.20442,1467.256955
Cell R107,3500,723,38814175.47,5938,8961,3023,8075.62379,522.4298078
Cell R11,3500,721,38706805.69,5041,8746,3705,7868.571429,584.941794
Cell R111,3500,723,38814175.47,1549,9474,7925,6989.218534,1807.658593
Cell R112,3500,719,38599435.91,6507,8405,1898,7586.514604,328.8549815
Cell R113,3500,722,38760490.58,1694,8225,6531,6842.972299,1202.672409
Cell R114,3500,720,38653120.8,6812,8759,1947,8101.311111,284.7309947
Cell R117,3500,723,38814175.47,2900,9347,6447,7669.074689,628.3826657
Cell R118,3500,725,38921545.25,6193,8892,2699,7442.315862,355.7237608
Cell R119,3500,724,38867860.36,1694,7991,6297,6894.466851,823.263812
Cell R120,3500,723,38814175.47,4695,8517,3822,7526.40249,636.8682234
Cell R121,3500,722,38760490.58,6706,8663,1957,8032.419668,297.4553991
Cell R123,3500,722,38760490.58,6615,9136,2521,7525.149584,387.9836395
Cell R124,3500,721,38706805.69,4010,8364,4354,7272.209431,455.7105034
Cell R125,3500,726,38975230.14,2277,8373,6096,6629.966942,1271.456887
Cell R126,3500,721,38706805.69,3613,8451,4838,7323.635229,744.0321521
Cell R15,3500,722,38760490.58,-1970,8948,10918,5378.16205,2209.271837
Cell R16,3500,727,39028915.03,-1842,9468,11310,5349.246217,2405.659925
Cell R17,3500,720,38653120.8,1969,9201,7232,7254.745833,1234.823303
Cell R18,3500,724,38867860.36,1607,8837,7230,6432.770718,1637.47241
Cell R19,3500,724,38867860.36,1457,9275,7818,7235.845304,1188.117412
Cell R20,3500,717,38492066.13,2251,8547,6296,7096.847978,950.40561
Cell R21,3500,718,38545751.02,4307,8683,4376,7754.732591,487.4732857
Cell R22,3500,719,38599435.91,7061,8702,1641,8137.756606,289.6559429
Cell R24,3500,727,39028915.03,-1875,8918,10793,5824.378267,2337.557339
Cell R25,3500,723,38814175.47,791,9784,8993,3726.289073,2437.768132
Cell R26,3500,722,38760490.58,1394,9201,7807,6617.864266,2020.88977
Cell R27,3500,721,38706805.69,3010,9386,6376,7606.841886,899.7759915
Cell R28,3500,722,38760490.58,1418,9768,8350,6121.792244,2053.011918
Cell R29,3500,717,38492066.13,1847,9773,7926,7424.938633,1153.692931
Cell R30,3500,723,38814175.47,5065,8476,3411,7548.745505,525.0586257
Cell R31,3500,722,38760490.58,5511,8581,3070,7827.049861,469.197128
Cell R35,3500,722,38760490.58,-1875,8738,10613,6593.228532,2190.496077
Cell R36,3500,723,38814175.47,1117,9005,7888,7211.546335,1627.80216
Cell R37,3500,726,38975230.14,1675,8976,7301,6766.157025,1553.168329
Cell R38,3500,726,38975230.14,1447,8825,7378,6593.221763,1764.762965
Cell R39,3500,724,38867860.36,1920,9211,7291,7025.740331,1326.144052
Cell R40,3500,719,38599435.91,2443,8808,6365,6968.225313,1156.604797
Cell R46,3500,723,38814175.47,193,9056,8863,4952.994467,2579.732282
Cell R47,3500,723,38814175.47,1226,9581,8355,6369.070539,2171.160453
Cell R48,3500,726,38975230.14,623,9388,8765,5758.977961,2245.999209
Cell R49,3500,724,38867860.36,1133,9388,8255,6056.064917,2012.935191
Cell R5,3500,723,38814175.47,-1970,8349,10319,5677.910097,1920.514002
Cell R50,3500,725,38921545.25,1148,9569,8421,5072.769655,2284.328846
Cell R51,3500,723,38814175.47,2159,8808,6649,6941.793914,1092.627056
Cell R52,3500,720,38653120.8,2761,8651,5890,7438.030556,743.6808206
Cell R53,3500,721,38706805.69,3421,8616,5195,7459.421637,513.2531661
Cell R54,3500,725,38921545.25,5965,8924,2959,8240.048276,375.7173063
Cell R58,3500,719,38599435.91,76,9901,9825,4704.018081,2579.989864
Cell R59,3500,722,38760490.58,258,9971,9713,6957.529086,1944.499849
Cell R6,3500,719,38599435.91,2583,8637,6054,7534.456189,893.2940279
Cell R60,3500,719,38599435.91,-471,9366,9837,7297.723227,1043.057283
Cell R61,3500,723,38814175.47,879,9982,9103,4745.275242,2788.158596
Cell R62,3500,721,38706805.69,716,9348,8632,4381.377254,2401.892287
Cell R63,3500,718,38545751.02,716,8530,7814,6647.073816,1680.078483
Cell R64,3500,721,38706805.69,3349,8335,4986,7605.117892,519.8845879
Cell R65,3500,724,38867860.36,7100,8690,1590,7961.703039,301.4224957
Cell R66,3500,724,38867860.36,7476,8798,1322,8403.464088,218.4872655
Cell R69,3500,719,38599435.91,-127,9814,9941,4191.489569,2768.526275
Cell R7,3500,719,38599435.91,134,8633,8499,6806.133519,1405.672349
Cell R70,3500,726,38975230.14,-1894,9795,11689,5442.11157,2401.712821
Cell R71,3500,720,38653120.8,850,8841,7991,6734.758333,1784.40937
Cell R72,3500,717,38492066.13,-10,9343,9353,4952.997211,2756.974036
Cell R73,3500,722,38760490.58,1203,9829,8626,6395.189751,2248.252923
Cell R74,3500,720,38653120.8,1342,9341,7999,6637.758333,1902.229794
Cell R75,3500,723,38814175.47,6008,8451,2443,7766.626556,306.6788797
Cell R76,3500,724,38867860.36,6613,8790,2177,8110.798343,309.995011
Cell R77,3500,724,38867860.36,6613,8802,2189,8151.374309,324.113175
Cell R8,3500,723,38814175.47,-384,8813,9197,7378.829876,1142.094454
Cell R80,3500,724,38867860.36,-1894,9795,11689,4994.95442,2733.327152
Cell R81,3500,723,38814175.47,441,9507,9066,7010.333333,1782.603152
Cell R82,3500,724,38867860.36,-10,9754,9764,4201.339779,2760.614476
Cell R83,3500,721,38706805.69,422,8755,8333,5429.456311,2561.311535
Cell R84,3500,720,38653120.8,1302,8712,7410,4595.726389,2297.839733
Cell R85,3500,725,38921545.25,1376,8712,7336,6326.675862,1877.682966
Cell R86,3500,719,38599435.91,6066,8399,2333,7441.077886,414.9656816
Cell R87,3500,725,38921545.25,6380,8547,2167,7784.171034,316.6630163
Cell R9,3500,723,38814175.47,-384,8813,9197,7355.807746,918.9326031
Cell R90,3500,719,38599435.91,784,9694,8910,6547.115438,2041.292339
Cell R91,3500,722,38760490.58,2610,8860,6250,7529.84072,749.5755925
Cell R92,3500,721,38706805.69,1249,9683,8434,3674.112344,2253.202845
Cell R93,3500,725,38921545.25,1648,9040,7392,6974.886897,1308.902349
Cell R97,3500,723,38814175.47,1284,9077,7793,6623.66805,1978.175398
Cell R98,3500,722,38760490.58,4664,8487,3823,7734.325485,402.8929123
Cell R99,3500,720,38653120.8,2668,8435,5767,7601.731944,485.8263797
Cell S102,3500,719,38599435.91,6731,8935,2204,8037.696801,444.4585146
Cell S108,3500,721,38706805.69,6068,8870,2802,8010.269071,518.8514385
Cell S13,3500,718,38545751.02,6084,9045,2961,8126.909471,474.2928898
Cell S14,3500,726,38975230.14,5706,9125,3419,8241.641873,522.4774276
Cell S2,3500,726,38975230.14,5628,8675,3047,7942.309917,414.0441534
Cell S23,3500,721,38706805.69,6351,8842,2491,8270.549237,376.7890261
Cell S32,3500,718,38545751.02,5779,8938,3159,8026.21727,422.7530676
Cell S33,3500,721,38706805.69,5452,8620,3168,7871.088766,422.7377554
Cell S34,3500,724,38867860.36,6649,8848,2199,8095.042818,334.2982294
Cell S41,3500,719,38599435.91,6027,8751,2724,7768.916551,295.9955526
Cell S42,3500,726,38975230.14,6899,8915,2016,8205.716253,338.4930784
Cell S44,3500,723,38814175.47,7365,8857,1492,8141.676349,297.2621689
Cell S56,3500,721,38706805.69,5634,8793,3159,7920.027739,515.3675599
Cell S67,3500,723,38814175.47,5823,8955,3132,8193.593361,408.2562461
Cell S78,3500,720,38653120.8,6692,8960,2268,8336.168056,296.1043188
Cell S88,3500,723,38814175.47,6375,8915,2540,8102.052559,423.234035
Cell S94,3500,724,38867860.36,7045,8935,1890,8121.225138,314.9893892
Cell S95,3500,727,39028915.03,6731,8796,2065,7935.878955,432.6596156
W287,3500,722,38760490.58,807,8994,8187,4051.415512,1825.649224
W295,3500,720,38653120.8,1997,8825,6828,7174.219444,1170.502501
W338,3500,725,38921545.25,1073,9843,8770,5086.93931,2528.692233
W342,3500,725,38921545.25,1473,8109,6636,5470.889655,1985.431472
W345,3500,722,38760490.58,3683,8069,4386,7415.458449,586.3065615
W387,3500,721,38706805.69,1191,8728,7537,5652.522885,2470.872282
W393,3500,725,38921545.25,1670,8897,7227,6815.165517,1533.226192
W440,3500,723,38814175.47,1429,8342,6913,5433.856155,2075.140414
W441,3500,719,38599435.91,3682,8537,4855,7286.360223,787.5637985
W445,3500,724,38867860.36,4029,8470,4441,6942.124309,718.9012976
W500,3500,717,38492066.13,1427,8823,7396,5889.306834,2059.653022
1,3750,826,44343719.14,2583,8639,6056,7531.811138,897.2686227
2,3750,828,44451088.92,1950,8837,6887,6490.376812,1452.447061
3,3750,833,44719513.37,5274,9189,3915,7537.021609,370.8415394
4,3750,830,44558458.7,2251,8547,6296,7105.686747,956.579028
5,3750,830,44558458.7,-1875,8738,10613,6615.914458,2135.261707
6,3750,830,44558458.7,2441,9386,6945,7394.081928,1096.606218
7,3750,828,44451088.92,1629,9768,8139,7024.72343,1251.749777
8,3750,832,44665828.48,2057,8838,6781,6660.757212,1371.239311
9,3750,836,44880568.04,6717,8751,2034,7881.449761,313.3348158
10,3750,827,44397404.03,628,9581,8953,6422.081016,2207.983869
11,3750,824,44236349.36,623,9388,8765,5660.095874,2274.820807
12,3750,821,44075294.69,1148,9569,8421,4900.630938,2336.00115
13,3750,826,44343719.14,2159,8808,6649,6904.627119,1148.148913
14,3750,832,44665828.48,4359,8723,4364,8044.832933,539.8597728
16,3750,825,44290034.25,93,9814,9721,4515.989091,2816.132124
17,3750,830,44558458.7,-471,9366,9837,7237.008434,1143.832584
18,3750,829,44504773.81,854,9982,9128,4365.693607,2709.959688
19,3750,832,44665828.48,716,9348,8632,4572.49399,2439.608594
20,3750,832,44665828.48,6008,8674,2666,7778.394231,305.1649079
21,3750,829,44504773.81,6613,8802,2189,8166.702051,313.8457386
22,3750,828,44451088.92,-1894,9795,11689,4645.69686,2813.883685
23,3750,834,44773198.26,-10,9754,9764,4277.818945,2724.300771
24,3750,827,44397404.03,1411,8860,7449,7423.498186,1033.127659
25,3750,835,44826883.15,1627,9040,7413,6958.31497,1347.603815
26,3750,831,44612143.59,6380,8547,2167,7792.326113,324.5718324
27,3750,830,44558458.7,4664,8487,3823,7732.26747,411.9381411
28,3750,830,44558458.7,4367,8307,3940,7546.20241,451.1447741
29,3750,827,44397404.03,3827,8711,4884,7593.153567,598.2781435
31,3750,830,44558458.7,6423,9474,3051,7674.409639,369.1653574
32,3750,829,44504773.81,1694,8696,7002,6812.278649,1279.79895
33,3750,826,44343719.14,6193,8892,2699,7456.554479,376.6608452
34,3750,832,44665828.48,5212,8364,3152,7277.240385,454.2985214
10A,3750,826,44343719.14,837,9915,9078,6273.858354,2253.628178
10NE,3750,829,44504773.81,312,8867,8555,6337.904704,2294.841214
10NW,3750,831,44612143.59,513,9005,8492,7038.706378,1842.125023
10SW,3750,823,44182664.47,448,9915,9467,5094.808019,2539.205161
11NE,3750,830,44558458.7,1675,9328,7653,6753.980723,1585.0939
11NW,3750,827,44397404.03,-195,9388,9583,5846.234583,2535.959423
11SE,3750,830,44558458.7,1068,9388,8320,5982.021687,2096.594829
17NW,3750,830,44558458.7,258,9971,9713,6755.910843,2120.795602
17SE,3750,828,44451088.92,850,8841,7991,6650.968599,1848.131954
17SW,3750,824,44236349.36,-1894,9795,11689,5437.208738,2445.00287
22S,3750,832,44665828.48,-1894,9795,11689,4441.979567,2811.356362
23S,3750,821,44075294.69,1090,9322,8232,3480.416565,1829.832216
24S,3750,831,44612143.59,1411,8860,7449,7402.097473,1066.375183
27A,3750,828,44451088.92,1284,8980,7696,6585.125604,2026.554323
2A,3750,830,44558458.7,1571,8837,7266,6334.096386,1766.128288
5NE,3750,831,44612143.59,-1842,9827,11669,5032.345367,2349.344588
5NW,3750,828,44451088.92,-1875,9827,11702,5469.082126,2355.411134
5SE,3750,827,44397404.03,791,9784,8993,3822.962515,2479.408483
6NE,3750,831,44612143.59,1697,8722,7025,6893.12515,1593.252735
6NW,3750,831,44612143.59,1056,9386,8330,6484.888087,2132.607128
6SW,3750,831,44612143.59,1204,8939,7735,6589.971119,2140.54141
Cell 1 2011/12,3750,826,44343719.14,2583,8639,6056,7531.811138,897.2686227
Cell 1 SW 2013,3750,826,44343719.14,-1970,8948,10918,5294.236077,2202.761257
Cell 10 2011/12,3750,827,44397404.03,628,9581,8953,6422.081016,2207.983869
Cell 10 NE 2011/12,3750,829,44504773.81,312,8867,8555,6337.904704,2294.841214
Cell 10 NW 2011/12,3750,831,44612143.59,513,9005,8492,7038.706378,1842.125023
Cell 10 SE 2013,3750,831,44612143.59,1056,9386,8330,6484.888087,2132.607128
Cell 10 SW 2011/12,3750,823,44182664.47,448,9915,9467,5094.808019,2539.205161
Cell 10-A 2011/12,3750,826,44343719.14,837,9915,9078,6273.858354,2253.628178
Cell 11 NE 2011/12,3750,830,44558458.7,1675,9328,7653,6753.980723,1585.0939
Cell 11 NW 2013,3750,830,44558458.7,1607,8837,7230,6417.059036,1638.785835
Cell 11 SW 2013,3750,831,44612143.59,1757,9386,7629,7465.788207,1183.547397
Cell 12 2013,3750,831,44612143.59,1629,9768,8139,7027.454874,1250.476468
Cell 13 2013,3750,832,44665828.48,1533,8838,7305,6561.104567,1424.76908
Cell 14 2013,3750,830,44558458.7,6858,8733,1875,8116.696386,304.8973272
Cell 15 2013,3750,828,44451088.92,5348,8761,3413,7874.378019,463.194501
Cell 15-A 2013,3750,833,44719513.37,5452,8620,3168,7876.535414,434.8670413
Cell 16 2013,3750,832,44665828.48,6616,8789,2173,7966.237981,383.8214806
Cell 17 NW 2011/12,3750,830,44558458.7,258,9971,9713,6755.910843,2120.795602
Cell 17 NW 2013,3750,829,44504773.81,-1875,9827,11702,5858.451146,2298.886284
Cell 17 SE 2013,3750,831,44612143.59,513,9005,8492,7038.706378,1842.125023
Cell 17 SW 2013,3750,825,44290034.25,-1875,8738,10613,6597.289697,2148.417164
Cell 18 2011/12,3750,829,44504773.81,854,9982,9128,4365.693607,2709.959688
Cell 18 NE 2013,3750,828,44451088.92,1204,9386,8182,6544.886473,2193.864337
Cell 18 NW 2013,3750,832,44665828.48,791,9784,8993,3724.966346,2423.945018
Cell 18 SE 2013,3750,830,44558458.7,1675,9328,7653,6753.980723,1585.0939
Cell 18 SSE 2013,3750,828,44451088.92,-195,9388,9583,5789,2461.708229
Cell 19 NW 2013,3750,829,44504773.81,1756,9386,7630,7522.237636,1041.554429
Cell 2 2011/12,3750,828,44451088.92,1950,8837,6887,6490.376812,1452.447061
Cell 2 NE 2013,3750,832,44665828.48,-2000,8957,10957,6208.098558,1890.206415
Cell 2 SW 2013,3750,826,44343719.14,2583,8639,6056,7540.239709,883.982569
Cell 20 2013,3750,830,44558458.7,1847,9773,7926,7297.243373,1329.090681
Cell 21 2013,3750,831,44612143.59,2443,8808,6365,6996.240674,1137.52627
Cell 22 2013,3750,831,44612143.59,6899,8416,1517,7828.957882,269.2994601
Cell 23 2013,3750,833,44719513.37,6899,8915,2016,8193.854742,341.1163219
Cell 24 2013,3750,830,44558458.7,6649,8848,2199,8087.66747,343.8051287
Cell 25 NE 2013,3750,826,44343719.14,628,9581,8953,6427.979419,2202.798821
Cell 25 SE 2013,3750,823,44182664.47,448,9915,9467,5094.808019,2539.205161
Cell 26 NE 2013,3750,824,44236349.36,623,9388,8765,5660.095874,2274.820807
Cell 26 NNW 2013,3750,830,44558458.7,312,8867,8555,6330.79759,2302.569204
Cell 26 NW 2013,3750,826,44343719.14,837,9915,9078,6273.858354,2253.628178
Cell 27 NW 2013,3750,830,44558458.7,1068,9388,8320,5982.021687,2096.594829
Cell 28 2013,3750,821,44075294.69,1148,9569,8421,4900.630938,2336.00115
Cell 29 2013,3750,828,44451088.92,2159,8808,6649,6904.114734,1146.832867
Cell 3 NE 2013,3750,832,44665828.48,-384,8813,9197,7296.538462,1127.929553
Cell 3 NW 2013,3750,828,44451088.92,-1502,8633,10135,6782.332126,1441.594812
Cell 30 2013,3750,831,44612143.59,7100,8690,1590,7965.827918,309.5341525
Cell 31 2013,3750,824,44236349.36,5965,8925,2960,8242.707524,373.8920242
Cell 32 2013,3750,832,44665828.48,5823,8955,3132,8190.885817,418.8045719
Cell 33 NE 2013,3750,830,44558458.7,258,9971,9713,6755.910843,2120.795602
Cell 33 SE 2013,3750,825,44290034.25,-1894,9795,11689,5431.647273,2448.730112
Cell 33 SW 2013,3750,831,44612143.59,-127,9814,9941,4343.977136,2842.073937
Cell 34 N 2013,3750,831,44612143.59,1506,8825,7319,6840.489771,1399.969304
Cell 34 NW 2013,3750,830,44558458.7,-471,9366,9837,7237.008434,1143.832584
Cell 34 SE 2013,3750,827,44397404.03,850,8841,7991,6658.501814,1839.015931
Cell 35 2013,3750,835,44826883.15,879,9982,9103,4764.626347,2746.787881
Cell 37 2013,3750,829,44504773.81,6008,8674,2666,7771.88661,306.430489
Cell 38 2013,3750,825,44290034.25,6613,8941,2328,8169.532121,317.3916525
Cell 39 2013,3750,832,44665828.48,6692,8960,2268,8349.346154,293.6028443
Cell 4 2013,3750,831,44612143.59,5794,8716,2922,7484.950662,427.2658449
Cell 40 NE 2013,3750,835,44826883.15,-1894,9795,11689,4989.246707,2686.517776
Cell 41 N 2013,3750,824,44236349.36,-1813,9615,11428,6825.726942,2032.33943
Cell 41 NW 2013,3750,826,44343719.14,-1894,9615,11509,5712.560533,2734.178023
Cell 42 NW 2013,3750,824,44236349.36,-10,9754,9764,4216.936893,2735.267221
Cell 43 2013,3750,822,44128979.58,1376,8712,7336,6264.902676,1936.912433
Cell 44 2013,3750,825,44290034.25,5923,8413,2490,7543.808485,459.1319791
Cell 45 2013,3750,831,44612143.59,6380,8547,2167,7793.412756,323.1647645
Cell 47 2013,3750,832,44665828.48,784,9694,8910,6365.036058,2141.275125
Cell 48 2013,3750,830,44558458.7,1411,8860,7449,7402.110843,1067.053405
Cell 49 2013,3750,835,44826883.15,1627,9040,7413,6958.31497,1347.603815
Cell 5 2011/12 Summer,3750,825,44290034.25,-1875,8738,10613,6597.289697,2148.417164
Cell 5 2013,3750,831,44612143.59,5041,8746,3705,7879.894103,599.3954823
Cell 50 2013,3750,827,44397404.03,3827,8711,4884,7593.153567,598.2781435
Cell 51 2013,3750,822,44128979.58,6731,8796,2065,7940.424574,431.9986185
Cell 52 2013,3750,832,44665828.48,2309,8435,6126,7567.040865,657.5172733
Cell 53 2013,3750,830,44558458.7,4367,8307,3940,7546.20241,451.1447741
Cell 54 2013,3750,828,44451088.92,5938,8961,3023,8062.434783,528.8821813
Cell 55 2013,3750,833,44719513.37,6068,8870,2802,7995.348139,519.8562908
Cell 56 2013,3750,824,44236349.36,6193,8892,2699,7456.912621,376.9300006
Cell 57 2013,3750,829,44504773.81,1694,8696,7002,6811.821472,1279.586222
Cell 58 2013,3750,832,44665828.48,6812,8815,2003,8082.504808,311.2264279
Cell 59 2013,3750,831,44612143.59,6193,9136,2943,7434.340554,399.0144396
Cell 6 2011/12,3750,830,44558458.7,2441,9386,6945,7394.081928,1096.606218
Cell 6 2013,3750,830,44558458.7,5628,8698,3070,7973.383133,412.7636509
Cell 6 NE 2011/12,3750,831,44612143.59,1697,8722,7025,6893.12515,1593.252735
Cell 6 NW 2011/12,3750,831,44612143.59,1056,9386,8330,6484.888087,2132.607128
Cell 6 SW 2011/12,3750,831,44612143.59,1204,8939,7735,6589.971119,2140.54141
Cell 60 2013,3750,825,44290034.25,5586,8364,2778,7282.758788,447.0560469
Cell 61 2013,3750,832,44665828.48,3613,8831,5218,7516.572115,673.2347106
Cell 7 2013,3750,822,44128979.58,5313,9125,3812,8191.116788,571.0578104
Cell 9 NW 2013,3750,828,44451088.92,-1842,9468,11310,5283.642512,2413.436806
Cell 9 SE 2013,3750,831,44612143.59,-1842,9827,11669,5032.345367,2349.344588
Cell 9 SW 2013,3750,827,44397404.03,-1875,9827,11702,5476.435308,2347.317782
Cell R1,3750,829,44504773.81,1268,8189,6921,5936.252111,2051.356238
Cell R10,3750,831,44612143.59,5794,8716,2922,7484.950662,427.2658449
Cell R100,3750,827,44397404.03,3827,8711,4884,7593.153567,598.2781435
Cell R101,3750,830,44558458.7,6325,8642,2317,7882.003614,385.9774651
Cell R104,3750,832,44665828.48,1639,8852,7213,7332.772837,1603.549623
Cell R105,3750,830,44558458.7,4367,8307,3940,7546.20241,451.1447741
Cell R106,3750,828,44451088.92,1640,9014,7374,7036.150966,1470.638855
Cell R107,3750,828,44451088.92,5938,8961,3023,8060.588164,529.6776964
Cell R11,3750,831,44612143.59,5041,8746,3705,7879.894103,599.3954823
Cell R111,3750,832,44665828.48,1549,9474,7925,6973.28125,1810.837905
Cell R112,3750,832,44665828.48,6499,8617,2118,7594.627404,339.0677769
Cell R113,3750,829,44504773.81,1694,8696,7002,6811.821472,1279.586222
Cell R114,3750,832,44665828.48,6812,8815,2003,8082.504808,311.2264279
Cell R117,3750,832,44665828.48,2182,9931,7749,7585.633413,827.2608192
Cell R118,3750,825,44290034.25,6193,8892,2699,7456.916364,376.7015043
Cell R119,3750,831,44612143.59,1694,8208,6514,6859.204573,942.5277936
Cell R120,3750,834,44773198.26,3613,8567,4954,7493.628297,682.8205581
Cell R121,3750,832,44665828.48,6706,8699,1993,8028.081731,302.9510632
Cell R123,3750,828,44451088.92,6193,9136,2943,7521.763285,402.6003605
Cell R124,3750,827,44397404.03,3799,8364,4565,7246.130593,522.5167515
Cell R125,3750,826,44343719.14,2277,8373,6096,6607.53753,1289.990239
Cell R126,3750,829,44504773.81,3613,8517,4904,7342.363088,733.8973279
Cell R15,3750,825,44290034.25,-1970,8948,10918,5292.287273,2203.384112
Cell R16,3750,828,44451088.92,-1842,9468,11310,5288.777778,2403.966932
Cell R17,3750,826,44343719.14,1969,9201,7232,7268.662228,1209.963818
Cell R18,3750,820,44021609.8,1607,8837,7230,6406.534146,1645.416473
Cell R19,3750,829,44504773.81,1373,9275,7902,7116.513872,1375.667324
Cell R20,3750,831,44612143.59,2251,8716,6465,7095.039711,986.7734349
Cell R21,3750,832,44665828.48,4307,8691,4384,7742.847356,506.9927002
Cell R22,3750,831,44612143.59,6858,8733,1875,8115.701564,305.1126718
Cell R24,3750,829,44504773.81,-1875,9827,11702,5858.451146,2298.886284
Cell R25,3750,832,44665828.48,791,9784,8993,3724.966346,2423.945018
Cell R26,3750,832,44665828.48,1056,9386,8330,6518.852163,2085.618206
Cell R27,3750,829,44504773.81,1756,9386,7630,7522.237636,1041.554429
Cell R28,3750,830,44558458.7,1418,9768,8350,6121.636145,2101.637778
Cell R29,3750,830,44558458.7,1847,9773,7926,7297.243373,1329.090681
Cell R30,3750,830,44558458.7,4541,8483,3942,7521.09759,575.9553144
Cell R31,3750,825,44290034.25,5511,8666,3155,7848.864242,465.9755265
Cell R35,3750,825,44290034.25,-1875,8738,10613,6597.289697,2148.417164
Cell R36,3750,831,44612143.59,513,9005,8492,7038.706378,1842.125023
Cell R37,3750,830,44558458.7,1675,9328,7653,6753.980723,1585.0939
Cell R38,3750,825,44290034.25,1296,8825,7529,6416.267879,1899.810438
Cell R39,3750,828,44451088.92,1920,9211,7291,6994.619565,1320.324851
Cell R40,3750,832,44665828.48,2443,8808,6365,6997.195913,1137.175905
Cell R46,3750,827,44397404.03,-111,9581,9692,5089.535671,2598.16194
Cell R47,3750,826,44343719.14,837,9915,9078,6273.858354,2253.628178
Cell R48,3750,824,44236349.36,623,9388,8765,5660.095874,2274.820807
Cell R49,3750,830,44558458.7,1068,9388,8320,5982.021687,2096.594829
Cell R5,3750,830,44558458.7,-1970,8349,10319,5684.63494,1930.532429
Cell R50,3750,821,44075294.69,1148,9569,8421,4900.630938,2336.00115
Cell R51,3750,826,44343719.14,2159,8808,6649,6909.020581,1140.109194
Cell R52,3750,828,44451088.92,2443,8651,6208,7408.807971,766.0607439
Cell R53,3750,831,44612143.59,3421,8616,5195,7472.565584,503.536736
Cell R54,3750,824,44236349.36,5965,8925,2960,8242.707524,373.8920242
Cell R58,3750,829,44504773.81,76,9901,9825,4684.328106,2589.930018
Cell R59,3750,830,44558458.7,258,9971,9713,6755.910843,2120.795602
Cell R6,3750,826,44343719.14,2583,8639,6056,7540.239709,883.982569
Cell R60,3750,830,44558458.7,-471,9366,9837,7237.008434,1143.832584
Cell R61,3750,835,44826883.15,879,9982,9103,4764.626347,2746.787881
Cell R62,3750,828,44451088.92,716,9348,8632,4421.849034,2409.757585
Cell R63,3750,832,44665828.48,716,8530,7814,6606.921875,1719.175998
Cell R64,3750,833,44719513.37,3349,8358,5009,7609.384154,504.0194587
Cell R65,3750,830,44558458.7,7100,8690,1590,7965.354217,309.419386
Cell R66,3750,825,44290034.25,7377,8932,1555,8394.687273,225.2358799
Cell R69,3750,831,44612143.59,-127,9814,9941,4343.977136,2842.073937
Cell R7,3750,828,44451088.92,-1502,8633,10135,6782.332126,1441.594812
Cell R70,3750,825,44290034.25,-1894,9795,11689,5431.647273,2448.730112
Cell R71,3750,826,44343719.14,850,8841,7991,6659.424939,1839.937299
Cell R72,3750,833,44719513.37,-10,9343,9353,5028.115246,2750.00347
Cell R73,3750,825,44290034.25,1203,9829,8626,6190.203636,2378.561615
Cell R74,3750,830,44558458.7,1342,9341,7999,6631.714458,1921.316415
Cell R75,3750,829,44504773.81,6008,8674,2666,7771.88661,306.430489
Cell R76,3750,826,44343719.14,6613,8790,2177,8099.711864,321.8722985
Cell R77,3750,825,44290034.25,6613,8941,2328,8169.532121,317.3916525
Cell R8,3750,830,44558458.7,-384,8813,9197,7356.168675,1125.51195
Cell R80,3750,833,44719513.37,-1894,9795,11689,4987.483794,2688.222332
Cell R81,3750,830,44558458.7,441,9507,9066,6852.095181,1938.152476
Cell R82,3750,824,44236349.36,-10,9754,9764,4216.936893,2735.267221
Cell R83,3750,828,44451088.92,422,8755,8333,5394.150966,2570.253973
Cell R84,3750,828,44451088.92,1302,8712,7410,4638.757246,2314.654426
Cell R85,3750,822,44128979.58,1376,8712,7336,6264.902676,1936.912433
Cell R86,3750,828,44451088.92,5976,8399,2423,7448.677536,418.0134913
Cell R87,3750,831,44612143.59,6380,8547,2167,7793.412756,323.1647645
Cell R9,3750,833,44719513.37,-384,8813,9197,7332.004802,979.9908432
Cell R90,3750,831,44612143.59,784,9694,8910,6364.196149,2142.426136
Cell R91,3750,830,44558458.7,1411,8860,7449,7402.110843,1067.053405
Cell R92,3750,828,44451088.92,1249,9683,8434,3756.192029,2250.393847
Cell R93,3750,835,44826883.15,1627,9040,7413,6958.31497,1347.603815
Cell R97,3750,825,44290034.25,1284,9318,8034,6651.391515,1960.40612
Cell R98,3750,830,44558458.7,4664,8487,3823,7732.439759,411.9858789
Cell R99,3750,832,44665828.48,2309,8435,6126,7567.040865,657.5172733
Cell S102,3750,827,44397404.03,6731,8935,2204,8034.530834,435.6239517
Cell S108,3750,834,44773198.26,6068,8870,2802,7993.884892,521.2581429
Cell S13,3750,831,44612143.59,6084,9045,2961,8137.724428,466.3859873
Cell S14,3750,821,44075294.69,5313,9125,3812,8190.745432,571.3062855
Cell S2,3750,830,44558458.7,5628,8698,3070,7972.437349,412.918082
Cell S23,3750,832,44665828.48,6351,8842,2491,8237.84976,397.2568442
Cell S32,3750,831,44612143.59,5779,8938,3159,7975.315283,473.0843255
Cell S33,3750,833,44719513.37,5452,8620,3168,7876.535414,434.8670413
Cell S34,3750,830,44558458.7,6649,8848,2199,8087.66747,343.8051287
Cell S41,3750,831,44612143.59,6027,8751,2724,7761.444043,309.8933382
Cell S42,3750,832,44665828.48,6899,8915,2016,8193.942308,341.3119013
Cell S44,3750,828,44451088.92,6968,8857,1889,8154.060386,304.6937779
Cell S56,3750,825,44290034.25,5634,8793,3159,7929.940606,506.38014
Cell S67,3750,832,44665828.48,5823,8955,3132,8190.885817,418.8045719
Cell S78,3750,832,44665828.48,6692,8960,2268,8349.346154,293.6028443
Cell S88,3750,832,44665828.48,6375,8915,2540,8112.627404,414.4714378
Cell S94,3750,830,44558458.7,7045,8935,1890,8111.49759,312.4220992
Cell S95,3750,822,44128979.58,6731,8796,2065,7940.424574,431.9986185
W287,3750,830,44558458.7,807,8994,8187,4019.903614,1822.625957
W295,3750,830,44558458.7,1997,8825,6828,7175.366265,1196.860417
W338,3750,830,44558458.7,1073,9843,8770,4878.138554,2557.975846
W342,3750,831,44612143.59,1473,8187,6714,5456.649819,2008.110823
W345,3750,829,44504773.81,3683,8069,4386,7427.790109,563.6509086
W387,3750,830,44558458.7,1191,8728,7537,5646.554217,2511.154281
W393,3750,828,44451088.92,1318,8897,7579,6703.214976,1659.234317
W440,3750,827,44397404.03,1429,8456,7027,5394.665054,2119.033436
W441,3750,830,44558458.7,3672,8537,4865,7206.477108,856.1936099
W445,3750,831,44612143.59,2376,8470,6094,6895.154031,769.2951032
W500,3750,829,44504773.81,1427,8823,7396,5948.576598,1988.527562
1,4000,944,50678536.16,2583,8664,6081,7512.245763,928.8553502
2,4000,948,50893275.72,1607,8837,7230,6451.020042,1490.439756
3,4000,940,50463796.6,2667,9275,6608,7512.210638,483.3377858
4,4000,941,50517481.49,2251,8716,6465,7088.444208,1010.41189
5,4000,940,50463796.6,-1875,8738,10613,6593.924468,2087.647231
6,4000,944,50678536.16,1854,9386,7532,7320.926907,1167.406486
7,4000,947,50839590.83,1617,9768,8151,6948.689546,1370.80239
8,4000,942,50571166.38,2057,8838,6781,6703.503185,1376.086821
9,4000,940,50463796.6,6614,8751,2137,7874.57234,321.209026
10,4000,945,50732221.05,628,9915,9287,6367.04127,2253.466973
11,4000,939,50410111.71,428,9388,8960,5566.357827,2308.625246
12,4000,939,50410111.71,1148,9569,8421,4736.188498,2358.624882
13,4000,941,50517481.49,2159,9202,7043,6865.300744,1210.128452
14,4000,942,50571166.38,4359,8723,4364,8012.261146,594.4009739
16,4000,941,50517481.49,-127,9814,9941,4583.103082,2833.389946
17,4000,939,50410111.71,-471,9366,9837,7182.654952,1222.875968
18,4000,949,50946960.61,854,9982,9128,4423.107482,2729.555867
19,4000,940,50463796.6,716,9348,8632,4593.112766,2446.781532
20,4000,942,50571166.38,6008,8674,2666,7776.946921,312.2417937
21,4000,947,50839590.83,6613,9040,2427,8185.687434,308.2886329
22,4000,948,50893275.72,-1894,9795,11689,4614.988397,2814.830907
23,4000,947,50839590.83,-10,9754,9764,4381.317846,2722.558083
24,4000,941,50517481.49,1239,8860,7621,7305.855473,1258.275734
25,4000,947,50839590.83,1627,9040,7413,6944.827878,1351.879881
26,4000,944,50678536.16,6380,8547,2167,7797.157839,332.911647
27,4000,942,50571166.38,4664,8487,3823,7723.067941,441.4022719
28,4000,943,50624851.27,4367,8307,3940,7541.791092,463.4334469
29,4000,941,50517481.49,3827,8711,4884,7582.839532,636.3705876
31,4000,946,50785905.94,5858,9474,3616,7668.104651,372.7278205
32,4000,947,50839590.83,1694,8797,7103,6828.383316,1293.889764
33,4000,941,50517481.49,6193,8892,2699,7460.693943,396.2975967
34,4000,950,51000645.5,4728,8364,3636,7255.863158,469.0707973
10A,4000,940,50463796.6,798,9915,9117,6182.089362,2311.793514
10NE,4000,941,50517481.49,312,8920,8608,6148.816153,2425.027658
10NW,4000,940,50463796.6,513,9005,8492,6865.157447,1988.846879
10SW,4000,942,50571166.38,193,9915,9722,5175.160297,2541.963362
11NE,4000,949,50946960.61,1361,9328,7967,6717.544784,1665.483069
11NW,4000,941,50517481.49,-195,9388,9583,5735.663124,2543.603834
11SE,4000,944,50678536.16,1059,9388,8329,5913.745763,2167.153377
17NW,4000,945,50732221.05,258,9971,9713,6584.991534,2235.850932
17SE,4000,942,50571166.38,850,8841,7991,6580.746285,1897.886806
17SW,4000,941,50517481.49,-1894,9795,11689,5316.031881,2539.311865
22S,4000,941,50517481.49,-1894,9795,11689,4492.273114,2811.688364
23S,4000,939,50410111.71,1090,9322,8232,3538.691161,1876.875994
24S,4000,941,50517481.49,1239,8860,7621,7286.272051,1281.277977
27A,4000,942,50571166.38,1284,9077,7793,6626.786624,2011.493968
2A,4000,939,50410111.71,1571,8837,7266,6351.218317,1737.342029
5NE,4000,941,50517481.49,-1842,9827,11669,4880.381509,2393.611552
5NW,4000,948,50893275.72,-1875,9827,11702,5479.50211,2392.139743
5SE,4000,943,50624851.27,791,9784,8993,3812.591729,2466.660709
6NE,4000,947,50839590.83,1697,8980,7283,6927.200634,1564.76335
6NW,4000,945,50732221.05,1040,9386,8346,6377.112169,2204.080598
6SW,4000,941,50517481.49,1204,9386,8182,6565.442083,2164.702102
Cell 1 2011/12,4000,944,50678536.16,2583,8664,6081,7512.245763,928.8553502
Cell 1 SW 2013,4000,942,50571166.38,-1970,8948,10918,5249.813163,2207.534636
Cell 10 2011/12,4000,945,50732221.05,628,9915,9287,6367.04127,2253.466973
Cell 10 NE 2011/12,4000,941,50517481.49,312,8920,8608,6148.816153,2425.027658
Cell 10 NW 2011/12,4000,940,50463796.6,513,9005,8492,6865.157447,1988.846879
Cell 10 SE 2013,4000,945,50732221.05,1040,9386,8346,6377.112169,2204.080598
Cell 10 SW 2011/12,4000,942,50571166.38,193,9915,9722,5175.160297,2541.963362
Cell 10-A 2011/12,4000,940,50463796.6,798,9915,9117,6182.089362,2311.793514
Cell 11 NE 2011/12,4000,949,50946960.61,1361,9328,7967,6717.544784,1665.483069
Cell 11 NW 2013,4000,940,50463796.6,1571,8837,7266,6376.303191,1662.883126
Cell 11 SW 2013,4000,941,50517481.49,1757,9386,7629,7319.154091,1382.763248
Cell 12 2013,4000,945,50732221.05,1617,9768,8151,6961.993651,1362.915824
Cell 13 2013,4000,940,50463796.6,1533,8838,7305,6615.061702,1432.522279
Cell 14 2013,4000,941,50517481.49,6858,8733,1875,8098.065887,317.2085773
Cell 15 2013,4000,945,50732221.05,5348,8768,3420,7885.349206,466.6932858
Cell 15-A 2013,4000,941,50517481.49,5452,8667,3215,7885.837407,438.9269232
Cell 16 2013,4000,943,50624851.27,5536,8789,3253,7969.503712,392.26065
Cell 17 NW 2011/12,4000,945,50732221.05,258,9971,9713,6584.991534,2235.850932
Cell 17 NW 2013,4000,947,50839590.83,-1875,9827,11702,5882.317846,2271.822871
Cell 17 SE 2013,4000,940,50463796.6,513,9005,8492,6865.157447,1988.846879
Cell 17 SW 2013,4000,938,50356426.82,-1875,8738,10613,6591.409382,2098.576321
Cell 18 2011/12,4000,949,50946960.61,854,9982,9128,4423.107482,2729.555867
Cell 18 NE 2013,4000,940,50463796.6,1204,9386,8182,6527.421277,2197.216787
Cell 18 NW 2013,4000,948,50893275.72,791,9784,8993,3743.312236,2426.24723
Cell 18 SE 2013,4000,949,50946960.61,1361,9328,7967,6717.544784,1665.483069
Cell 18 SSE 2013,4000,947,50839590.83,-195,9388,9583,5709.775079,2489.7991
Cell 19 NW 2013,4000,943,50624851.27,1756,9386,7630,7400.077413,1236.882156
Cell 2 2011/12,4000,948,50893275.72,1607,8837,7230,6451.020042,1490.439756
Cell 2 NE 2013,4000,941,50517481.49,-2000,8957,10957,6235.53135,1894.386782
Cell 2 SW 2013,4000,944,50678536.16,2583,8664,6081,7514.592161,926.8273944
Cell 20 2013,4000,940,50463796.6,1828,9773,7945,7180.718085,1471.726894
Cell 21 2013,4000,941,50517481.49,2443,8808,6365,7054.935175,1096.905276
Cell 22 2013,4000,942,50571166.38,6899,8543,1644,7841.972399,272.2813295
Cell 23 2013,4000,946,50785905.94,6899,8915,2016,8177.838266,350.3099266
Cell 24 2013,4000,949,50946960.61,6616,8848,2232,8082.167545,354.5853459
Cell 25 NE 2013,4000,945,50732221.05,628,9915,9287,6367.04127,2253.466973
Cell 25 SE 2013,4000,942,50571166.38,193,9915,9722,5175.160297,2541.963362
Cell 26 NE 2013,4000,940,50463796.6,428,9388,8960,5568.745745,2308.556886
Cell 26 NNW 2013,4000,941,50517481.49,312,8920,8608,6148.816153,2425.027658
Cell 26 NW 2013,4000,940,50463796.6,798,9915,9117,6182.089362,2311.793514
Cell 27 NW 2013,4000,944,50678536.16,1059,9388,8329,5913.745763,2167.153377
Cell 28 2013,4000,939,50410111.71,1148,9569,8421,4736.188498,2358.624882
Cell 29 2013,4000,942,50571166.38,2159,9202,7043,6869.957537,1205.93972
Cell 3 NE 2013,4000,940,50463796.6,-384,8813,9197,7282.562766,1135.439976
Cell 3 NW 2013,4000,942,50571166.38,-1502,8662,10164,6765.082803,1455.993463
Cell 30 2013,4000,950,51000645.5,7093,8690,1597,7968.285263,313.8702006
Cell 31 2013,4000,941,50517481.49,5718,8925,3207,8235.180659,388.5166883
Cell 32 2013,4000,943,50624851.27,5823,8955,3132,8192.00106,417.3982982
Cell 33 NE 2013,4000,946,50785905.94,258,9971,9713,6580.991543,2238.049359
Cell 33 SE 2013,4000,941,50517481.49,-1894,9795,11689,5308.256111,2549.905176
Cell 33 SW 2013,4000,941,50517481.49,-232,9814,10046,4450.232731,2871.539272
Cell 34 N 2013,4000,941,50517481.49,1364,8825,7461,6770.306057,1542.666527
Cell 34 NW 2013,4000,940,50463796.6,-471,9366,9837,7183.018085,1222.275982
Cell 34 SE 2013,4000,943,50624851.27,850,8841,7991,6583.40403,1897.747427
Cell 35 2013,4000,947,50839590.83,879,9982,9103,4761.511088,2720.223532
Cell 37 2013,4000,948,50893275.72,6008,8674,2666,7775.875527,310.7230633
Cell 38 2013,4000,941,50517481.49,6613,9040,2427,8187.299681,310.4172905
Cell 39 2013,4000,941,50517481.49,6692,8960,2268,8357.396387,289.669769
Cell 4 2013,4000,942,50571166.38,5068,8716,3648,7481.953291,442.7052116
Cell 40 NE 2013,4000,947,50839590.83,-1894,9795,11689,4988.073918,2648.792257
Cell 41 N 2013,4000,940,50463796.6,-1894,9615,11509,6758.895745,2115.414479
Cell 41 NW 2013,4000,945,50732221.05,-1894,9615,11509,5676.786243,2728.266497
Cell 42 NW 2013,4000,940,50463796.6,-10,9754,9764,4341.839362,2729.189668
Cell 43 2013,4000,941,50517481.49,1376,8712,7336,6242.478215,1977.165538
Cell 44 2013,4000,941,50517481.49,5923,8413,2490,7541.005313,450.5560916
Cell 45 2013,4000,943,50624851.27,6380,8547,2167,7797.782609,331.9271797
Cell 47 2013,4000,941,50517481.49,784,9694,8910,6277.137088,2156.04023
Cell 48 2013,4000,941,50517481.49,1239,8860,7621,7286.550478,1281.305268
Cell 49 2013,4000,947,50839590.83,1627,9040,7413,6944.827878,1351.879881
Cell 5 2011/12 Summer,4000,938,50356426.82,-1875,8738,10613,6591.409382,2098.576321
Cell 5 2013,4000,940,50463796.6,5041,8830,3789,7892.344681,602.9967894
Cell 50 2013,4000,941,50517481.49,3827,8711,4884,7582.839532,636.3705876
Cell 51 2013,4000,940,50463796.6,6731,8796,2065,7946.956383,427.53328
Cell 52 2013,4000,941,50517481.49,1402,8435,7033,7506.803401,879.4037473
Cell 53 2013,4000,943,50624851.27,4367,8307,3940,7541.791092,463.4334469
Cell 54 2013,4000,947,50839590.83,5832,8961,3129,8036.892291,546.8956463
Cell 55 2013,4000,942,50571166.38,6068,8870,2802,7983.412951,523.7314513
Cell 56 2013,4000,940,50463796.6,6193,8892,2699,7462.67766,397.3621604
Cell 57 2013,4000,948,50893275.72,1694,8797,7103,6825.129747,1298.610094
Cell 58 2013,4000,943,50624851.27,6774,8815,2041,8071.194062,324.7983982
Cell 59 2013,4000,949,50946960.61,6193,9136,2943,7437.14647,402.7151247
Cell 6 2011/12,4000,944,50678536.16,1854,9386,7532,7320.926907,1167.406486
Cell 6 2013,4000,945,50732221.05,5628,8794,3166,8001.58836,408.278576
Cell 6 NE 2011/12,4000,947,50839590.83,1697,8980,7283,6927.200634,1564.76335
Cell 6 NW 2011/12,4000,945,50732221.05,1040,9386,8346,6377.112169,2204.080598
Cell 6 SW 2011/12,4000,941,50517481.49,1204,9386,8182,6565.442083,2164.702102
Cell 60 2013,4000,942,50571166.38,3799,8364,4565,7264.136943,505.5680555
Cell 61 2013,4000,946,50785905.94,3613,8831,5218,7507.714588,701.1643721
Cell 7 2013,4000,940,50463796.6,5313,9125,3812,8147.442553,596.2264027
Cell 9 NW 2013,4000,944,50678536.16,-1842,9827,11669,5209.09322,2408.498389
Cell 9 SE 2013,4000,940,50463796.6,-1842,9827,11669,4878.792553,2394.38834
Cell 9 SW 2013,4000,949,50946960.61,-1875,9827,11702,5472.640674,2390.420841
Cell R1,4000,949,50946960.61,1268,8189,6921,5875.871444,2088.359517
Cell R10,4000,942,50571166.38,5068,8716,3648,7481.953291,442.7052116
Cell R100,4000,941,50517481.49,3827,8711,4884,7582.839532,636.3705876
Cell R101,4000,944,50678536.16,6325,8642,2317,7878.70339,388.5425354
Cell R104,4000,942,50571166.38,1639,9069,7430,7218.16242,1742.644771
Cell R105,4000,943,50624851.27,4367,8307,3940,7541.791092,463.4334469
Cell R106,4000,948,50893275.72,1640,9014,7374,7085.878692,1452.360552
Cell R107,4000,948,50893275.72,5832,8961,3129,8034.918776,549.9706233
Cell R11,4000,940,50463796.6,5041,8830,3789,7890.294681,605.164679
Cell R111,4000,943,50624851.27,1549,9474,7925,6961.389183,1810.158628
Cell R112,4000,942,50571166.38,6499,8617,2118,7603.578556,339.8797959
Cell R113,4000,948,50893275.72,1694,8797,7103,6825.129747,1298.610094
Cell R114,4000,943,50624851.27,6774,8815,2041,8071.194062,324.7983982
Cell R117,4000,949,50946960.61,2018,9931,7913,7499.231823,1003.08518
Cell R118,4000,940,50463796.6,6193,8892,2699,7462.67766,397.3621604
Cell R119,4000,942,50571166.38,1694,8208,6514,6809.519108,1082.174063
Cell R120,4000,949,50946960.61,3613,8567,4954,7473.157007,684.5313732
Cell R121,4000,942,50571166.38,6699,8699,2000,8019.750531,318.9136889
Cell R123,4000,942,50571166.38,4115,9136,5021,7507.558386,418.8194792
Cell R124,4000,941,50517481.49,2390,8364,5974,7222.140276,595.3716219
Cell R125,4000,942,50571166.38,2277,8373,6096,6625.40552,1263.497872
Cell R126,4000,940,50463796.6,3613,8660,5047,7363.964894,716.560603
Cell R15,4000,942,50571166.38,-1970,8948,10918,5249.813163,2207.534636
Cell R16,4000,947,50839590.83,-1842,9827,11669,5199.511088,2410.613627
Cell R17,4000,941,50517481.49,1025,9201,8176,7267.287991,1247.833805
Cell R18,4000,937,50302741.93,1571,8837,7266,6360.478122,1670.926732
Cell R19,4000,947,50839590.83,1373,9275,7902,7018.269271,1504.759165
Cell R20,4000,940,50463796.6,2251,8716,6465,7101.730851,1028.161113
Cell R21,4000,940,50463796.6,4153,8691,4538,7725.253191,566.2252594
Cell R22,4000,940,50463796.6,6858,8733,1875,8098.420213,317.1910878
Cell R24,4000,947,50839590.83,-1875,9827,11702,5882.317846,2271.822871
Cell R25,4000,948,50893275.72,791,9784,8993,3748.731013,2430.82468
Cell R26,4000,941,50517481.49,1040,9386,8346,6412.058448,2167.585892
Cell R27,4000,945,50732221.05,1756,9386,7630,7396.66455,1244.159846
Cell R28,4000,942,50571166.38,1326,9773,8447,6114.286624,2144.332941
Cell R29,4000,940,50463796.6,1828,9773,7945,7180.718085,1471.726894
Cell R30,4000,941,50517481.49,4003,8483,4480,7485.824655,636.7413621
Cell R31,4000,942,50571166.38,5511,8733,3222,7869.245223,467.7794206
Cell R35,4000,938,50356426.82,-1875,8738,10613,6591.409382,2098.576321
Cell R36,4000,939,50410111.71,513,9005,8492,6863.584665,1989.32128
Cell R37,4000,949,50946960.61,1361,9328,7967,6717.544784,1665.483069
Cell R38,4000,941,50517481.49,1296,8825,7529,6247.344315,2015.418767
Cell R39,4000,948,50893275.72,1920,9211,7291,6968.483122,1321.249682
Cell R40,4000,941,50517481.49,2443,8808,6365,7054.935175,1096.905276
Cell R46,4000,943,50624851.27,-592,9915,10507,5222.607635,2629.348112
Cell R47,4000,940,50463796.6,798,9915,9117,6182.089362,2311.793514
Cell R48,4000,940,50463796.6,428,9388,8960,5568.745745,2308.556886
Cell R49,4000,945,50732221.05,1059,9388,8329,5911.759788,2166.865728
Cell R5,4000,945,50732221.05,-1970,8429,10399,5655.948148,1980.659157
Cell R50,4000,939,50410111.71,1148,9569,8421,4736.188498,2358.624882
Cell R51,4000,940,50463796.6,2159,9202,7043,6871.532979,1201.366309
Cell R52,4000,941,50517481.49,2443,8651,6208,7384.731137,787.8762054
Cell R53,4000,940,50463796.6,3421,8616,5195,7488.911702,490.7951491
Cell R54,4000,940,50463796.6,5718,8925,3207,8235.593617,388.5168262
Cell R58,4000,941,50517481.49,76,9901,9825,4660.511158,2608.045319
Cell R59,4000,945,50732221.05,258,9971,9713,6584.991534,2235.850932
Cell R6,4000,946,50785905.94,1220,8664,7444,7507.710359,948.1974011
Cell R60,4000,939,50410111.71,-471,9366,9837,7182.591054,1222.856563
Cell R61,4000,947,50839590.83,879,9982,9103,4761.511088,2720.223532
Cell R62,4000,941,50517481.49,716,9348,8632,4472.916047,2440.141542
Cell R63,4000,941,50517481.49,716,8811,8095,6590.489904,1707.771691
Cell R64,4000,942,50571166.38,3349,8358,5009,7603.386412,490.3620996
Cell R65,4000,950,51000645.5,7093,8690,1597,7968.285263,313.8702006
Cell R66,4000,943,50624851.27,7377,8955,1578,8395.423118,226.6506559
Cell R69,4000,941,50517481.49,-232,9814,10046,4450.232731,2871.539272
Cell R7,4000,942,50571166.38,-1502,8662,10164,6765.082803,1455.993463
Cell R70,4000,941,50517481.49,-1894,9795,11689,5308.256111,2549.905176
Cell R71,4000,942,50571166.38,850,8841,7991,6581.947983,1898.227926
Cell R72,4000,940,50463796.6,-10,9343,9353,5054.289362,2738.73296
Cell R73,4000,941,50517481.49,1156,9829,8673,6001.085016,2467.38893
Cell R74,4000,943,50624851.27,1342,9341,7999,6634.616119,1916.184015
Cell R75,4000,948,50893275.72,6008,8674,2666,7775.875527,310.7230633
Cell R76,4000,942,50571166.38,6613,8790,2177,8095.298301,321.4793584
Cell R77,4000,941,50517481.49,6613,9040,2427,8187.299681,310.4172905
Cell R8,4000,940,50463796.6,-384,8813,9197,7329.61383,1118.169959
Cell R80,4000,947,50839590.83,-1894,9795,11689,4988.073918,2648.792257
Cell R81,4000,946,50785905.94,441,9507,9066,6709.238901,2026.097559
Cell R82,4000,940,50463796.6,-10,9754,9764,4341.839362,2729.189668
Cell R83,4000,943,50624851.27,422,8954,8532,5373.313892,2570.817471
Cell R84,4000,946,50785905.94,1266,8712,7446,4659.374207,2338.763596
Cell R85,4000,941,50517481.49,1376,8712,7336,6242.478215,1977.165538
Cell R86,4000,943,50624851.27,5976,8431,2455,7456.395546,424.1380098
Cell R87,4000,943,50624851.27,6380,8547,2167,7797.782609,331.9271797
Cell R9,4000,947,50839590.83,-384,8813,9197,7321.134108,998.1431229
Cell R90,4000,941,50517481.49,784,9694,8910,6277.137088,2156.04023
Cell R91,4000,942,50571166.38,1239,8860,7621,7286.544586,1280.625002
Cell R92,4000,941,50517481.49,1249,9683,8434,3831.478215,2244.989282
Cell R93,4000,947,50839590.83,1627,9040,7413,6944.827878,1351.879881
Cell R97,4000,941,50517481.49,1284,9318,8034,6704.404888,1919.221987
Cell R98,4000,942,50571166.38,4664,8487,3823,7723.067941,441.4022719
Cell R99,4000,941,50517481.49,1402,8435,7033,7506.803401,879.4037473
Cell S102,4000,945,50732221.05,6731,8935,2204,8036.266667,428.2864477
Cell S108,4000,941,50517481.49,6068,8870,2802,7983.108395,523.9262842
Cell S13,4000,940,50463796.6,6084,9045,2961,8140.523404,459.1123796
Cell S14,4000,942,50571166.38,5313,9125,3812,8146.54034,595.9344194
Cell S2,4000,945,50732221.05,5628,8794,3166,8001.58836,408.278576
Cell S23,4000,941,50517481.49,6351,8842,2491,8209.296493,421.6559888
Cell S32,4000,940,50463796.6,5779,8938,3159,7953.006383,481.4311068
Cell S33,4000,941,50517481.49,5452,8667,3215,7885.837407,438.9269232
Cell S34,4000,948,50893275.72,6616,8848,2232,8082.985232,353.8769301
Cell S41,4000,940,50463796.6,6027,8751,2724,7751.36383,330.2964232
Cell S42,4000,946,50785905.94,6899,8915,2016,8177.838266,350.3099266
Cell S44,4000,942,50571166.38,6968,8939,1971,8162.313163,310.9209398
Cell S56,4000,943,50624851.27,5634,8793,3159,7951.972428,496.6751567
Cell S67,4000,943,50624851.27,5823,8955,3132,8192.003181,417.3994415
Cell S78,4000,941,50517481.49,6692,8960,2268,8357.396387,289.669769
Cell S88,4000,944,50678536.16,6375,8915,2540,8117.580508,413.9053947
Cell S94,4000,942,50571166.38,7045,8935,1890,8104.066879,310.0754459
Cell S95,4000,940,50463796.6,6731,8796,2065,7946.956383,427.53328
W287,4000,940,50463796.6,807,8994,8187,4000.158511,1848.925836
W295,4000,942,50571166.38,1964,8825,6861,7163.916136,1243.540344
W338,4000,945,50732221.05,1046,9843,8797,4734.665608,2579.881766
W342,4000,943,50624851.27,1427,8187,6760,5448.296925,2034.915389
W345,4000,942,50571166.38,3683,8069,4386,7444.877919,548.3885261
W387,4000,943,50624851.27,1191,8728,7537,5657.803818,2510.232449
W393,4000,946,50785905.94,1318,8897,7579,6592.605708,1780.349181
W440,4000,940,50463796.6,1429,8601,7172,5376.642553,2155.150926
W441,4000,940,50463796.6,3672,8537,4865,7149.205319,891.0253736
W445,4000,946,50785905.94,2376,8470,6094,6852.10148,827.3186856
W500,4000,938,50356426.82,1427,8823,7396,5995.053305,1941.974082
1,4250,1066,57228092.74,1220,8664,7444,7464.586304,1013.766422
2,4250,1066,57228092.74,1607,8837,7230,6396.11257,1547.038174
3,4250,1065,57174407.85,2183,9275,7092,7451.931455,669.315972
4,4250,1066,57228092.74,2251,8716,6465,7077.716698,1050.803968
5,4250,1061,56959668.29,-1875,8795,10670,6573.804901,2058.636287
6,4250,1067,57281777.63,1706,9386,7680,7203.616682,1327.295842
7,4250,1069,57389147.41,1617,9768,8151,6905.065482,1457.57376
8,4250,1063,57067038.07,1533,8838,7305,6743.168391,1389.004093
9,4250,1063,57067038.07,6614,8751,2137,7864.697084,327.7261385
10,4250,1067,57281777.63,599,9915,9316,6293.001874,2290.741444
11,4250,1055,56637558.95,428,9388,8960,5496.846445,2340.195958
12,4250,1058,56798613.62,1148,9569,8421,4578.862004,2369.309221
13,4250,1063,57067038.07,2159,9211,7052,6837.83349,1261.419442
14,4250,1066,57228092.74,4359,8852,4493,7979.074109,647.4351889
16,4250,1057,56744928.73,-232,9859,10091,4638.198675,2854.366912
17,4250,1066,57228092.74,-471,9366,9837,7107.991557,1318.075514
18,4250,1067,57281777.63,854,9982,9128,4461.101218,2729.113526
19,4250,1064,57120722.96,716,9358,8642,4608.244361,2458.61957
20,4250,1065,57174407.85,6008,8674,2666,7772.722066,312.4893384
21,4250,1065,57174407.85,6613,9040,2427,8199.567136,303.2236248
22,4250,1066,57228092.74,-1894,9795,11689,4621.695122,2809.195089
23,4250,1068,57335462.52,-10,9754,9764,4486.96161,2717.638453
24,4250,1063,57067038.07,1032,8860,7828,7184.761994,1468.528355
25,4250,1069,57389147.41,1627,9040,7413,6945.563143,1350.908662
26,4250,1067,57281777.63,6259,8547,2288,7793.420806,346.7018361
27,4250,1063,57067038.07,2951,8487,5536,7683.714017,559.9327999
28,4250,1064,57120722.96,4215,8307,4092,7521.515038,516.0483615
29,4250,1063,57067038.07,2124,8711,6587,7535.924741,746.2371432
31,4250,1067,57281777.63,2298,9474,7176,7649.890347,438.1864262
32,4250,1067,57281777.63,1694,8797,7103,6848.820993,1282.00651
33,4250,1064,57120722.96,6193,8892,2699,7455.257519,406.9837606
34,4250,1069,57389147.41,4310,8364,4054,7226.460243,500.0704025
10A,4250,1060,56905983.4,439,9915,9476,6084.40283,2349.236939
10NE,4250,1063,57067038.07,312,9255,8943,5996.593603,2504.093106
10NW,4250,1066,57228092.74,513,9522,9009,6679.081614,2144.942423
10SW,4250,1056,56691243.84,-592,9915,10507,5225.518939,2559.173067
11NE,4250,1064,57120722.96,862,9328,8466,6680.325188,1722.456705
11NW,4250,1064,57120722.96,-195,9388,9583,5661.086466,2550.070309
11SE,4250,1068,57335462.52,1059,9388,8329,5847.791199,2214.686346
17NW,4250,1067,57281777.63,258,9971,9713,6477.904405,2254.87868
17SE,4250,1067,57281777.63,-129,8841,8970,6524.589503,1927.391894
17SW,4250,1055,56637558.95,-1894,9795,11689,5199.332701,2628.140024
22S,4250,1066,57228092.74,-1894,9795,11689,4540.664165,2797.705134
23S,4250,1058,56798613.62,1090,9366,8276,3602.417769,1928.320991
24S,4250,1068,57335462.52,1032,8860,7828,7164.076779,1493.375893
27A,4250,1064,57120722.96,1284,9077,7793,6680.49906,1976.469324
2A,4250,1067,57281777.63,1571,8837,7266,6338.187441,1721.079533
5NE,4250,1068,57335462.52,-1842,9827,11669,4737.059925,2430.692391
5NW,4250,1066,57228092.74,-1875,9827,11702,5460.265478,2451.361071
5SE,4250,1062,57013353.18,791,9784,8993,3805.881356,2463.410468
6NE,4250,1066,57228092.74,1697,9110,7413,6959.841463,1541.023912
6NW,4250,1068,57335462.52,1040,9386,8346,6276.159176,2260.263334
6SW,4250,1063,57067038.07,1204,9386,8182,6547.534337,2166.302031
Cell 1 2011/12,4250,1066,57228092.74,1220,8664,7444,7464.586304,1013.766422
Cell 1 SW 2013,4250,1061,56959668.29,-1970,9374,11344,5204.566447,2230.691423
Cell 10 2011/12,4250,1067,57281777.63,599,9915,9316,6293.001874,2290.741444
Cell 10 NE 2011/12,4250,1063,57067038.07,312,9255,8943,5996.593603,2504.093106
Cell 10 NW 2011/12,4250,1066,57228092.74,513,9522,9009,6679.081614,2144.942423
Cell 10 SE 2013,4250,1068,57335462.52,1040,9386,8346,6276.159176,2260.263334
Cell 10 SW 2011/12,4250,1056,56691243.84,-592,9915,10507,5225.518939,2559.173067
Cell 10-A 2011/12,4250,1060,56905983.4,439,9915,9476,6084.40283,2349.236939
Cell 11 NE 2011/12,4250,1064,57120722.96,862,9328,8466,6680.325188,1722.456705
Cell 11 NW 2013,4250,1065,57174407.85,1571,8837,7266,6349.157746,1678.56482
Cell 11 SW 2013,4250,1065,57174407.85,1692,9386,7694,7175.193427,1542.105156
Cell 12 2013,4250,1067,57281777.63,1617,9768,8151,6906.69447,1456.788887
Cell 13 2013,4250,1063,57067038.07,1533,8838,7305,6658.110066,1452.136547
Cell 14 2013,4250,1064,57120722.96,6766,8733,1967,8081.161654,328.3574269
Cell 15 2013,4250,1067,57281777.63,5348,8768,3420,7903.713215,467.9643149
Cell 15-A 2013,4250,1063,57067038.07,5452,8700,3248,7897.645343,438.4750077
Cell 16 2013,4250,1067,57281777.63,5452,8789,3337,7980.458294,403.8952221
Cell 17 NW 2011/12,4250,1067,57281777.63,258,9971,9713,6477.904405,2254.87868
Cell 17 NW 2013,4250,1065,57174407.85,-1875,9827,11702,5867.961502,2282.473109
Cell 17 SE 2013,4250,1065,57174407.85,513,9522,9009,6683.558685,2140.964944
Cell 17 SW 2013,4250,1061,56959668.29,-1875,8795,10670,6575.079171,2063.502481
Cell 18 2011/12,4250,1067,57281777.63,854,9982,9128,4461.101218,2729.113526
Cell 18 NE 2013,4250,1063,57067038.07,1204,9386,8182,6520.269991,2195.646464
Cell 18 NW 2013,4250,1068,57335462.52,791,9784,8993,3742.779963,2422.044097
Cell 18 SE 2013,4250,1065,57174407.85,862,9328,8466,6680.211268,1721.65186
Cell 18 SSE 2013,4250,1068,57335462.52,-195,9388,9583,5629.84176,2495.242487
Cell 19 NW 2013,4250,1067,57281777.63,1530,9386,7856,7269.332709,1423.226734
Cell 2 2011/12,4250,1066,57228092.74,1607,8837,7230,6396.11257,1547.038174
Cell 2 NE 2013,4250,1067,57281777.63,-2000,8957,10957,6281.179944,1848.184786
Cell 2 SW 2013,4250,1067,57281777.63,1220,8664,7444,7466.715089,1014.18265
Cell 20 2013,4250,1065,57174407.85,1489,9773,8284,7079.714554,1568.892006
Cell 21 2013,4250,1066,57228092.74,2443,8808,6365,7096.545966,1061.343918
Cell 22 2013,4250,1065,57174407.85,6899,8692,1793,7850.334272,281.914143
Cell 23 2013,4250,1070,57442832.3,6899,8915,2016,8166.519626,359.6382958
Cell 24 2013,4250,1069,57389147.41,6616,8848,2232,8070.395697,365.5610955
Cell 25 NE 2013,4250,1067,57281777.63,599,9915,9316,6293.001874,2290.741444
Cell 25 SE 2013,4250,1056,56691243.84,-592,9915,10507,5225.518939,2559.173067
Cell 26 NE 2013,4250,1055,56637558.95,428,9388,8960,5496.846445,2340.195958
Cell 26 NNW 2013,4250,1062,57013353.18,312,9255,8943,6000.429379,2502.148395
Cell 26 NW 2013,4250,1061,56959668.29,439,9915,9476,6080.299717,2351.926497
Cell 27 NW 2013,4250,1068,57335462.52,1059,9388,8329,5847.791199,2214.686346
Cell 28 2013,4250,1058,56798613.62,1148,9569,8421,4578.862004,2369.309221
Cell 29 2013,4250,1063,57067038.07,2159,9211,7052,6837.123236,1261.367064
Cell 3 NE 2013,4250,1067,57281777.63,-384,8813,9197,7279.089035,1133.066302
Cell 3 NW 2013,4250,1067,57281777.63,-1502,8761,10263,6709.148079,1491.834589
Cell 30 2013,4250,1069,57389147.41,6936,8690,1754,7970.426567,319.5698546
Cell 31 2013,4250,1062,57013353.18,5718,8925,3207,8231.453861,398.7906049
Cell 32 2013,4250,1066,57228092.74,5823,8955,3132,8201.272983,416.4960641
Cell 33 NE 2013,4250,1067,57281777.63,258,9971,9713,6477.904405,2254.87868
Cell 33 SE 2013,4250,1058,56798613.62,-1894,9795,11689,5201.859168,2626.837195
Cell 33 SW 2013,4250,1064,57120722.96,-308,9859,10167,4533.859962,2895.258251
Cell 34 N 2013,4250,1066,57228092.74,1364,8825,7461,6713.885553,1648.239755
Cell 34 NW 2013,4250,1067,57281777.63,-471,9366,9837,7107.968135,1317.457936
Cell 34 SE 2013,4250,1065,57174407.85,-129,8841,8970,6532.219718,1919.728735
Cell 35 2013,4250,1068,57335462.52,854,9982,9128,4712.643258,2706.054322
Cell 37 2013,4250,1066,57228092.74,6008,8674,2666,7768.525328,318.4947828
Cell 38 2013,4250,1061,56959668.29,6613,9040,2427,8203.6164,304.8636581
Cell 39 2013,4250,1066,57228092.74,6692,8960,2268,8361.554409,290.2035084
Cell 4 2013,4250,1067,57281777.63,4531,8716,4185,7472.528585,481.7854912
Cell 40 NE 2013,4250,1068,57335462.52,-1894,9795,11689,4943.491573,2646.290768
Cell 41 N 2013,4250,1058,56798613.62,-1894,9615,11509,6680.828922,2165.535085
Cell 41 NW 2013,4250,1066,57228092.74,-1894,9615,11509,5635.109756,2727.892782
Cell 42 NW 2013,4250,1061,56959668.29,-10,9754,9764,4467.028275,2730.552585
Cell 43 2013,4250,1055,56637558.95,1376,8712,7336,6236.948815,1979.137417
Cell 44 2013,4250,1058,56798613.62,5636,8413,2777,7534.198488,460.4268714
Cell 45 2013,4250,1068,57335462.52,6259,8547,2288,7793.690075,346.6510896
Cell 47 2013,4250,1065,57174407.85,784,9694,8910,6248.45446,2158.65572
Cell 48 2013,4250,1067,57281777.63,1032,8860,7828,7163.445173,1493.932943
Cell 49 2013,4250,1069,57389147.41,1627,9040,7413,6945.563143,1350.908662
Cell 5 2011/12 Summer,4250,1061,56959668.29,-1875,8795,10670,6575.079171,2063.502481
Cell 5 2013,4250,1069,57389147.41,4987,8830,3843,7899.59869,606.4897998
Cell 50 2013,4250,1063,57067038.07,2124,8711,6587,7535.924741,746.2371432
Cell 51 2013,4250,1058,56798613.62,6188,8796,2608,7951.155955,426.3914787
Cell 52 2013,4250,1064,57120722.96,1402,8442,7040,7463.868421,1010.558778
Cell 53 2013,4250,1064,57120722.96,4215,8307,4092,7521.515038,516.0483615
Cell 54 2013,4250,1068,57335462.52,5832,8961,3129,8008.103933,568.8666071
Cell 55 2013,4250,1064,57120722.96,6068,8870,2802,7974.887218,526.1769215
Cell 56 2013,4250,1060,56905983.4,6193,8892,2699,7455.282075,407.2637024
Cell 57 2013,4250,1066,57228092.74,1694,8797,7103,6847.962477,1282.301073
Cell 58 2013,4250,1066,57228092.74,6424,8815,2391,8060.422139,346.5259724
Cell 59 2013,4250,1068,57335462.52,6044,9136,3092,7439.218165,400.5476333
Cell 6 2011/12,4250,1067,57281777.63,1706,9386,7680,7203.616682,1327.295842
Cell 6 2013,4250,1067,57281777.63,5628,8794,3166,8032.331771,406.1775626
Cell 6 NE 2011/12,4250,1066,57228092.74,1697,9110,7413,6959.841463,1541.023912
Cell 6 NW 2011/12,4250,1068,57335462.52,1040,9386,8346,6276.159176,2260.263334
Cell 6 SW 2011/12,4250,1063,57067038.07,1204,9386,8182,6547.534337,2166.302031
Cell 60 2013,4250,1062,57013353.18,3799,8364,4565,7231.862524,565.8991478
Cell 61 2013,4250,1067,57281777.63,3613,8831,5218,7513.608247,703.3737898
Cell 7 2013,4250,1056,56691243.84,5313,9125,3812,8121.036932,601.6859737
Cell 9 NW 2013,4250,1067,57281777.63,-1842,9827,11669,5106.778819,2425.848507
Cell 9 SE 2013,4250,1067,57281777.63,-1842,9827,11669,4734.017807,2429.798136
Cell 9 SW 2013,4250,1066,57228092.74,-1875,9827,11702,5465.339587,2441.935069
Cell R1,4250,1066,57228092.74,1192,8189,6997,5830.729831,2106.250363
Cell R10,4250,1067,57281777.63,4531,8716,4185,7472.528585,481.7854912
Cell R100,4250,1064,57120722.96,2124,8711,6587,7536.06109,745.8996328
Cell R101,4250,1068,57335462.52,5222,8642,3420,7876.055243,402.2033926
Cell R104,4250,1067,57281777.63,1367,9069,7702,7124.688847,1852.971911
Cell R105,4250,1064,57120722.96,4215,8307,4092,7521.515038,516.0483615
Cell R106,4250,1068,57335462.52,1640,9014,7374,7129.922285,1416.175859
Cell R107,4250,1068,57335462.52,5832,8961,3129,8008.103933,568.8666071
Cell R11,4250,1070,57442832.3,4987,8830,3843,7899.784112,606.2366408
Cell R111,4250,1066,57228092.74,1549,9474,7925,6938.331144,1822.080233
Cell R112,4250,1066,57228092.74,6271,8707,2436,7615.316135,340.4889301
Cell R113,4250,1067,57281777.63,1694,8797,7103,6847.791003,1281.712269
Cell R114,4250,1067,57281777.63,6424,8815,2391,8060.280225,346.3945413
Cell R117,4250,1068,57335462.52,2018,9931,7913,7375.139513,1216.286271
Cell R118,4250,1058,56798613.62,6193,8892,2699,7456.773157,406.0438479
Cell R119,4250,1068,57335462.52,1694,8208,6514,6765.377341,1182.755935
Cell R120,4250,1070,57442832.3,2116,8617,6501,7447.561682,708.2801807
Cell R121,4250,1063,57067038.07,6699,8699,2000,8019.37159,326.9736256
Cell R123,4250,1066,57228092.74,3588,9136,5548,7476.526266,497.775905
Cell R124,4250,1066,57228092.74,2390,8364,5974,7175.402439,685.2505412
Cell R125,4250,1059,56852298.51,2277,8505,6228,6660.394712,1233.998502
Cell R126,4250,1064,57120722.96,3613,8765,5152,7391.968045,699.8413024
Cell R15,4250,1060,56905983.4,-1970,9374,11344,5206.854717,2230.498366
Cell R16,4250,1065,57174407.85,-1842,9827,11669,5105.030986,2426.451679
Cell R17,4250,1065,57174407.85,1025,9201,8176,7257.36338,1339.124977
Cell R18,4250,1058,56798613.62,1571,8837,7266,6333.136106,1686.250754
Cell R19,4250,1068,57335462.52,1373,9275,7902,6929.51779,1623.105836
Cell R20,4250,1067,57281777.63,2251,8716,6465,7101.216495,1058.129478
Cell R21,4250,1065,57174407.85,3117,8702,5585,7706.855399,631.7830671
Cell R22,4250,1064,57120722.96,6766,8733,1967,8081.161654,328.3574269
Cell R24,4250,1065,57174407.85,-1875,9827,11702,5867.961502,2282.473109
Cell R25,4250,1068,57335462.52,791,9784,8993,3742.779963,2422.044097
Cell R26,4250,1064,57120722.96,1040,9386,8346,6287.916353,2246.452653
Cell R27,4250,1067,57281777.63,1530,9386,7856,7269.332709,1423.226734
Cell R28,4250,1064,57120722.96,1326,9773,8447,6111.414474,2166.919738
Cell R29,4250,1065,57174407.85,1489,9773,8284,7080.805634,1569.247853
Cell R30,4250,1063,57067038.07,4003,8483,4480,7456.266228,676.1667034
Cell R31,4250,1061,56959668.29,5511,8733,3222,7883.717248,465.1568069
Cell R35,4250,1061,56959668.29,-1875,8795,10670,6575.079171,2063.502481
Cell R36,4250,1066,57228092.74,513,9522,9009,6679.081614,2144.942423
Cell R37,4250,1064,57120722.96,862,9328,8466,6680.325188,1722.456705
Cell R38,4250,1055,56637558.95,1296,8825,7529,6117.273934,2089.384609
Cell R39,4250,1069,57389147.41,1920,9211,7291,6963.225444,1313.627388
Cell R40,4250,1066,57228092.74,2443,8808,6365,7096.545966,1061.343918
Cell R46,4250,1063,57067038.07,-779,9915,10694,5320.340546,2640.64802
Cell R47,4250,1059,56852298.51,439,9915,9476,6086.84797,2348.997276
Cell R48,4250,1056,56691243.84,428,9388,8960,5492.357955,2343.6266
Cell R49,4250,1067,57281777.63,1059,9388,8329,5845.712277,2214.682066
Cell R5,4250,1068,57335462.52,-1970,8429,10399,5615.182584,2019.701885
Cell R50,4250,1058,56798613.62,1148,9569,8421,4578.862004,2369.309221
Cell R51,4250,1063,57067038.07,2159,9211,7052,6836.699906,1262.908021
Cell R52,4250,1062,57013353.18,2443,8651,6208,7377.592279,787.0428566
Cell R53,4250,1068,57335462.52,3421,8616,5195,7491.934457,480.9020213
Cell R54,4250,1061,56959668.29,5718,8925,3207,8231.409991,398.9759307
Cell R58,4250,1067,57281777.63,68,9942,9874,4656.169634,2654.382136
Cell R59,4250,1067,57281777.63,258,9971,9713,6477.904405,2254.87868
Cell R6,4250,1067,57281777.63,1220,8664,7444,7466.715089,1014.18265
Cell R60,4250,1066,57228092.74,-471,9366,9837,7107.772045,1318.060173
Cell R61,4250,1068,57335462.52,854,9982,9128,4712.643258,2706.054322
Cell R62,4250,1066,57228092.74,716,9358,8642,4535.587242,2448.333774
Cell R63,4250,1066,57228092.74,716,8811,8095,6568.139775,1706.685067
Cell R64,4250,1062,57013353.18,3349,8358,5009,7601.265537,474.6305463
Cell R65,4250,1068,57335462.52,6936,8690,1754,7969.958801,319.3534289
Cell R66,4250,1058,56798613.62,7377,8955,1578,8392.486767,228.9964139
Cell R69,4250,1065,57174407.85,-308,9859,10167,4536.520188,2895.199327
Cell R7,4250,1067,57281777.63,-1502,8761,10263,6709.148079,1491.834589
Cell R70,4250,1057,56744928.73,-1894,9795,11689,5202.305582,2628.039378
Cell R71,4250,1065,57174407.85,-129,8841,8970,6532.219718,1919.728735
Cell R72,4250,1067,57281777.63,-10,9509,9519,5089.700094,2710.275759
Cell R73,4250,1061,56959668.29,535,9829,9294,5798.28935,2545.627701
Cell R74,4250,1067,57281777.63,1342,9341,7999,6621.99344,1913.173422
Cell R75,4250,1066,57228092.74,6008,8674,2666,7768.525328,318.4947828
Cell R76,4250,1058,56798613.62,6613,8790,2177,8096.837429,320.2074824
Cell R77,4250,1061,56959668.29,6613,9040,2427,8203.6164,304.8636581
Cell R8,4250,1062,57013353.18,-384,8813,9197,7288.30226,1125.932667
Cell R80,4250,1067,57281777.63,-1894,9795,11689,4945.40956,2646.788456
Cell R81,4250,1067,57281777.63,441,9507,9066,6620.565136,2064.988729
Cell R82,4250,1061,56959668.29,-10,9754,9764,4467.028275,2730.552585
Cell R83,4250,1063,57067038.07,422,8954,8532,5351.896519,2550.110128
Cell R84,4250,1068,57335462.52,1262,8712,7450,4701.384831,2347.515034
Cell R85,4250,1055,56637558.95,1376,8712,7336,6236.948815,1979.137417
Cell R86,4250,1067,57281777.63,5782,8431,2649,7464.445173,425.1079355
Cell R87,4250,1067,57281777.63,6259,8547,2288,7793.420806,346.7018361
Cell R9,4250,1068,57335462.52,-384,8813,9197,7294.136704,1025.624313
Cell R90,4250,1066,57228092.74,784,9694,8910,6248.10788,2157.672624
Cell R91,4250,1067,57281777.63,1032,8860,7828,7163.445173,1493.932943
Cell R92,4250,1065,57174407.85,1249,9683,8434,3871.011268,2223.26366
Cell R93,4250,1068,57335462.52,1627,9040,7413,6945.485955,1351.538606
Cell R97,4250,1063,57067038.07,1284,9318,8034,6740.567262,1894.684175
Cell R98,4250,1062,57013353.18,2951,8487,5536,7683.772128,560.1931558
Cell R99,4250,1064,57120722.96,1402,8442,7040,7463.868421,1010.558778
Cell S102,4250,1067,57281777.63,6731,8935,2204,8034.56045,423.227299
Cell S108,4250,1064,57120722.96,6068,8870,2802,7974.887218,526.1769215
Cell S13,4250,1066,57228092.74,6084,9045,2961,8150.184803,452.1186737
Cell S14,4250,1058,56798613.62,5313,9125,3812,8120.091682,601.7519273
Cell S2,4250,1067,57281777.63,5628,8794,3166,8032.331771,406.1775626
Cell S23,4250,1063,57067038.07,5723,8842,3119,8179.722484,452.3677804
Cell S32,4250,1065,57174407.85,5779,8938,3159,7945.734272,481.6771051
Cell S33,4250,1062,57013353.18,5452,8700,3248,7897.421846,438.620873
Cell S34,4250,1068,57335462.52,6616,8848,2232,8070.61985,365.6587607
Cell S41,4250,1065,57174407.85,6027,8751,2724,7744.618779,350.7507966
Cell S42,4250,1070,57442832.3,6899,8915,2016,8166.519626,359.6382958
Cell S44,4250,1063,57067038.07,6968,8939,1971,8174.857008,313.2373345
Cell S56,4250,1067,57281777.63,5634,8793,3159,7961.522024,493.2432348
Cell S67,4250,1066,57228092.74,5823,8955,3132,8201.272983,416.4960641
Cell S78,4250,1067,57281777.63,6692,8960,2268,8361.858482,290.2373324
Cell S88,4250,1065,57174407.85,6375,8915,2540,8118.042254,408.6148445
Cell S94,4250,1063,57067038.07,7045,8935,1890,8100.793979,307.2205625
Cell S95,4250,1058,56798613.62,6188,8796,2608,7951.155955,426.3914787
W287,4250,1062,57013353.18,807,8994,8187,4004.661959,1905.938156
W295,4250,1067,57281777.63,1891,8825,6934,7144.716026,1285.562437
W338,4250,1067,57281777.63,1046,9866,8820,4599.56045,2577.971232
W342,4250,1068,57335462.52,1427,8187,6760,5432.764981,2045.588172
W345,4250,1063,57067038.07,3683,8540,4857,7461.571966,538.8171099
W387,4250,1065,57174407.85,1191,9334,8143,5698.560563,2493.221715
W393,4250,1064,57120722.96,1318,8897,7579,6499.042293,1847.853885
W440,4250,1061,56959668.29,1125,8601,7476,5387.067861,2188.305101
W441,4250,1062,57013353.18,3316,8537,5221,7101.188324,914.0068253
W445,4250,1067,57281777.63,2376,8498,6122,6797.08716,887.6282821
W500,4250,1065,57174407.85,1427,8823,7396,6050.037559,1904.742217
1,4500,1194,64099758.66,1220,8730,7510,7388.064489,1144.104127
2,4500,1199,64368183.11,1607,8837,7230,6324.943286,1610.954393
3,4500,1192,63992388.88,1457,9275,7818,7384.663591,827.2134047
4,4500,1192,63992388.88,2251,8716,6465,7073.672819,1084.760563
5,4500,1190,63885019.1,-1875,8795,10670,6537.954622,2041.883888
6,4500,1195,64153443.55,1665,9386,7721,7071.569874,1504.07698
7,4500,1196,64207128.44,1476,9773,8297,6852.530936,1551.657458
8,4500,1194,64099758.66,1533,8838,7305,6771.644054,1412.10849
9,4500,1191,63938703.99,6027,8751,2724,7855.675903,342.0349201
10,4500,1195,64153443.55,448,9915,9467,6156.853556,2371.152224
11,4500,1190,63885019.1,348,9388,9040,5389.278992,2378.439317
12,4500,1188,63777649.32,1148,9569,8421,4443.41835,2377.392512
13,4500,1194,64099758.66,1807,9211,7404,6788.673367,1334.754651
14,4500,1195,64153443.55,4359,8852,4493,7959.733054,671.4778405
16,4500,1192,63992388.88,-308,9859,10167,4700.152685,2859.395639
17,4500,1195,64153443.55,-471,9366,9837,7003.738912,1448.920641
18,4500,1196,64207128.44,854,9982,9128,4462.067726,2718.852565
19,4500,1192,63992388.88,716,9358,8642,4631.533557,2457.124387
20,4500,1189,63831334.21,6008,9288,3280,7765.583684,328.6694548
21,4500,1197,64260813.33,6613,9040,2427,8204.595656,302.2826115
22,4500,1195,64153443.55,-1894,9795,11689,4659.878661,2786.192974
23,4500,1199,64368183.11,-10,9874,9884,4662.080901,2734.487965
24,4500,1192,63992388.88,1032,8860,7828,7073.255872,1628.882065
25,4500,1198,64314498.22,1626,9040,7414,6943.57429,1348.762509
26,4500,1196,64207128.44,6199,8547,2348,7794.880435,354.935674
27,4500,1193,64046073.77,1606,8506,6900,7618.019279,773.1792004
28,4500,1193,64046073.77,1930,8307,6377,7467.355407,683.3048526
29,4500,1193,64046073.77,2124,8711,6587,7492.818944,856.8905203
31,4500,1197,64260813.33,2282,9474,7192,7620.147034,568.043058
32,4500,1195,64153443.55,1694,8797,7103,6861.232636,1260.536115
33,4500,1194,64099758.66,6193,8892,2699,7454.337521,417.2541804
34,4500,1196,64207128.44,3799,8364,4565,7186.721572,569.8414615
10A,4500,1192,63992388.88,312,9915,9603,5966.739933,2390.680633
10NE,4500,1190,63885019.1,312,9581,9269,5861.815966,2569.875586
10NW,4500,1188,63777649.32,513,9522,9009,6483.23064,2287.69164
10SW,4500,1189,63831334.21,-779,9915,10694,5277.931034,2595.457888
11NE,4500,1197,64260813.33,-195,9328,9523,6613.891395,1833.156241
11NW,4500,1192,63992388.88,-195,9388,9583,5585.220638,2557.892494
11SE,4500,1194,64099758.66,1059,9388,8329,5801.367672,2235.690192
17NW,4500,1193,64046073.77,258,9971,9713,6432.220453,2245.782507
17SE,4500,1193,64046073.77,-156,9013,9169,6480.94803,1971.128508
17SW,4500,1190,63885019.1,-1894,9795,11689,5080.615966,2685.365636
22S,4500,1190,63885019.1,-1894,9795,11689,4557.222689,2782.096371
23S,4500,1188,63777649.32,1090,9719,8629,3664.239057,2002.104207
24S,4500,1193,64046073.77,1032,8860,7828,7072.24057,1623.107331
27A,4500,1193,64046073.77,1284,9318,8034,6734.202012,1947.813957
2A,4500,1196,64207128.44,1571,8837,7266,6321.681438,1721.989608
5NE,4500,1194,64099758.66,-1842,9827,11669,4664.222781,2423.180167
5NW,4500,1197,64260813.33,-1875,9827,11702,5413.144528,2470.446172
5SE,4500,1193,64046073.77,527,9784,9257,3799.433361,2455.414533
6NE,4500,1196,64207128.44,1697,9110,7413,6976.420569,1524.785565
6NW,4500,1196,64207128.44,851,9386,8535,6137.802676,2348.450819
6SW,4500,1193,64046073.77,1204,9386,8182,6530.2171,2154.502108
Cell 1 2011/12,4500,1194,64099758.66,1220,8730,7510,7388.064489,1144.104127
Cell 1 SW 2013,4500,1194,64099758.66,-1970,9374,11344,5173.056951,2238.123585
Cell 10 2011/12,4500,1195,64153443.55,448,9915,9467,6156.853556,2371.152224
Cell 10 NE 2011/12,4500,1190,63885019.1,312,9581,9269,5861.815966,2569.875586
Cell 10 NW 2011/12,4500,1188,63777649.32,513,9522,9009,6483.23064,2287.69164
Cell 10 SE 2013,4500,1196,64207128.44,851,9386,8535,6137.802676,2348.450819
Cell 10 SW 2011/12,4500,1189,63831334.21,-779,9915,10694,5277.931034,2595.457888
Cell 10-A 2011/12,4500,1192,63992388.88,312,9915,9603,5966.739933,2390.680633
Cell 11 NE 2011/12,4500,1197,64260813.33,-195,9328,9523,6613.891395,1833.156241
Cell 11 NW 2013,4500,1191,63938703.99,1571,8837,7266,6337.196474,1689.827598
Cell 11 SW 2013,4500,1190,63885019.1,1563,9386,7823,7071.596639,1639.162836
Cell 12 2013,4500,1192,63992388.88,1476,9773,8297,6856.063758,1550.22418
Cell 13 2013,4500,1189,63831334.21,1423,8838,7415,6681.227923,1482.730668
Cell 14 2013,4500,1193,64046073.77,6766,8733,1967,8069.741827,339.4362968
Cell 15 2013,4500,1195,64153443.55,5348,8780,3432,7917.624268,476.2636908
Cell 15-A 2013,4500,1193,64046073.77,5452,8726,3274,7915.24979,440.3480312
Cell 16 2013,4500,1193,64046073.77,5452,8810,3358,7982.685666,411.6496235
Cell 17 NW 2011/12,4500,1193,64046073.77,258,9971,9713,6432.220453,2245.782507
Cell 17 NW 2013,4500,1195,64153443.55,-1875,9827,11702,5874.358159,2279.444022
Cell 17 SE 2013,4500,1188,63777649.32,513,9522,9009,6483.23064,2287.69164
Cell 17 SW 2013,4500,1194,64099758.66,-1875,8795,10670,6544.772194,2043.405509
Cell 18 2011/12,4500,1196,64207128.44,854,9982,9128,4462.067726,2718.852565
Cell 18 NE 2013,4500,1193,64046073.77,1204,9386,8182,6523.823135,2164.276377
Cell 18 NW 2013,4500,1195,64153443.55,527,9784,9257,3783.010042,2432.270489
Cell 18 SE 2013,4500,1196,64207128.44,-195,9328,9523,6613.857023,1833.922065
Cell 18 SSE 2013,4500,1195,64153443.55,-195,9388,9583,5532.795816,2509.244155
Cell 19 NW 2013,4500,1194,64099758.66,1530,9386,7856,7145.533501,1556.615746
Cell 2 2011/12,4500,1199,64368183.11,1607,8837,7230,6324.943286,1610.954393
Cell 2 NE 2013,4500,1189,63831334.21,-2000,8957,10957,6311.767031,1809.077416
Cell 2 SW 2013,4500,1194,64099758.66,1220,8730,7510,7388.639028,1142.489325
Cell 20 2013,4500,1192,63992388.88,1476,9773,8297,6995.604866,1632.253909
Cell 21 2013,4500,1191,63938703.99,2443,8808,6365,7129.514694,1043.276336
Cell 22 2013,4500,1193,64046073.77,6717,8692,1975,7855.834032,290.2745227
Cell 23 2013,4500,1196,64207128.44,6899,8915,2016,8162.269231,360.8475082
Cell 24 2013,4500,1197,64260813.33,6616,8848,2232,8065.308271,366.3647028
Cell 25 NE 2013,4500,1195,64153443.55,448,9915,9467,6156.853556,2371.152224
Cell 25 SE 2013,4500,1188,63777649.32,-779,9915,10694,5275.740741,2595.451392
Cell 26 NE 2013,4500,1190,63885019.1,348,9388,9040,5389.278992,2378.439317
Cell 26 NNW 2013,4500,1190,63885019.1,312,9581,9269,5861.815966,2569.875586
Cell 26 NW 2013,4500,1191,63938703.99,312,9915,9603,5969.124265,2390.266953
Cell 27 NW 2013,4500,1194,64099758.66,1059,9388,8329,5801.367672,2235.690192
Cell 28 2013,4500,1188,63777649.32,1148,9569,8421,4443.41835,2377.392512
Cell 29 2013,4500,1192,63992388.88,1807,9211,7404,6788.024329,1334.916462
Cell 3 NE 2013,4500,1195,64153443.55,-384,8813,9197,7276.463598,1109.192143
Cell 3 NW 2013,4500,1194,64099758.66,-2000,8761,10761,6668.828308,1533.952841
Cell 30 2013,4500,1197,64260813.33,6786,8693,1907,7975.173768,326.6602396
Cell 31 2013,4500,1194,64099758.66,5610,8925,3315,8227.176717,400.2704087
Cell 32 2013,4500,1191,63938703.99,5823,8982,3159,8209.086482,417.928314
Cell 33 NE 2013,4500,1193,64046073.77,258,9971,9713,6432.220453,2245.782507
Cell 33 SE 2013,4500,1191,63938703.99,-1894,9795,11689,5076.31822,2688.329203
Cell 33 SW 2013,4500,1190,63885019.1,-506,9859,10365,4590.472269,2897.357202
Cell 34 N 2013,4500,1190,63885019.1,1364,8825,7461,6653.021849,1734.769351
Cell 34 NW 2013,4500,1195,64153443.55,-471,9366,9837,7003.738912,1448.920641
Cell 34 SE 2013,4500,1193,64046073.77,-156,9013,9169,6478.498743,1976.195113
Cell 35 2013,4500,1199,64368183.11,854,9982,9128,4681.168474,2708.234036
Cell 37 2013,4500,1196,64207128.44,6008,9288,3280,7765.19398,327.8581641
Cell 38 2013,4500,1197,64260813.33,6613,9040,2427,8212.028404,301.347593
Cell 39 2013,4500,1191,63938703.99,6692,8985,2293,8363.167926,289.8515101
Cell 4 2013,4500,1195,64153443.55,4531,8716,4185,7471.499582,493.7188134
Cell 40 NE 2013,4500,1198,64314498.22,-1894,9795,11689,4862.642738,2666.378117
Cell 41 N 2013,4500,1194,64099758.66,-1894,9615,11509,6575.036851,2211.390436
Cell 41 NW 2013,4500,1195,64153443.55,-1894,9795,11689,5605.815063,2720.759654
Cell 42 NW 2013,4500,1195,64153443.55,-10,9874,9884,4638.533054,2738.154128
Cell 43 2013,4500,1188,63777649.32,1376,8712,7336,6240.404882,1981.519113
Cell 44 2013,4500,1193,64046073.77,5636,8413,2777,7526.874267,466.5021103
Cell 45 2013,4500,1193,64046073.77,6199,8547,2348,7796.357921,354.654275
Cell 47 2013,4500,1190,63885019.1,784,9694,8910,6280.693277,2155.969612
Cell 48 2013,4500,1195,64153443.55,1032,8860,7828,7054.430962,1647.330917
Cell 49 2013,4500,1199,64368183.11,1626,9040,7414,6942.919933,1348.390166
Cell 5 2011/12 Summer,4500,1192,63992388.88,-1875,8795,10670,6547.297819,2042.217668
Cell 5 2013,4500,1196,64207128.44,4772,8830,4058,7904.233278,602.7260771
Cell 50 2013,4500,1193,64046073.77,2124,8711,6587,7492.818944,856.8905203
Cell 51 2013,4500,1188,63777649.32,6188,8796,2608,7957.389731,423.2570206
Cell 52 2013,4500,1189,63831334.21,1402,8506,7104,7404.341463,1156.828633
Cell 53 2013,4500,1193,64046073.77,1930,8307,6377,7467.355407,683.3048526
Cell 54 2013,4500,1196,64207128.44,5832,8961,3129,7988.242475,579.6192382
Cell 55 2013,4500,1194,64099758.66,6068,8870,2802,7968.979899,526.0407516
Cell 56 2013,4500,1194,64099758.66,6193,8892,2699,7454.551926,417.0615977
Cell 57 2013,4500,1198,64314498.22,1694,8797,7103,6859.623539,1259.122228
Cell 58 2013,4500,1195,64153443.55,6273,8815,2542,8053.600837,370.1323461
Cell 59 2013,4500,1197,64260813.33,6044,9136,3092,7445.908104,396.7183112
Cell 6 2011/12,4500,1195,64153443.55,1665,9386,7721,7071.569874,1504.07698
Cell 6 2013,4500,1196,64207128.44,5628,8794,3166,8050.198997,400.9161401
Cell 6 NE 2011/12,4500,1196,64207128.44,1697,9110,7413,6976.420569,1524.785565
Cell 6 NW 2011/12,4500,1196,64207128.44,851,9386,8535,6137.802676,2348.450819
Cell 6 SW 2011/12,4500,1193,64046073.77,1204,9386,8182,6530.2171,2154.502108
Cell 60 2013,4500,1196,64207128.44,2390,8364,5974,7187.378763,639.2095135
Cell 61 2013,4500,1199,64368183.11,3613,8831,5218,7523.062552,698.533689
Cell 7 2013,4500,1190,63885019.1,5313,9125,3812,8099.823529,606.1674942
Cell 9 NW 2013,4500,1194,64099758.66,-1842,9827,11669,4990.944724,2435.472511
Cell 9 SE 2013,4500,1194,64099758.66,-1842,9827,11669,4664.222781,2423.180167
Cell 9 SW 2013,4500,1197,64260813.33,-1875,9827,11702,5413.439432,2470.647929
Cell R1,4500,1201,64475552.89,1192,8189,6997,5803.366361,2109.774975
Cell R10,4500,1193,64046073.77,4531,8716,4185,7469.818106,492.8199094
Cell R100,4500,1193,64046073.77,2124,8711,6587,7492.818944,856.8905203
Cell R101,4500,1195,64153443.55,5222,8709,3487,7869.375732,419.3148768
Cell R104,4500,1192,63992388.88,1367,9157,7790,7021.795302,1957.680463
Cell R105,4500,1194,64099758.66,1930,8307,6377,7462.9866,699.4888429
Cell R106,4500,1196,64207128.44,1640,9014,7374,7168.16388,1377.602267
Cell R107,4500,1195,64153443.55,5832,8961,3129,7988,579.8010696
Cell R11,4500,1196,64207128.44,4772,8830,4058,7904.233278,602.7260771
Cell R111,4500,1191,63938703.99,1549,9474,7925,6909.324097,1845.172538
Cell R112,4500,1195,64153443.55,6271,8707,2436,7613.833473,341.8972904
Cell R113,4500,1200,64421868,1694,8797,7103,6860.456667,1258.248687
Cell R114,4500,1196,64207128.44,6273,8815,2542,8053.349498,370.079581
Cell R117,4500,1196,64207128.44,2018,9931,7913,7273.919732,1371.274295
Cell R118,4500,1194,64099758.66,6193,8892,2699,7454.551926,417.0615977
Cell R119,4500,1193,64046073.77,1694,8405,6711,6758.109807,1221.25521
Cell R120,4500,1201,64475552.89,2116,8617,6501,7414.413822,751.0925716
Cell R121,4500,1195,64153443.55,6699,8764,2065,8022.686192,334.6277634
Cell R123,4500,1191,63938703.99,2644,9136,6492,7428.052057,633.7931356
Cell R124,4500,1193,64046073.77,2390,8373,5983,7143.117351,743.5871302
Cell R125,4500,1192,63992388.88,2277,8505,6228,6690.832215,1203.871156
Cell R126,4500,1194,64099758.66,3613,8796,5183,7418.59799,687.2380226
Cell R15,4500,1194,64099758.66,-1970,9374,11344,5173.056951,2238.123585
Cell R16,4500,1196,64207128.44,-1842,9827,11669,4978.67893,2440.323261
Cell R17,4500,1192,63992388.88,1025,9201,8176,7215.261745,1436.059053
Cell R18,4500,1184,63562909.76,1571,8837,7266,6316.897804,1699.992877
Cell R19,4500,1197,64260813.33,1373,9275,7902,6869.658312,1688.145551
Cell R20,4500,1193,64046073.77,2251,8716,6465,7095.554904,1097.891021
Cell R21,4500,1192,63992388.88,2520,8838,6318,7683.661074,738.9914921
Cell R22,4500,1193,64046073.77,6766,8733,1967,8069.741827,339.4362968
Cell R24,4500,1195,64153443.55,-1875,9827,11702,5874.358159,2279.444022
Cell R25,4500,1195,64153443.55,527,9784,9257,3783.010042,2432.270489
Cell R26,4500,1189,63831334.21,851,9386,8535,6150.240538,2337.642214
Cell R27,4500,1192,63992388.88,1530,9386,7856,7151.138423,1551.326594
Cell R28,4500,1192,63992388.88,1326,9773,8447,6128.098154,2166.321291
Cell R29,4500,1193,64046073.77,1476,9773,8297,6997.134116,1632.423721
Cell R30,4500,1193,64046073.77,3917,8751,4834,7444.901928,706.0074451
Cell R31,4500,1196,64207128.44,5511,8751,3240,7890.464047,460.5639279
Cell R35,4500,1192,63992388.88,-1875,8795,10670,6547.297819,2042.217668
Cell R36,4500,1190,63885019.1,513,9522,9009,6484.338655,2285.947617
Cell R37,4500,1196,64207128.44,-195,9328,9523,6613.857023,1833.922065
Cell R38,4500,1189,63831334.21,1282,9231,7949,6001.518923,2156.079167
Cell R39,4500,1196,64207128.44,1828,9211,7383,6945.311037,1315.950268
Cell R40,4500,1191,63938703.99,2443,8808,6365,7129.514694,1043.276336
Cell R46,4500,1191,63938703.99,-779,9915,10694,5385.109152,2650.958845
Cell R47,4500,1192,63992388.88,312,9915,9603,5966.739933,2390.680633
Cell R48,4500,1190,63885019.1,348,9388,9040,5389.278992,2378.439317
Cell R49,4500,1194,64099758.66,1059,9388,8329,5801.367672,2235.690192
Cell R5,4500,1196,64207128.44,-1970,8429,10399,5565.590301,2053.260241
Cell R50,4500,1187,63723964.43,1148,9569,8421,4445.915754,2376.835533
Cell R51,4500,1194,64099758.66,1807,9211,7404,6786.31072,1330.242256
Cell R52,4500,1193,64046073.77,2443,8651,6208,7364.69824,797.5548369
Cell R53,4500,1196,64207128.44,3421,8616,5195,7495.458194,473.361067
Cell R54,4500,1194,64099758.66,5610,8925,3315,8227.176717,400.2704087
Cell R58,4500,1194,64099758.66,66,9942,9876,4662.649079,2672.649472
Cell R59,4500,1194,64099758.66,258,9971,9713,6431.312395,2245.060959
Cell R6,4500,1194,64099758.66,1220,8730,7510,7388.639028,1142.489325
Cell R60,4500,1195,64153443.55,-471,9366,9837,7003.738912,1448.920641
Cell R61,4500,1199,64368183.11,854,9982,9128,4681.168474,2708.234036
Cell R62,4500,1192,63992388.88,716,9358,8642,4556.999161,2444.095876
Cell R63,4500,1196,64207128.44,716,8811,8095,6547.398829,1701.333979
Cell R64,4500,1194,64099758.66,3349,8358,5009,7602.556951,458.6438722
Cell R65,4500,1198,64314498.22,6786,8693,1907,7975.048414,326.5526763
Cell R66,4500,1191,63938703.99,7270,8955,1685,8390.65827,231.6116279
Cell R69,4500,1190,63885019.1,-506,9859,10365,4590.472269,2897.357202
Cell R7,4500,1194,64099758.66,-2000,8761,10761,6668.828308,1533.952841
Cell R70,4500,1190,63885019.1,-1894,9795,11689,5080.615966,2685.365636
Cell R71,4500,1194,64099758.66,-156,9013,9169,6478.775544,1975.390523
Cell R72,4500,1194,64099758.66,-10,9509,9519,5125.427136,2696.576985
Cell R73,4500,1196,64207128.44,535,9829,9294,5565.117893,2611.050541
Cell R74,4500,1194,64099758.66,1154,9341,8187,6586.372697,1944.163101
Cell R75,4500,1197,64260813.33,6008,9288,3280,7765.115288,327.7324847
Cell R76,4500,1192,63992388.88,6613,8790,2177,8091.626678,318.1359204
Cell R77,4500,1197,64260813.33,6613,9040,2427,8212.028404,301.347593
Cell R8,4500,1189,63831334.21,-384,8813,9197,7270.960471,1114.79289
Cell R80,4500,1198,64314498.22,-1894,9795,11689,4862.642738,2666.378117
Cell R81,4500,1193,64046073.77,441,9583,9142,6550.609388,2081.080139
Cell R82,4500,1196,64207128.44,-10,9874,9884,4641.25,2738.620176
Cell R83,4500,1192,63992388.88,422,9108,8686,5341.812081,2515.325147
Cell R84,4500,1193,64046073.77,1211,8712,7501,4765.867561,2354.617665
Cell R85,4500,1188,63777649.32,1376,8712,7336,6240.404882,1981.519113
Cell R86,4500,1194,64099758.66,5782,8431,2649,7472.113903,421.0786266
Cell R87,4500,1193,64046073.77,6199,8547,2348,7796.357921,354.654275
Cell R9,4500,1197,64260813.33,-384,8813,9197,7264.705931,1046.085355
Cell R90,4500,1190,63885019.1,784,9694,8910,6280.693277,2155.969612
Cell R91,4500,1195,64153443.55,1032,8860,7828,7054.430962,1647.330917
Cell R92,4500,1193,64046073.77,1249,9683,8434,3942.580889,2222.201644
Cell R93,4500,1199,64368183.11,1626,9040,7414,6942.919933,1348.390166
Cell R97,4500,1193,64046073.77,1284,9318,8034,6773.317687,1883.506149
Cell R98,4500,1193,64046073.77,1606,8506,6900,7618.019279,773.1792004
Cell R99,4500,1189,63831334.21,1402,8506,7104,7404.341463,1156.828633
Cell S102,4500,1196,64207128.44,6394,8935,2541,8031.667224,418.6545674
Cell S108,4500,1194,64099758.66,6068,8870,2802,7968.979899,526.0407516
Cell S13,4500,1194,64099758.66,6084,9045,2961,8154.206868,451.6045504
Cell S14,4500,1189,63831334.21,5313,9125,3812,8099.791421,606.4213356
Cell S2,4500,1196,64207128.44,5628,8794,3166,8050.198997,400.9161401
Cell S23,4500,1190,63885019.1,5723,8842,3119,8170.772269,460.7118526
Cell S32,4500,1192,63992388.88,5779,8938,3159,7948.40604,477.367183
Cell S33,4500,1193,64046073.77,5452,8726,3274,7915.24979,440.3480312
Cell S34,4500,1197,64260813.33,6616,8848,2232,8065.308271,366.3647028
Cell S41,4500,1192,63992388.88,5480,8751,3271,7736.616611,363.8700144
Cell S42,4500,1196,64207128.44,6899,8915,2016,8162.269231,360.8475082
Cell S44,4500,1193,64046073.77,6968,8939,1971,8183.697402,315.5196193
Cell S56,4500,1197,64260813.33,5634,8793,3159,7966.908104,502.1120904
Cell S67,4500,1191,63938703.99,5823,8982,3159,8209.086482,417.928314
Cell S78,4500,1191,63938703.99,6692,8985,2293,8363.167926,289.8515101
Cell S88,4500,1194,64099758.66,6375,8915,2540,8119.183417,402.7418599
Cell S94,4500,1192,63992388.88,6943,8935,1992,8099.612416,310.1802882
Cell S95,4500,1188,63777649.32,6188,8796,2608,7957.389731,423.2570206
W287,4500,1188,63777649.32,807,8994,8187,4007.714646,1945.933854
W295,4500,1194,64099758.66,1643,8825,7182,7114.642379,1371.257739
W338,4500,1196,64207128.44,876,9866,8990,4485.139632,2563.280355
W342,4500,1197,64260813.33,1426,8356,6930,5422.281537,2074.973273
W345,4500,1190,63885019.1,3683,8605,4922,7469.916807,556.2267091
W387,4500,1194,64099758.66,1191,9937,8746,5720.897822,2487.886938
W393,4500,1196,64207128.44,1318,9521,8203,6426.002508,1889.829607
W440,4500,1192,63992388.88,1125,8601,7476,5413.809564,2209.773951
W441,4500,1193,64046073.77,2581,8550,5969,7078.207041,931.6632766
W445,4500,1196,64207128.44,2376,8498,6122,6785.922241,914.2674681
W500,4500,1195,64153443.55,1427,8823,7396,6106.062762,1875.758674
1,4750,1332,71508273.48,1187,8730,7543,7253.373874,1358.657883
2,4750,1334,71615643.26,1607,8837,7230,6278.618441,1639.782096
3,4750,1328,71293533.92,1373,9275,7902,7311.676958,955.8605
4,4750,1328,71293533.92,1923,8716,6793,7077.731175,1107.013585
5,4750,1329,71347218.81,-1875,8967,10842,6496.75696,2049.402286
6,4750,1330,71400903.7,1489,9386,7897,6920.769173,1674.300971
7,4750,1330,71400903.7,1476,9773,8297,6789.327068,1631.302168
8,4750,1327,71239849.03,1423,8838,7415,6804.424265,1424.367686
9,4750,1329,71347218.81,6027,8751,2724,7851.732129,346.7767334
10,4750,1331,71454588.59,448,9915,9467,6014.03456,2433.499414
11,4750,1327,71239849.03,108,9388,9280,5294.000754,2405.723966
12,4750,1333,71561958.37,700,9569,8869,4361.383346,2381.117691
13,4750,1327,71239849.03,1506,9211,7705,6748.276564,1395.636431
14,4750,1330,71400903.7,4359,8852,4493,7953.850376,672.2216948
16,4750,1328,71293533.92,-506,9859,10365,4754.25,2864.673554
17,4750,1328,71293533.92,-471,9366,9837,6873.146084,1598.771543
18,4750,1333,71561958.37,854,9982,9128,4452.170293,2690.227982
19,4750,1332,71508273.48,716,9358,8642,4683.054054,2463.530856
20,4750,1331,71454588.59,6008,9288,3280,7759.179564,332.5358955
21,4750,1330,71400903.7,6613,9040,2427,8209.454887,297.8596629
22,4750,1330,71400903.7,-1894,9795,11689,4699.699248,2764.050484
23,4750,1330,71400903.7,-10,9874,9884,4802.781203,2733.487307
24,4750,1328,71293533.92,1032,8860,7828,6962.060994,1771.623388
25,4750,1333,71561958.37,1626,9040,7414,6942.165791,1352.125638
26,4750,1332,71508273.48,6199,8547,2348,7793.989489,365.6964661
27,4750,1330,71400903.7,1316,8549,7233,7546.672932,968.6903587
28,4750,1334,71615643.26,1486,8367,6881,7368.614693,959.1345658
29,4750,1328,71293533.92,1810,8711,6901,7436.277108,991.6959028
31,4750,1331,71454588.59,1966,9474,7508,7607.70849,658.7637369
32,4750,1333,71561958.37,1694,8797,7103,6878.913728,1242.580363
33,4750,1328,71293533.92,6193,9034,2841,7457.36747,422.7838256
34,4750,1332,71508273.48,3625,8364,4739,7143.824324,647.5288988
10A,4750,1329,71347218.81,206,9915,9709,5834.259594,2445.8808
10NE,4750,1329,71347218.81,312,9581,9269,5747.874342,2612.456658
10NW,4750,1331,71454588.59,513,9522,9009,6302.851991,2406.974781
10SW,4750,1329,71347218.81,-779,9915,10694,5330.776524,2616.659233
11NE,4750,1332,71508273.48,-195,9328,9523,6533.655405,1950.714712
11NW,4750,1329,71347218.81,-195,9388,9583,5522.045899,2560.650059
11SE,4750,1331,71454588.59,1059,9388,8329,5772.885049,2227.728739
17NW,4750,1331,71454588.59,258,9971,9713,6400.896319,2223.454233
17SE,4750,1330,71400903.7,-573,9509,10082,6431.902256,2047.94062
17SW,4750,1327,71239849.03,-1894,9795,11689,5069.073097,2706.125372
22S,4750,1331,71454588.59,-1894,9795,11689,4583.461307,2755.869592
23S,4750,1333,71561958.37,1090,9773,8683,3717.741185,2082.713091
24S,4750,1331,71454588.59,1032,8860,7828,6951.862509,1779.593722
27A,4750,1330,71400903.7,1284,9694,8410,6788.817293,1914.994603
2A,4750,1327,71239849.03,1571,8837,7266,6287.467219,1729.119102
5NE,4750,1328,71293533.92,-1842,9827,11669,4597.216114,2424.270917
5NW,4750,1334,71615643.26,-1875,9827,11702,5362.934033,2463.148878
5SE,4750,1329,71347218.81,234,9784,9550,3820.578631,2451.348201
6NE,4750,1330,71400903.7,1697,9110,7413,6988.245865,1506.263727
6NW,4750,1331,71454588.59,851,9386,8535,6057.568745,2411.335183
6SW,4750,1329,71347218.81,1204,9784,8580,6541.277652,2119.550128
Cell 1 2011/12,4750,1332,71508273.48,1187,8730,7543,7253.373874,1358.657883
Cell 1 SW 2013,4750,1325,71132479.25,-1970,9374,11344,5173.154717,2237.648123
Cell 10 2011/12,4750,1331,71454588.59,448,9915,9467,6014.03456,2433.499414
Cell 10 NE 2011/12,4750,1329,71347218.81,312,9581,9269,5747.874342,2612.456658
Cell 10 NW 2011/12,4750,1331,71454588.59,513,9522,9009,6302.851991,2406.974781
Cell 10 SE 2013,4750,1331,71454588.59,851,9386,8535,6057.568745,2411.335183
Cell 10 SW 2011/12,4750,1329,71347218.81,-779,9915,10694,5330.776524,2616.659233
Cell 10-A 2011/12,4750,1329,71347218.81,206,9915,9709,5834.259594,2445.8808
Cell 11 NE 2011/12,4750,1332,71508273.48,-195,9328,9523,6533.655405,1950.714712
Cell 11 NW 2013,4750,1326,71186164.14,1571,8837,7266,6325.564103,1688.628975
Cell 11 SW 2013,4750,1330,71400903.7,1530,9386,7856,6971.881955,1714.174989
Cell 12 2013,4750,1333,71561958.37,1476,9773,8297,6790.625656,1629.723051
Cell 13 2013,4750,1331,71454588.59,1423,8838,7415,6715.850488,1491.657061
Cell 14 2013,4750,1329,71347218.81,6613,8733,2120,8054.457487,352.1667916
Cell 15 2013,4750,1333,71561958.37,5348,8876,3528,7934.683421,487.7034232
Cell 15-A 2013,4750,1331,71454588.59,5452,8876,3424,7934.791886,441.5719541
Cell 16 2013,4750,1334,71615643.26,5452,8848,3396,7992.497001,411.4476377
Cell 17 NW 2011/12,4750,1331,71454588.59,258,9971,9713,6400.896319,2223.454233
Cell 17 NW 2013,4750,1331,71454588.59,-1875,9827,11702,5873.842224,2291.774533
Cell 17 SE 2013,4750,1331,71454588.59,513,9522,9009,6302.851991,2406.974781
Cell 17 SW 2013,4750,1327,71239849.03,-1875,8967,10842,6501.787491,2057.754833
Cell 18 2011/12,4750,1333,71561958.37,854,9982,9128,4452.170293,2690.227982
Cell 18 NE 2013,4750,1327,71239849.03,1204,9386,8182,6547.935192,2118.350354
Cell 18 NW 2013,4750,1330,71400903.7,527,9784,9257,3805.832331,2422.956801
Cell 18 SE 2013,4750,1332,71508273.48,-195,9328,9523,6533.655405,1950.714712
Cell 18 SSE 2013,4750,1330,71400903.7,-195,9388,9583,5452.665414,2529.13084
Cell 19 NW 2013,4750,1329,71347218.81,1421,9386,7965,7000.906697,1675.291682
Cell 2 2011/12,4750,1334,71615643.26,1607,8837,7230,6278.618441,1639.782096
Cell 2 NE 2013,4750,1330,71400903.7,-2000,8957,10957,6329.418045,1784.657213
Cell 2 SW 2013,4750,1332,71508273.48,1187,8730,7543,7254.273273,1358.684479
Cell 20 2013,4750,1328,71293533.92,1465,9773,8308,6933.341114,1676.136335
Cell 21 2013,4750,1330,71400903.7,2159,8808,6649,7152.117293,1032.616158
Cell 22 2013,4750,1330,71400903.7,6717,8751,2034,7858.757895,299.8080314
Cell 23 2013,4750,1332,71508273.48,6899,8915,2016,8159.056306,361.746405
Cell 24 2013,4750,1330,71400903.7,6616,8848,2232,8061.158647,367.5064968
Cell 25 NE 2013,4750,1331,71454588.59,448,9915,9467,6014.03456,2433.499414
Cell 25 SE 2013,4750,1328,71293533.92,-779,9915,10694,5329.02259,2616.863192
Cell 26 NE 2013,4750,1327,71239849.03,108,9388,9280,5294.000754,2405.723966
Cell 26 NNW 2013,4750,1330,71400903.7,192,9581,9389,5743.696992,2615.910862
Cell 26 NW 2013,4750,1328,71293533.92,206,9915,9709,5832.571536,2446.027519
Cell 27 NW 2013,4750,1331,71454588.59,1059,9388,8329,5772.885049,2227.728739
Cell 28 2013,4750,1333,71561958.37,700,9569,8869,4361.459865,2381.031906
Cell 29 2013,4750,1329,71347218.81,1506,9211,7705,6749.835214,1395.356593
Cell 3 NE 2013,4750,1328,71293533.92,-384,8813,9197,7265.493223,1078.994954
Cell 3 NW 2013,4750,1330,71400903.7,-2000,8830,10830,6612.113534,1593.392871
Cell 30 2013,4750,1332,71508273.48,6786,8772,1986,7979.122372,337.4212254
Cell 31 2013,4750,1330,71400903.7,5610,8925,3315,8216.079699,416.3214323
Cell 32 2013,4750,1332,71508273.48,5823,8982,3159,8218.439189,416.6553062
Cell 33 NE 2013,4750,1332,71508273.48,258,9971,9713,6401.417417,2222.700751
Cell 33 SE 2013,4750,1327,71239849.03,-1894,9795,11689,5073.423512,2705.069805
Cell 33 SW 2013,4750,1329,71347218.81,-506,9859,10365,4634.6155,2880.065443
Cell 34 N 2013,4750,1330,71400903.7,-471,8825,9296,6607.142857,1793.75496
Cell 34 NW 2013,4750,1328,71293533.92,-471,9366,9837,6873.146084,1598.771543
Cell 34 SE 2013,4750,1330,71400903.7,-573,9509,10082,6431.453383,2047.781578
Cell 35 2013,4750,1331,71454588.59,854,9982,9128,4636.844478,2702.846092
Cell 37 2013,4750,1331,71454588.59,6008,9288,3280,7755.396694,333.8006785
Cell 38 2013,4750,1328,71293533.92,6613,9040,2427,8215.859187,298.0489881
Cell 39 2013,4750,1330,71400903.7,6692,9004,2312,8358.032331,292.3277278
Cell 4 2013,4750,1330,71400903.7,4531,8716,4185,7470.285714,507.0128526
Cell 40 NE 2013,4750,1332,71508273.48,-1894,9795,11689,4761.536787,2698.464365
Cell 41 N 2013,4750,1328,71293533.92,-1894,9615,11509,6437.637048,2278.678092
Cell 41 NW 2013,4750,1332,71508273.48,-1894,9795,11689,5590.632132,2703.796007
Cell 42 NW 2013,4750,1327,71239849.03,-10,9874,9884,4764.588546,2729.940474
Cell 43 2013,4750,1331,71454588.59,1376,9260,7884,6225.123216,2012.406645
Cell 44 2013,4750,1331,71454588.59,5286,8714,3428,7518.917355,482.0625195
Cell 45 2013,4750,1336,71723013.04,6199,8547,2348,7794.573353,365.3768508
Cell 47 2013,4750,1330,71400903.7,784,9694,8910,6319.567669,2155.712429
Cell 48 2013,4750,1332,71508273.48,1032,8860,7828,6948.177928,1783.393088
Cell 49 2013,4750,1332,71508273.48,1626,9040,7414,6941.612613,1352.482306
Cell 5 2011/12 Summer,4750,1327,71239849.03,-1875,8967,10842,6501.787491,2057.754833
Cell 5 2013,4750,1329,71347218.81,4772,8830,4058,7906.887886,597.8825631
Cell 50 2013,4750,1329,71347218.81,1810,8711,6901,7436.702032,991.4436677
Cell 51 2013,4750,1334,71615643.26,6188,8796,2608,7965.609445,421.7076848
Cell 52 2013,4750,1331,71454588.59,1402,8506,7104,7367.071375,1236.855248
Cell 53 2013,4750,1333,71561958.37,1486,8367,6881,7368.339085,959.4414584
Cell 54 2013,4750,1333,71561958.37,5832,8961,3129,7984.694674,569.584191
Cell 55 2013,4750,1330,71400903.7,6068,8870,2802,7964.079699,528.8866072
Cell 56 2013,4750,1330,71400903.7,6193,9034,2841,7456.852632,423.6505344
Cell 57 2013,4750,1334,71615643.26,1694,8797,7103,6878.865067,1242.115812
Cell 58 2013,4750,1329,71347218.81,5938,8815,2877,8043.704289,387.2999091
Cell 59 2013,4750,1333,71561958.37,6044,9136,3092,7453.490623,399.0642855
Cell 6 2011/12,4750,1330,71400903.7,1489,9386,7897,6920.769173,1674.300971
Cell 6 2013,4750,1331,71454588.59,5628,8794,3166,8068.325319,395.7316215
Cell 6 NE 2011/12,4750,1330,71400903.7,1697,9110,7413,6988.245865,1506.263727
Cell 6 NW 2011/12,4750,1331,71454588.59,851,9386,8535,6057.568745,2411.335183
Cell 6 SW 2011/12,4750,1329,71347218.81,1204,9784,8580,6541.277652,2119.550128
Cell 60 2013,4750,1328,71293533.92,2390,8364,5974,7152.498494,701.278456
Cell 61 2013,4750,1332,71508273.48,3613,8831,5218,7533.760511,689.8344443
Cell 7 2013,4750,1331,71454588.59,5313,9125,3812,8088.737791,600.1054988
Cell 9 NW 2013,4750,1331,71454588.59,-1842,9827,11669,4909.51991,2433.822185
Cell 9 SE 2013,4750,1328,71293533.92,-1842,9827,11669,4597.216114,2424.270917
Cell 9 SW 2013,4750,1331,71454588.59,-1875,9827,11702,5362.858753,2462.985156
Cell R1,4750,1321,70917739.69,1192,8189,6997,5805.866011,2083.635958
Cell R10,4750,1331,71454588.59,4531,8716,4185,7470.482344,506.8730811
Cell R100,4750,1330,71400903.7,1810,8711,6901,7436.993985,991.1280229
Cell R101,4750,1332,71508273.48,5222,8709,3487,7861.689189,425.5084764
Cell R104,4750,1331,71454588.59,1367,9157,7790,6965.709241,2009.550557
Cell R105,4750,1333,71561958.37,1486,8367,6881,7368.339085,959.4414584
Cell R106,4750,1330,71400903.7,1640,9014,7374,7191.260902,1352.749494
Cell R107,4750,1333,71561958.37,5832,8961,3129,7984.684171,569.576828
Cell R11,4750,1329,71347218.81,4772,8830,4058,7906.887886,597.8825631
Cell R111,4750,1330,71400903.7,1522,9474,7952,6868.025564,1900.847575
Cell R112,4750,1330,71400903.7,5773,8707,2934,7605.179699,354.0440396
Cell R113,4750,1334,71615643.26,1694,8797,7103,6878.865067,1242.115812
Cell R114,4750,1331,71454588.59,5938,8815,2877,8042.441022,389.3724479
Cell R117,4750,1332,71508273.48,1686,9931,8245,7147.668919,1542.162599
Cell R118,4750,1329,71347218.81,6193,9034,2841,7457.176072,423.64571
Cell R119,4750,1334,71615643.26,1694,8597,6903,6762.99925,1232.678609
Cell R120,4750,1332,71508273.48,2116,8887,6771,7409.774024,763.2618859
Cell R121,4750,1331,71454588.59,6699,8796,2097,8027.167543,343.7753159
Cell R123,4750,1330,71400903.7,1945,9136,7191,7366.144361,816.9802688
Cell R124,4750,1330,71400903.7,2390,8373,5983,7103.115789,786.6689515
Cell R125,4750,1331,71454588.59,2277,8505,6228,6712.138242,1179.839102
Cell R126,4750,1328,71293533.92,3613,8831,5218,7441.760542,680.353891
Cell R15,4750,1325,71132479.25,-1970,9374,11344,5173.154717,2237.648123
Cell R16,4750,1330,71400903.7,-1842,9827,11669,4906.509774,2434.30594
Cell R17,4750,1330,71400903.7,771,9230,8459,7132.803008,1571.282829
Cell R18,4750,1340,71937752.6,1571,8837,7266,6313.363433,1693.742191
Cell R19,4750,1329,71347218.81,1373,9275,7902,6806.679458,1748.772977
Cell R20,4750,1328,71293533.92,2251,8716,6465,7102.729669,1112.134554
Cell R21,4750,1329,71347218.81,2520,8838,6318,7661.406321,824.4743482
Cell R22,4750,1329,71347218.81,6613,8733,2120,8053.958616,352.1012094
Cell R24,4750,1331,71454588.59,-1875,9827,11702,5873.842224,2291.774533
Cell R25,4750,1328,71293533.92,527,9784,9257,3803.658133,2422.92956
Cell R26,4750,1330,71400903.7,851,9386,8535,6046.433835,2412.184273
Cell R27,4750,1331,71454588.59,1421,9386,7965,6993.768595,1684.125929
Cell R28,4750,1332,71508273.48,1326,9773,8447,6103.305556,2183.413519
Cell R29,4750,1328,71293533.92,1465,9773,8308,6933.341114,1676.136335
Cell R30,4750,1330,71400903.7,3649,8751,5102,7440.078195,730.2464595
Cell R31,4750,1329,71347218.81,5511,8751,3240,7892.326561,454.862602
Cell R35,4750,1327,71239849.03,-1875,8967,10842,6501.787491,2057.754833
Cell R36,4750,1331,71454588.59,513,9522,9009,6302.851991,2406.974781
Cell R37,4750,1332,71508273.48,-195,9328,9523,6533.655405,1950.714712
Cell R38,4750,1327,71239849.03,1170,9231,8061,5919.064808,2196.840186
Cell R39,4750,1332,71508273.48,1828,9366,7538,6916.524775,1369.452268
Cell R40,4750,1330,71400903.7,2159,8808,6649,7152.117293,1032.616158
Cell R46,4750,1327,71239849.03,-779,9915,10694,5401.097965,2662.699778
Cell R47,4750,1329,71347218.81,206,9915,9709,5834.259594,2445.8808
Cell R48,4750,1326,71186164.14,108,9388,9280,5300.033183,2404.376363
Cell R49,4750,1331,71454588.59,1059,9388,8329,5772.885049,2227.728739
Cell R5,4750,1331,71454588.59,-1970,8743,10713,5570.403456,2069.812904
Cell R50,4750,1334,71615643.26,700,9569,8869,4359.42054,2381.303597
Cell R51,4750,1326,71186164.14,1506,9211,7705,6768.362745,1374.70801
Cell R52,4750,1329,71347218.81,2443,8651,6208,7352.386757,816.5105374
Cell R53,4750,1330,71400903.7,3421,8616,5195,7494.509774,471.0626528
Cell R54,4750,1329,71347218.81,5610,8925,3315,8216.103837,416.4771021
Cell R58,4750,1329,71347218.81,-108,9942,10050,4690.147479,2701.001543
Cell R59,4750,1331,71454588.59,258,9971,9713,6400.896319,2223.454233
Cell R6,4750,1332,71508273.48,1187,8730,7543,7254.273273,1358.684479
Cell R60,4750,1328,71293533.92,-471,9366,9837,6870.652108,1603.09591
Cell R61,4750,1331,71454588.59,854,9982,9128,4636.844478,2702.846092
Cell R62,4750,1330,71400903.7,716,9358,8642,4613.008271,2460.131854
Cell R63,4750,1327,71239849.03,716,8882,8166,6513.433308,1704.498066
Cell R64,4750,1329,71347218.81,3349,8458,5109,7607.034612,451.6420325
Cell R65,4750,1333,71561958.37,6786,8772,1986,7978.87847,337.4120789
Cell R66,4750,1328,71293533.92,5718,8955,3237,8384.987952,241.1012414
Cell R69,4750,1329,71347218.81,-506,9859,10365,4634.6155,2880.065443
Cell R7,4750,1330,71400903.7,-2000,8830,10830,6612.113534,1593.392871
Cell R70,4750,1327,71239849.03,-1894,9795,11689,5073.423512,2705.069805
Cell R71,4750,1331,71454588.59,-573,9509,10082,6431.604808,2047.019618
Cell R72,4750,1329,71347218.81,-10,9509,9519,5194.891648,2688.067611
Cell R73,4750,1328,71293533.92,355,9829,9474,5382.86747,2665.774966
Cell R74,4750,1329,71347218.81,1154,9341,8187,6540.721595,1987.254192
Cell R75,4750,1331,71454588.59,6008,9288,3280,7755.396694,333.8006785
Cell R76,4750,1330,71400903.7,6613,8790,2177,8089.593985,316.9029556
Cell R77,4750,1329,71347218.81,6613,9040,2427,8215.76298,297.9574615
Cell R8,4750,1328,71293533.92,-384,8813,9197,7265.51506,1090.369982
Cell R80,4750,1330,71400903.7,-1894,9795,11689,4761.994737,2698.682488
Cell R81,4750,1333,71561958.37,-204,9583,9787,6499.153038,2099.08438
Cell R82,4750,1327,71239849.03,-10,9874,9884,4764.588546,2729.940474
Cell R83,4750,1329,71347218.81,422,9874,9452,5372.772009,2505.314574
Cell R84,4750,1331,71454588.59,1211,8712,7501,4872.048084,2378.504075
Cell R85,4750,1331,71454588.59,1376,9260,7884,6222.275733,2013.126307
Cell R86,4750,1331,71454588.59,5782,8431,2649,7476.290008,418.6452732
Cell R87,4750,1335,71669328.15,6199,8547,2348,7794.289888,365.366791
Cell R9,4750,1332,71508273.48,-384,8813,9197,7247.374625,1046.710609
Cell R90,4750,1330,71400903.7,784,9694,8910,6319.567669,2155.712429
Cell R91,4750,1332,71508273.48,1032,8860,7828,6948.177928,1783.393088
Cell R92,4750,1330,71400903.7,1249,9683,8434,4040.518045,2263.372258
Cell R93,4750,1333,71561958.37,1626,9040,7414,6938.76144,1355.973529
Cell R97,4750,1327,71239849.03,1284,9318,8034,6802.607385,1877.024649
Cell R98,4750,1332,71508273.48,1316,8549,7233,7546.03003,968.1725219
Cell R99,4750,1331,71454588.59,1402,8506,7104,7367.071375,1236.855248
Cell S102,4750,1335,71669328.15,5785,8935,3150,8036.141573,421.9690123
Cell S108,4750,1330,71400903.7,6068,8870,2802,7964.079699,528.8866072
Cell S13,4750,1328,71293533.92,6084,9125,3041,8154.179217,456.5626576
Cell S14,4750,1331,71454588.59,5313,9125,3812,8088.737791,600.1054988
Cell S2,4750,1331,71454588.59,5628,8794,3166,8068.325319,395.7316215
Cell S23,4750,1329,71347218.81,5723,8842,3119,8155.991723,474.4587958
Cell S32,4750,1329,71347218.81,5511,8938,3427,7954.221971,479.8675368
Cell S33,4750,1331,71454588.59,5452,8876,3424,7934.791886,441.5719541
Cell S34,4750,1330,71400903.7,6616,8848,2232,8061.158647,367.5064968
Cell S41,4750,1330,71400903.7,5127,8751,3624,7724.900752,386.6549421
Cell S42,4750,1332,71508273.48,6899,8915,2016,8159.056306,361.746405
Cell S44,4750,1330,71400903.7,6968,8939,1971,8189.896992,316.9093237
Cell S56,4750,1330,71400903.7,5634,8793,3159,7974.796241,507.8224734
Cell S67,4750,1332,71508273.48,5823,8982,3159,8218.439189,416.6553062
Cell S78,4750,1330,71400903.7,6692,9004,2312,8358.032331,292.3277278
Cell S88,4750,1332,71508273.48,6375,8915,2540,8112.963964,401.2579602
Cell S94,4750,1332,71508273.48,6943,8935,1992,8100.798048,311.3034048
Cell S95,4750,1336,71723013.04,6188,8796,2608,7965.202096,421.6954866
W287,4750,1329,71347218.81,807,9196,8389,4001.995485,1995.277123
W295,4750,1329,71347218.81,1643,8825,7182,7086.580135,1436.745963
W338,4750,1331,71454588.59,855,9866,9011,4364.253193,2547.145278
W342,4750,1333,71561958.37,1263,8356,7093,5375.735934,2123.563827
W345,4750,1329,71347218.81,3683,8605,4922,7469.643341,571.3333822
W387,4750,1330,71400903.7,1191,9937,8746,5767.583459,2465.543692
W393,4750,1330,71400903.7,1196,9521,8325,6353.203008,1945.503871
W440,4750,1326,71186164.14,1125,9047,7922,5462.329563,2239.822218
W441,4750,1329,71347218.81,2581,8634,6053,7058.865312,937.9940121
W445,4750,1331,71454588.59,2376,8498,6122,6771.647633,936.8214703
W500,4750,1327,71239849.03,1427,8823,7396,6147.607385,1849.227989
1,5000,1473,79077842.97,1187,8730,7543,7127.00611,1520.989973
2,5000,1469,78863103.41,1591,8837,7246,6236.189244,1669.816586
3,5000,1477,79292582.53,1373,9275,7902,7253.664861,1047.228597
4,5000,1474,79131527.86,1834,8716,6882,7089.284939,1108.740148
5,5000,1477,79292582.53,-1875,9245,11120,6460.578876,2067.662795
6,5000,1471,78970473.19,1470,9386,7916,6804.186268,1787.056896
7,5000,1473,79077842.97,1476,9773,8297,6748.736592,1679.757628
8,5000,1478,79346267.42,1423,8838,7415,6821.883627,1461.136525
9,5000,1476,79238897.64,6027,8751,2724,7849.941734,350.9142309
10,5000,1473,79077842.97,448,9915,9467,5858.186015,2491.180997
11,5000,1475,79185212.75,-195,9388,9583,5265.258983,2411.275748
12,5000,1474,79131527.86,700,9569,8869,4324.774763,2388.238981
13,5000,1474,79131527.86,1506,9211,7705,6718.808684,1474.872983
14,5000,1478,79346267.42,4359,8852,4493,7945.662382,677.8643554
16,5000,1475,79185212.75,-506,9859,10365,4803.867797,2882.581749
17,5000,1475,79185212.75,-471,9366,9837,6791.265085,1662.480308
18,5000,1472,79024158.08,854,9982,9128,4491.025815,2670.808577
19,5000,1474,79131527.86,716,9358,8642,4720.609227,2469.938469
20,5000,1475,79185212.75,6008,9288,3280,7745.044068,341.8703354
21,5000,1473,79077842.97,6613,9040,2427,8214.917176,294.8178651
22,5000,1471,78970473.19,-1894,9795,11689,4726.588035,2737.741935
23,5000,1477,79292582.53,-10,9874,9884,4937.381855,2725.130924
24,5000,1474,79131527.86,1032,8860,7828,6869.912483,1861.873479
25,5000,1475,79185212.75,1626,9284,7658,6915.188475,1397.158787
26,5000,1471,78970473.19,6199,8547,2348,7790.959211,377.0228284
27,5000,1480,79453637.2,1316,8549,7233,7451.331081,1182.482643
28,5000,1478,79346267.42,1486,8964,7478,7290.102165,1154.321644
29,5000,1473,79077842.97,1810,8711,6901,7394.824847,1073.220262
31,5000,1472,79024158.08,1966,9474,7508,7575.148098,779.5572469
32,5000,1475,79185212.75,1694,8797,7103,6907.317288,1217.15836
33,5000,1472,79024158.08,6135,9347,3212,7461.46875,430.929787
34,5000,1473,79077842.97,2390,8364,5974,7106.748133,707.0418115
10A,5000,1472,79024158.08,44,9915,9871,5694.558424,2520.363821
10NE,5000,1475,79185212.75,-159,9915,10074,5639.442712,2672.596953
10NW,5000,1473,79077842.97,513,9522,9009,6137.156823,2491.405292
10SW,5000,1473,79077842.97,-779,9915,10694,5380.680244,2640.215216
11NE,5000,1473,79077842.97,-195,9328,9523,6450.630007,2060.626902
11NW,5000,1474,79131527.86,-195,9388,9583,5447.341927,2581.029218
11SE,5000,1468,78809418.52,1059,9388,8329,5793.486376,2216.344388
17NW,5000,1469,78863103.41,258,9971,9713,6393.04629,2195.29876
17SE,5000,1473,79077842.97,-782,9509,10291,6365.412763,2108.096395
17SW,5000,1475,79185212.75,-1894,9795,11689,5111.148475,2690.553222
22S,5000,1472,79024158.08,-1894,9795,11689,4595.85462,2741.47096
23S,5000,1473,79077842.97,1090,9773,8683,3768.029192,2136.469927
24S,5000,1474,79131527.86,1032,9336,8304,6859.885346,1868.108542
27A,5000,1474,79131527.86,1284,9694,8410,6837.054274,1882.531729
2A,5000,1473,79077842.97,1571,8957,7386,6292.992532,1716.314731
5NE,5000,1471,78970473.19,-1842,9827,11669,4585.329028,2422.733083
5NW,5000,1470,78916788.3,-1875,9827,11702,5306.482993,2463.779621
5SE,5000,1475,79185212.75,234,9784,9550,3870.735593,2460.159096
6NE,5000,1473,79077842.97,1665,9386,7721,6976.716904,1505.143848
6NW,5000,1473,79077842.97,771,9386,8615,5988.447386,2466.412935
6SW,5000,1476,79238897.64,1204,9784,8580,6561.7771,2096.153041
Cell 1 2011/12,5000,1473,79077842.97,1187,8730,7543,7127.00611,1520.989973
Cell 1 SW 2013,5000,1472,79024158.08,-1970,9374,11344,5211.785326,2234.183625
Cell 10 2011/12,5000,1473,79077842.97,448,9915,9467,5858.186015,2491.180997
Cell 10 NE 2011/12,5000,1475,79185212.75,-159,9915,10074,5639.442712,2672.596953
Cell 10 NW 2011/12,5000,1473,79077842.97,513,9522,9009,6137.156823,2491.405292
Cell 10 SE 2013,5000,1473,79077842.97,771,9386,8615,5988.447386,2466.412935
Cell 10 SW 2011/12,5000,1473,79077842.97,-779,9915,10694,5380.680244,2640.215216
Cell 10-A 2011/12,5000,1472,79024158.08,44,9915,9871,5694.558424,2520.363821
Cell 11 NE 2011/12,5000,1473,79077842.97,-195,9328,9523,6450.630007,2060.626902
Cell 11 NW 2013,5000,1476,79238897.64,1571,8837,7266,6309.248645,1681.338506
Cell 11 SW 2013,5000,1476,79238897.64,1530,9386,7856,6901.380081,1756.364639
Cell 12 2013,5000,1470,78916788.3,1476,9773,8297,6748.530612,1677.510978
Cell 13 2013,5000,1476,79238897.64,1422,8838,7416,6739.200542,1505.634226
Cell 14 2013,5000,1475,79185212.75,6150,8733,2583,8039.48339,367.2210625
Cell 15 2013,5000,1474,79131527.86,5348,8876,3528,7949.156038,485.1227013
Cell 15-A 2013,5000,1478,79346267.42,5452,8876,3424,7957.530447,442.8350861
Cell 16 2013,5000,1473,79077842.97,5452,8848,3396,7999.864223,411.3103437
Cell 17 NW 2011/12,5000,1469,78863103.41,258,9971,9713,6393.04629,2195.29876
Cell 17 NW 2013,5000,1473,79077842.97,-1875,9827,11702,5868.660557,2300.71511
Cell 17 SE 2013,5000,1474,79131527.86,513,9522,9009,6134.09905,2493.323441
Cell 17 SW 2013,5000,1471,78970473.19,-1875,9086,10961,6476.581917,2059.378952
Cell 18 2011/12,5000,1472,79024158.08,854,9982,9128,4491.025815,2670.808577
Cell 18 NE 2013,5000,1471,78970473.19,1204,9784,8580,6586.39225,2082.276521
Cell 18 NW 2013,5000,1472,79024158.08,234,9784,9550,3865.141984,2433.379307
Cell 18 SE 2013,5000,1473,79077842.97,-195,9328,9523,6450.630007,2060.626902
Cell 18 SSE 2013,5000,1471,78970473.19,-195,9388,9583,5394.475867,2548.363676
Cell 19 NW 2013,5000,1471,78970473.19,1421,9386,7965,6859.546567,1788.464856
Cell 2 2011/12,5000,1469,78863103.41,1591,8837,7246,6236.189244,1669.816586
Cell 2 NE 2013,5000,1472,79024158.08,-2000,8957,10957,6334.027174,1772.003735
Cell 2 SW 2013,5000,1473,79077842.97,1187,8730,7543,7131.746775,1516.06274
Cell 20 2013,5000,1476,79238897.64,1465,9773,8308,6871.978997,1717.654439
Cell 21 2013,5000,1475,79185212.75,2159,9211,7052,7162.805424,1029.958338
Cell 22 2013,5000,1476,79238897.64,6717,8751,2034,7861.7229,315.6752835
Cell 23 2013,5000,1475,79185212.75,6899,8915,2016,8160.735593,362.3334197
Cell 24 2013,5000,1472,79024158.08,6616,8848,2232,8060.075408,371.6669345
Cell 25 NE 2013,5000,1473,79077842.97,448,9915,9467,5858.186015,2491.180997
Cell 25 SE 2013,5000,1474,79131527.86,-779,9915,10694,5381.144505,2639.379614
Cell 26 NE 2013,5000,1475,79185212.75,-195,9388,9583,5265.258983,2411.275748
Cell 26 NNW 2013,5000,1475,79185212.75,-159,9915,10074,5639.442712,2672.596953
Cell 26 NW 2013,5000,1472,79024158.08,44,9915,9871,5694.558424,2520.363821
Cell 27 NW 2013,5000,1468,78809418.52,1059,9388,8329,5793.486376,2216.344388
Cell 28 2013,5000,1473,79077842.97,700,9569,8869,4322.157502,2386.935401
Cell 29 2013,5000,1474,79131527.86,1506,9211,7705,6718.065807,1474.329371
Cell 3 NE 2013,5000,1475,79185212.75,-384,8813,9197,7251.335593,1056.660699
Cell 3 NW 2013,5000,1475,79185212.75,-2000,9096,11096,6568.987797,1631.413343
Cell 30 2013,5000,1473,79077842.97,6786,8772,1986,7984.238968,345.574732
Cell 31 2013,5000,1476,79238897.64,5610,8925,3315,8205.373306,417.5433195
Cell 32 2013,5000,1476,79238897.64,5823,8982,3159,8222.944444,410.7788981
Cell 33 NE 2013,5000,1469,78863103.41,258,9971,9713,6393.04629,2195.29876
Cell 33 SE 2013,5000,1475,79185212.75,-1894,9795,11689,5111.148475,2690.553222
Cell 33 SW 2013,5000,1474,79131527.86,-506,9859,10365,4720.566486,2867.379843
Cell 34 N 2013,5000,1474,79131527.86,-471,9455,9926,6583.921981,1836.497177
Cell 34 NW 2013,5000,1475,79185212.75,-471,9366,9837,6791.265085,1662.480308
Cell 34 SE 2013,5000,1474,79131527.86,-782,9509,10291,6362.799186,2108.290208
Cell 35 2013,5000,1479,79399952.31,854,9982,9128,4580.693036,2690.487026
Cell 37 2013,5000,1471,78970473.19,5141,9288,4147,7744.931339,345.1143753
Cell 38 2013,5000,1473,79077842.97,6613,9040,2427,8222.986422,295.0774321
Cell 39 2013,5000,1475,79185212.75,6692,9040,2348,8352.229153,294.5960205
Cell 4 2013,5000,1473,79077842.97,4531,8716,4185,7480.327223,505.6357376
Cell 40 NE 2013,5000,1475,79185212.75,-1894,9795,11689,4684.734237,2733.392951
Cell 41 N 2013,5000,1474,79131527.86,-1894,9615,11509,6317.695387,2331.325968
Cell 41 NW 2013,5000,1473,79077842.97,-1894,9795,11689,5604.75017,2670.287994
Cell 42 NW 2013,5000,1473,79077842.97,-10,9874,9884,4909.431093,2724.160695
Cell 43 2013,5000,1476,79238897.64,1302,9341,8039,6182.421409,2045.513005
Cell 44 2013,5000,1477,79292582.53,5286,9288,4002,7525.968179,494.6558432
Cell 45 2013,5000,1472,79024158.08,6199,8547,2348,7791.870245,377.061587
Cell 47 2013,5000,1476,79238897.64,784,9694,8910,6380.272358,2135.920731
Cell 48 2013,5000,1473,79077842.97,1032,9336,8304,6861.319756,1865.525975
Cell 49 2013,5000,1475,79185212.75,1626,9284,7658,6915.188475,1397.158787
Cell 5 2011/12 Summer,5000,1471,78970473.19,-1875,9086,10961,6476.581917,2059.378952
Cell 5 2013,5000,1476,79238897.64,4772,8830,4058,7901.911247,604.9620435
Cell 50 2013,5000,1473,79077842.97,1810,8711,6901,7394.824847,1073.220262
Cell 51 2013,5000,1477,79292582.53,6188,8935,2747,7968.346649,419.47
Cell 52 2013,5000,1475,79185212.75,1402,8549,7147,7314.791864,1342.740393
Cell 53 2013,5000,1479,79399952.31,1486,8964,7478,7290.020284,1153.935634
Cell 54 2013,5000,1474,79131527.86,5832,8961,3129,7986.833786,561.8017465
Cell 55 2013,5000,1481,79507322.09,6068,8870,2802,7966.303174,530.1593271
Cell 56 2013,5000,1475,79185212.75,6135,9347,3212,7462.012203,430.5640587
Cell 57 2013,5000,1472,79024158.08,1694,8797,7103,6906.009511,1218.111991
Cell 58 2013,5000,1478,79346267.42,5938,8815,2877,8032.806495,408.5433004
Cell 59 2013,5000,1471,78970473.19,6044,9347,3303,7457.24949,408.2778005
Cell 6 2011/12,5000,1471,78970473.19,1470,9386,7916,6804.186268,1787.056896
Cell 6 2013,5000,1472,79024158.08,5628,8824,3196,8083.468071,395.6539531
Cell 6 NE 2011/12,5000,1473,79077842.97,1665,9386,7721,6976.716904,1505.143848
Cell 6 NW 2011/12,5000,1473,79077842.97,771,9386,8615,5988.447386,2466.412935
Cell 6 SW 2011/12,5000,1476,79238897.64,1204,9784,8580,6561.7771,2096.153041
Cell 60 2013,5000,1474,79131527.86,2390,8364,5974,7113.852103,743.0236458
Cell 61 2013,5000,1473,79077842.97,3613,8831,5218,7547.467753,679.6648623
Cell 7 2013,5000,1475,79185212.75,5313,9125,3812,8083.094237,597.786255
Cell 9 NW 2013,5000,1469,78863103.41,-1842,9827,11669,4858.027229,2430.723426
Cell 9 SE 2013,5000,1471,78970473.19,-1842,9827,11669,4585.329028,2422.733083
Cell 9 SW 2013,5000,1471,78970473.19,-1875,9827,11702,5305.543168,2463.205603
Cell R1,5000,1479,79399952.31,1192,8189,6997,5814.248141,2048.577836
Cell R10,5000,1474,79131527.86,4531,8716,4185,7480.618725,505.5879872
Cell R100,5000,1474,79131527.86,1470,8711,7241,7390.805292,1083.890827
Cell R101,5000,1472,79024158.08,5222,8709,3487,7861.824728,429.4649689
Cell R104,5000,1474,79131527.86,1367,9157,7790,6922.563772,2045.27498
Cell R105,5000,1479,79399952.31,1486,8964,7478,7290.020284,1153.935634
Cell R106,5000,1475,79185212.75,1628,9014,7386,7207.905763,1334.496538
Cell R107,5000,1474,79131527.86,5832,8961,3129,7986.833786,561.8017465
Cell R11,5000,1475,79185212.75,4772,8830,4058,7901.610847,605.0570236
Cell R111,5000,1473,79077842.97,1480,9474,7994,6825.305499,1957.147694
Cell R112,5000,1478,79346267.42,3557,8707,5150,7592.039242,409.5480394
Cell R113,5000,1472,79024158.08,1694,8797,7103,6906.009511,1218.111991
Cell R114,5000,1478,79346267.42,5938,8815,2877,8032.806495,408.5433004
Cell R117,5000,1474,79131527.86,1686,9931,8245,7046.740841,1651.606304
Cell R118,5000,1476,79238897.64,6135,9347,3212,7461.97561,430.4204734
Cell R119,5000,1475,79185212.75,1694,8696,7002,6786.12678,1221.256872
Cell R120,5000,1479,79399952.31,2116,8887,6771,7409.975659,774.7234038
Cell R121,5000,1478,79346267.42,6699,8831,2132,8029.812585,347.1132675
Cell R123,5000,1480,79453637.2,1605,9136,7531,7314.254054,937.1453695
Cell R124,5000,1475,79185212.75,2390,8373,5983,7062.355254,811.3731094
Cell R125,5000,1476,79238897.64,2277,8767,6490,6732.381436,1164.007961
Cell R126,5000,1475,79185212.75,3613,8831,5218,7456.221017,677.5052412
Cell R15,5000,1472,79024158.08,-1970,9374,11344,5211.785326,2234.183625
Cell R16,5000,1472,79024158.08,-1842,9827,11669,4848.737772,2430.905175
Cell R17,5000,1475,79185212.75,771,9230,8459,7031.300339,1708.536025
Cell R18,5000,1474,79131527.86,1571,8837,7266,6313.357531,1683.320965
Cell R19,5000,1472,79024158.08,1373,9455,8082,6777.476223,1751.209855
Cell R20,5000,1476,79238897.64,1923,8716,6793,7114.601626,1130.7691
Cell R21,5000,1476,79238897.64,2057,8838,6781,7612.410569,946.7990544
Cell R22,5000,1475,79185212.75,6150,8733,2583,8039.48339,367.2210625
Cell R24,5000,1473,79077842.97,-1875,9827,11702,5868.660557,2300.71511
Cell R25,5000,1470,78916788.3,234,9784,9550,3861.306122,2432.740218
Cell R26,5000,1473,79077842.97,771,9386,8615,5993.754922,2460.572158
Cell R27,5000,1471,78970473.19,1421,9386,7965,6859.546567,1788.464856
Cell R28,5000,1477,79292582.53,1326,9773,8447,6077.526066,2189.888276
Cell R29,5000,1476,79238897.64,1465,9773,8308,6871.978997,1717.654439
Cell R30,5000,1476,79238897.64,3649,8751,5102,7446.649051,751.0178965
Cell R31,5000,1474,79131527.86,5511,8751,3240,7891.867707,449.4807053
Cell R35,5000,1471,78970473.19,-1875,9086,10961,6476.581917,2059.378952
Cell R36,5000,1474,79131527.86,513,9522,9009,6134.09905,2493.323441
Cell R37,5000,1473,79077842.97,-195,9328,9523,6450.630007,2060.626902
Cell R38,5000,1475,79185212.75,981,9231,8250,5840.585085,2247.433536
Cell R39,5000,1472,79024158.08,1535,9366,7831,6875.649457,1431.942973
Cell R40,5000,1474,79131527.86,2159,9211,7052,7162.419946,1030.201284
Cell R46,5000,1474,79131527.86,-779,9915,10694,5389.537992,2685.102089
Cell R47,5000,1472,79024158.08,44,9915,9871,5694.558424,2520.363821
Cell R48,5000,1475,79185212.75,-195,9388,9583,5265.258983,2411.275748
Cell R49,5000,1469,78863103.41,1059,9388,8329,5790.94486,2217.728749
Cell R5,5000,1473,79077842.97,-1970,8743,10713,5575.911066,2085.837015
Cell R50,5000,1473,79077842.97,700,9569,8869,4321.623218,2387.232501
Cell R51,5000,1473,79077842.97,1506,9211,7705,6736.467753,1461.132499
Cell R52,5000,1472,79024158.08,2443,8679,6236,7336.048234,829.6200477
Cell R53,5000,1477,79292582.53,3421,8616,5195,7485.91063,499.7543948
Cell R54,5000,1475,79185212.75,5610,8925,3315,8205.302373,417.6759454
Cell R58,5000,1473,79077842.97,-108,9942,10050,4742.025119,2738.416808
Cell R59,5000,1470,78916788.3,258,9971,9713,6394.164626,2194.970484
Cell R6,5000,1473,79077842.97,1187,8730,7543,7131.746775,1516.06274
Cell R60,5000,1475,79185212.75,-471,9366,9837,6791.265085,1662.480308
Cell R61,5000,1477,79292582.53,854,9982,9128,4582.626947,2691.117319
Cell R62,5000,1476,79238897.64,716,9358,8642,4648.726965,2468.212678
Cell R63,5000,1476,79238897.64,716,8882,8166,6502.934959,1698.355386
Cell R64,5000,1479,79399952.31,3349,8458,5109,7611.336038,452.1825324
Cell R65,5000,1473,79077842.97,6786,8772,1986,7984.238968,345.574732
Cell R66,5000,1475,79185212.75,5718,8955,3237,8375.95322,253.3025949
Cell R69,5000,1474,79131527.86,-506,9859,10365,4720.566486,2867.379843
Cell R7,5000,1474,79131527.86,-2000,9096,11096,6570.729308,1630.595493
Cell R70,5000,1475,79185212.75,-1894,9795,11689,5111.148475,2690.553222
Cell R71,5000,1474,79131527.86,-782,9509,10291,6362.799186,2108.290208
Cell R72,5000,1476,79238897.64,-10,9509,9519,5241.273035,2677.620633
Cell R73,5000,1473,79077842.97,5,9879,9874,5252.854039,2702.814109
Cell R74,5000,1471,78970473.19,1140,9341,8201,6486.777702,2035.089114
Cell R75,5000,1471,78970473.19,5141,9288,4147,7744.931339,345.1143753
Cell R76,5000,1478,79346267.42,6613,8790,2177,8089.830853,318.6123644
Cell R77,5000,1473,79077842.97,6613,9040,2427,8222.986422,295.0774321
Cell R8,5000,1477,79292582.53,-384,8813,9197,7241.94719,1083.78202
Cell R80,5000,1475,79185212.75,-1894,9795,11689,4684.734237,2733.392951
Cell R81,5000,1470,78916788.3,-498,9583,10081,6496.364626,2103.67668
Cell R82,5000,1473,79077842.97,-10,9874,9884,4909.431093,2724.160695
Cell R83,5000,1474,79131527.86,422,9874,9452,5408.002714,2499.26035
Cell R84,5000,1473,79077842.97,1126,8839,7713,4923.156144,2396.767047
Cell R85,5000,1476,79238897.64,1302,9341,8039,6182.421409,2045.513005
Cell R86,5000,1475,79185212.75,5782,8547,2765,7485.32678,418.1729238
Cell R87,5000,1472,79024158.08,6199,8547,2348,7791.870245,377.061587
Cell R9,5000,1477,79292582.53,-384,8813,9197,7246.962085,1046.014902
Cell R90,5000,1476,79238897.64,784,9694,8910,6380.272358,2135.920731
Cell R91,5000,1473,79077842.97,1032,9336,8304,6861.319756,1865.525975
Cell R92,5000,1475,79185212.75,1113,9683,8570,4170.465763,2321.86558
Cell R93,5000,1475,79185212.75,1626,9284,7658,6915.188475,1397.158787
Cell R97,5000,1473,79077842.97,1284,9318,8034,6829.663951,1865.959808
Cell R98,5000,1479,79399952.31,1316,8549,7233,7455.348884,1172.740105
Cell R99,5000,1474,79131527.86,1402,8549,7147,7315.039349,1343.162161
Cell S102,5000,1473,79077842.97,5785,8935,3150,8038.852682,420.7503199
Cell S108,5000,1480,79453637.2,6068,8870,2802,7965.908108,530.1204335
Cell S13,5000,1475,79185212.75,6073,9125,3052,8151.616949,470.9735338
Cell S14,5000,1475,79185212.75,5313,9125,3812,8083.094237,597.786255
Cell S2,5000,1472,79024158.08,5628,8824,3196,8083.468071,395.6539531
Cell S23,5000,1477,79292582.53,5723,8842,3119,8143.708869,491.7552377
Cell S32,5000,1475,79185212.75,5511,8938,3427,7956.341017,484.8549498
Cell S33,5000,1478,79346267.42,5452,8876,3424,7957.530447,442.8350861
Cell S34,5000,1472,79024158.08,6616,8848,2232,8060.075408,371.6669345
Cell S41,5000,1476,79238897.64,5127,8751,3624,7708.469512,414.6229011
Cell S42,5000,1475,79185212.75,6899,8915,2016,8160.735593,362.3334197
Cell S44,5000,1477,79292582.53,6649,8939,2290,8191.076506,316.8235375
Cell S56,5000,1475,79185212.75,5634,8793,3159,7983.404068,501.7459693
Cell S67,5000,1475,79185212.75,5823,8982,3159,8223.541017,410.2784373
Cell S78,5000,1476,79238897.64,6692,9040,2348,8352.348916,294.5321255
Cell S88,5000,1479,79399952.31,6375,8915,2540,8104.281947,401.8179273
Cell S94,5000,1480,79453637.2,6943,8935,1992,8098.176351,310.3641268
Cell S95,5000,1476,79238897.64,6188,8935,2747,7968.186314,419.566827
W287,5000,1474,79131527.86,807,9196,8389,4009.48711,2033.35566
W295,5000,1471,78970473.19,1643,8825,7182,7063.825969,1492.927578
W338,5000,1473,79077842.97,692,9866,9174,4245.363204,2539.749205
W342,5000,1471,78970473.19,1245,8356,7111,5349.114208,2166.535529
W345,5000,1476,79238897.64,3045,8605,5560,7461.224255,598.8073551
W387,5000,1470,78916788.3,1191,9937,8746,5778.439456,2445.553524
W393,5000,1472,79024158.08,1152,9522,8370,6296.133152,1989.7298
W440,5000,1473,79077842.97,1125,9047,7922,5523.22539,2257.201222
W441,5000,1475,79185212.75,2391,8634,6243,7029.530169,956.3225424
W445,5000,1474,79131527.86,2376,8498,6122,6770.361601,951.7732398
W500,5000,1473,79077842.97,1427,8823,7396,6170.775967,1846.427842
1,5250,1621,87023206.69,1187,9230,8043,7007.83467,1639.147294
2,5250,1624,87184261.36,1571,9110,7539,6198.719212,1708.322238
3,5250,1622,87076891.58,1373,9275,7902,7199.318742,1134.860787
4,5250,1624,87184261.36,1834,8716,6882,7095.021552,1114.94318
5,5250,1623,87130576.47,-1875,9245,11120,6425.473814,2097.196553
6,5250,1624,87184261.36,1470,9386,7916,6676.426108,1898.356752
7,5250,1621,87023206.69,1418,9773,8355,6673.706354,1736.302212
8,5250,1621,87023206.69,1422,8838,7416,6854.078964,1460.658009
9,5250,1625,87237946.25,6027,8751,2724,7849.332308,367.5074216
10,5250,1621,87023206.69,448,9915,9467,5728.927205,2543.628211
11,5250,1632,87613740.48,-195,9388,9583,5284.415441,2421.215638
12,5250,1633,87667425.37,700,9569,8869,4323.739743,2398.433549
13,5250,1625,87237946.25,1506,9211,7705,6678.345231,1544.698429
14,5250,1623,87130576.47,4359,8852,4493,7944.829945,666.5357738
16,5250,1629,87452685.81,-506,9976,10482,4876.000614,2892.088868
17,5250,1624,87184261.36,-471,9942,10413,6753.901478,1701.828508
18,5250,1624,87184261.36,854,9982,9128,4523.815271,2656.6804
19,5250,1628,87399000.92,716,9358,8642,4749.850123,2467.387071
20,5250,1626,87291631.14,5141,9288,4147,7729.877614,358.7881944
21,5250,1623,87130576.47,6613,9040,2427,8218.65496,294.5723079
22,5250,1622,87076891.58,-1894,9795,11689,4749.168927,2716.385035
23,5250,1618,86862152.02,-10,9874,9884,5052.470334,2712.086218
24,5250,1627,87345316.03,1032,9336,8304,6778.535341,1934.454362
25,5250,1622,87076891.58,1418,9284,7866,6885.933416,1469.089791
26,5250,1626,87291631.14,6199,8547,2348,7789.557811,388.740986
27,5250,1625,87237946.25,1316,8549,7233,7377.929231,1312.563037
28,5250,1627,87345316.03,1401,9014,7613,7221.709896,1303.494176
29,5250,1628,87399000.92,1454,8711,7257,7356.802826,1163.210629
31,5250,1624,87184261.36,1849,9931,8082,7540.074507,901.4693814
32,5250,1623,87130576.47,1694,8797,7103,6936.850893,1186.51134
33,5250,1627,87345316.03,6135,9347,3212,7461.287646,439.9295575
34,5250,1625,87237946.25,2390,8364,5974,7072.734154,760.6404747
10A,5250,1626,87291631.14,-268,9915,10183,5536.933579,2606.36085
10NE,5250,1624,87184261.36,-195,9915,10110,5545.948892,2725.617376
10NW,5250,1626,87291631.14,-1428,9522,10950,6009.354244,2536.657838
10SW,5250,1631,87560055.59,-779,9915,10694,5431.459841,2664.863354
11NE,5250,1623,87130576.47,-195,9328,9523,6386.49353,2146.136037
11NW,5250,1622,87076891.58,-195,9388,9583,5377.915536,2597.542484
11SE,5250,1624,87184261.36,900,9388,8488,5790.982143,2239.020943
17NW,5250,1624,87184261.36,258,9971,9713,6385.601601,2166.120139
17SE,5250,1625,87237946.25,-782,9509,10291,6276.432615,2152.523236
17SW,5250,1631,87560055.59,-1894,9795,11689,5168.031882,2671.945238
22S,5250,1628,87399000.92,-1894,9795,11689,4593.974816,2728.482715
23S,5250,1632,87613740.48,1090,9773,8683,3827.172794,2189.053242
24S,5250,1628,87399000.92,1032,9336,8304,6763.707617,1951.676582
27A,5250,1625,87237946.25,1284,9694,8410,6859.619077,1868.991039
2A,5250,1624,87184261.36,1571,8957,7386,6300.160099,1705.131827
5NE,5250,1623,87130576.47,-1842,9827,11669,4570.884165,2426.158639
5NW,5250,1624,87184261.36,-1875,9827,11702,5252.485837,2467.739029
5SE,5250,1623,87130576.47,234,9784,9550,3934.297597,2460.774324
6NE,5250,1623,87130576.47,1665,9386,7721,6936.645102,1532.424878
6NW,5250,1622,87076891.58,771,9386,8615,5931.019112,2512.282318
6SW,5250,1623,87130576.47,530,9784,9254,6562.625385,2099.568193
Cell 1 2011/12,5250,1621,87023206.69,1187,9230,8043,7007.83467,1639.147294
Cell 1 SW 2013,5250,1624,87184261.36,-1970,9374,11344,5212.915025,2249.78741
Cell 10 2011/12,5250,1621,87023206.69,448,9915,9467,5728.927205,2543.628211
Cell 10 NE 2011/12,5250,1624,87184261.36,-195,9915,10110,5545.948892,2725.617376
Cell 10 NW 2011/12,5250,1626,87291631.14,-1428,9522,10950,6009.354244,2536.657838
Cell 10 SE 2013,5250,1622,87076891.58,771,9386,8615,5931.019112,2512.282318
Cell 10 SW 2011/12,5250,1631,87560055.59,-779,9915,10694,5431.459841,2664.863354
Cell 10-A 2011/12,5250,1626,87291631.14,-268,9915,10183,5536.933579,2606.36085
Cell 11 NE 2011/12,5250,1623,87130576.47,-195,9328,9523,6386.49353,2146.136037
Cell 11 NW 2013,5250,1622,87076891.58,1571,8837,7266,6308.228113,1683.406265
Cell 11 SW 2013,5250,1622,87076891.58,1421,9386,7965,6839.108508,1790.13348
Cell 12 2013,5250,1624,87184261.36,1418,9773,8355,6672.271552,1735.403811
Cell 13 2013,5250,1624,87184261.36,1422,8838,7416,6784.814655,1486.704878
Cell 14 2013,5250,1624,87184261.36,5511,8733,3222,8022.490764,391.2449341
Cell 15 2013,5250,1622,87076891.58,5348,8876,3528,7966.416153,484.7699723
Cell 15-A 2013,5250,1624,87184261.36,5452,8876,3424,7978.704433,445.8952293
Cell 16 2013,5250,1626,87291631.14,5452,8848,3396,8015.109471,411.88066
Cell 17 NW 2011/12,5250,1624,87184261.36,258,9971,9713,6385.601601,2166.120139
Cell 17 NW 2013,5250,1622,87076891.58,-1875,9827,11702,5878.800247,2296.257686
Cell 17 SE 2013,5250,1626,87291631.14,-1428,9522,10950,6011.95941,2536.326445
Cell 17 SW 2013,5250,1626,87291631.14,-1875,9245,11120,6430.282903,2100.807201
Cell 18 2011/12,5250,1624,87184261.36,854,9982,9128,4523.815271,2656.6804
Cell 18 NE 2013,5250,1624,87184261.36,1204,9784,8580,6588.721675,2081.40934
Cell 18 NW 2013,5250,1624,87184261.36,234,9784,9550,3936.394704,2442.090868
Cell 18 SE 2013,5250,1622,87076891.58,-195,9328,9523,6385.638101,2146.52088
Cell 18 SSE 2013,5250,1621,87023206.69,-195,9388,9583,5364.362122,2566.916086
Cell 19 NW 2013,5250,1623,87130576.47,1421,9386,7965,6706.958102,1909.335516
Cell 2 2011/12,5250,1624,87184261.36,1571,9110,7539,6198.719212,1708.322238
Cell 2 NE 2013,5250,1628,87399000.92,-2000,8957,10957,6353.728501,1750.816444
Cell 2 SW 2013,5250,1622,87076891.58,1187,9230,8043,7005.419236,1643.242683
Cell 20 2013,5250,1623,87130576.47,1465,9773,8308,6814.637092,1753.836564
Cell 21 2013,5250,1623,87130576.47,2159,9211,7052,7164.013555,1048.651657
Cell 22 2013,5250,1625,87237946.25,5418,8751,3333,7869.387692,335.1862415
Cell 23 2013,5250,1623,87130576.47,5514,8915,3401,8156.875539,367.6995737
Cell 24 2013,5250,1623,87130576.47,6616,8848,2232,8055.013555,378.1156719
Cell 25 NE 2013,5250,1621,87023206.69,448,9915,9467,5728.927205,2543.628211
Cell 25 SE 2013,5250,1630,87506370.7,-779,9915,10694,5430.106748,2665.120506
Cell 26 NE 2013,5250,1633,87667425.37,-195,9388,9583,5282.102878,2422.276435
Cell 26 NNW 2013,5250,1624,87184261.36,-195,9915,10110,5545.948892,2725.617376
Cell 26 NW 2013,5250,1626,87291631.14,-268,9915,10183,5536.933579,2606.36085
Cell 27 NW 2013,5250,1624,87184261.36,900,9388,8488,5790.982143,2239.020943
Cell 28 2013,5250,1632,87613740.48,700,9569,8869,4322.447304,2398.599703
Cell 29 2013,5250,1623,87130576.47,1506,9211,7705,6678.497227,1542.591219
Cell 3 NE 2013,5250,1623,87130576.47,-384,8813,9197,7247.241528,1042.87612
Cell 3 NW 2013,5250,1623,87130576.47,-2000,9096,11096,6545.438694,1658.485104
Cell 30 2013,5250,1626,87291631.14,6585,8772,2187,7982.358549,358.7606005
Cell 31 2013,5250,1631,87560055.59,5610,8932,3322,8193.611895,429.6686355
Cell 32 2013,5250,1628,87399000.92,5823,8982,3159,8224.985258,407.6953457
Cell 33 NE 2013,5250,1624,87184261.36,258,9971,9713,6385.601601,2166.120139
Cell 33 SE 2013,5250,1633,87667425.37,-1894,9795,11689,5169.805879,2670.789087
Cell 33 SW 2013,5250,1622,87076891.58,-506,9859,10365,4785.135635,2872.726938
Cell 34 N 2013,5250,1622,87076891.58,-471,9455,9926,6585.321208,1863.384498
Cell 34 NW 2013,5250,1624,87184261.36,-471,9942,10413,6753.901478,1701.828508
Cell 34 SE 2013,5250,1624,87184261.36,-782,9509,10291,6276.831281,2153.159615
Cell 35 2013,5250,1619,86915836.91,850,9982,9132,4564.250154,2679.318372
Cell 37 2013,5250,1623,87130576.47,5141,9288,4147,7725.269254,361.2256327
Cell 38 2013,5250,1630,87506370.7,6613,9040,2427,8225.166258,293.5458555
Cell 39 2013,5250,1624,87184261.36,6692,9040,2348,8344.668103,296.9150831
Cell 4 2013,5250,1626,87291631.14,4531,8716,4185,7493.98401,505.4355164
Cell 40 NE 2013,5250,1620,86969521.8,-1894,9795,11689,4675.514198,2744.905422
Cell 41 N 2013,5250,1629,87452685.81,-1894,9615,11509,6241.16329,2363.299003
Cell 41 NW 2013,5250,1621,87023206.69,-1894,9795,11689,5653.507711,2626.715608
Cell 42 NW 2013,5250,1627,87345316.03,-10,9874,9884,5010.665642,2705.5514
Cell 43 2013,5250,1634,87721110.26,1302,9341,8039,6130.213586,2088.246555
Cell 44 2013,5250,1628,87399000.92,4274,9288,5014,7522.175061,520.3262178
Cell 45 2013,5250,1625,87237946.25,6199,8547,2348,7789.596308,388.8574816
Cell 47 2013,5250,1622,87076891.58,784,9694,8910,6422.041307,2127.550348
Cell 48 2013,5250,1628,87399000.92,1032,9336,8304,6756.594595,1960.600674
Cell 49 2013,5250,1623,87130576.47,1418,9284,7866,6883.467652,1471.990753
Cell 5 2011/12 Summer,5250,1626,87291631.14,-1875,9245,11120,6430.282903,2100.807201
Cell 5 2013,5250,1624,87184261.36,4407,8830,4423,7898.525862,610.6963495
Cell 50 2013,5250,1629,87452685.81,1454,8711,7257,7356.747698,1162.855669
Cell 51 2013,5250,1635,87774795.15,6188,8935,2747,7967.981651,418.4503942
Cell 52 2013,5250,1626,87291631.14,1402,8549,7147,7281.708487,1410.575109
Cell 53 2013,5250,1628,87399000.92,1401,9014,7613,7221.92629,1303.123011
Cell 54 2013,5250,1625,87237946.25,5832,8961,3129,7982.104,558.3354346
Cell 55 2013,5250,1624,87184261.36,6068,8870,2802,7970.743227,532.2783784
Cell 56 2013,5250,1632,87613740.48,6135,9347,3212,7461.567402,442.1161932
Cell 57 2013,5250,1625,87237946.25,1694,8797,7103,6935.764923,1185.670272
Cell 58 2013,5250,1623,87130576.47,5938,8815,2877,8024.978435,421.1549697
Cell 59 2013,5250,1624,87184261.36,4674,9347,4673,7460.473522,427.7820699
Cell 6 2011/12,5250,1624,87184261.36,1470,9386,7916,6676.426108,1898.356752
Cell 6 2013,5250,1624,87184261.36,5628,8830,3202,8094.493227,397.5614399
Cell 6 NE 2011/12,5250,1623,87130576.47,1665,9386,7721,6936.645102,1532.424878
Cell 6 NW 2011/12,5250,1622,87076891.58,771,9386,8615,5931.019112,2512.282318
Cell 6 SW 2011/12,5250,1623,87130576.47,530,9784,9254,6562.625385,2099.568193
Cell 60 2013,5250,1629,87452685.81,2390,8373,5983,7073.055249,791.9433282
Cell 61 2013,5250,1625,87237946.25,3613,8831,5218,7556.802462,674.3370057
Cell 7 2013,5250,1636,87828480.04,5313,9125,3812,8076.165037,606.7433849
Cell 9 NW 2013,5250,1623,87130576.47,-1842,9827,11669,4816.383857,2432.284626
Cell 9 SE 2013,5250,1623,87130576.47,-1842,9827,11669,4570.884165,2426.158639
Cell 9 SW 2013,5250,1622,87076891.58,-1875,9827,11702,5250.654747,2468.696596
Cell R1,5250,1617,86808467.13,1192,8189,6997,5805.076067,2029.865799
Cell R10,5250,1626,87291631.14,4531,8716,4185,7493.98401,505.4355164
Cell R100,5250,1629,87452685.81,1454,8711,7257,7356.747698,1162.855669
Cell R101,5250,1625,87237946.25,5222,8838,3616,7860.263385,433.8924399
Cell R104,5250,1629,87452685.81,1367,9157,7790,6916.189687,2043.587045
Cell R105,5250,1627,87345316.03,1401,9014,7613,7221.581438,1303.449153
Cell R106,5250,1623,87130576.47,1628,9014,7386,7208.900185,1339.238124
Cell R107,5250,1624,87184261.36,5832,8961,3129,7982.839286,557.7202403
Cell R11,5250,1624,87184261.36,4407,8830,4423,7898.326355,610.5742951
Cell R111,5250,1628,87399000.92,1444,9474,8030,6790.235872,2002.505904
Cell R112,5250,1623,87130576.47,3061,8707,5646,7573.850277,485.2603437
Cell R113,5250,1625,87237946.25,1694,8797,7103,6935.764923,1185.670272
Cell R114,5250,1623,87130576.47,5938,8815,2877,8024.978435,421.1549697
Cell R117,5250,1626,87291631.14,1613,9931,8318,6948.061501,1734.310141
Cell R118,5250,1631,87560055.59,6135,9347,3212,7461.613734,442.247747
Cell R119,5250,1629,87452685.81,1694,8696,7002,6798.790055,1214.320984
Cell R120,5250,1620,86969521.8,2116,8887,6771,7414.309259,779.7667751
Cell R121,5250,1625,87237946.25,6699,8831,2132,8033.462769,347.5590203
Cell R123,5250,1626,87291631.14,1605,9347,7742,7256.035055,1075.355973
Cell R124,5250,1625,87237946.25,2277,8373,6096,7010.333538,857.3752516
Cell R125,5250,1634,87721110.26,2277,8767,6490,6749.184823,1145.368876
Cell R126,5250,1629,87452685.81,3613,8831,5218,7453.472683,691.5122777
Cell R15,5250,1625,87237946.25,-1970,9374,11344,5211.000615,2250.417849
Cell R16,5250,1622,87076891.58,-1842,9827,11669,4806.759556,2434.985814
Cell R17,5250,1624,87184261.36,771,9230,8459,6904.626847,1843.537853
Cell R18,5250,1632,87613740.48,1571,8837,7266,6302.732843,1678.827345
Cell R19,5250,1623,87130576.47,1373,9768,8395,6746.319778,1761.307259
Cell R20,5250,1623,87130576.47,1834,8716,6882,7115.868762,1130.245151
Cell R21,5250,1623,87130576.47,2057,8838,6781,7578.50647,1028.135363
Cell R22,5250,1623,87130576.47,5511,8733,3222,8022.279113,391.2724936
Cell R24,5250,1622,87076891.58,-1875,9827,11702,5878.84402,2296.29224
Cell R25,5250,1624,87184261.36,234,9784,9550,3936.394704,2442.090868
Cell R26,5250,1628,87399000.92,771,9386,8615,5935.42199,2503.507975
Cell R27,5250,1621,87023206.69,1421,9386,7965,6709.980259,1907.046141
Cell R28,5250,1626,87291631.14,1326,9773,8447,6022.962485,2220.199769
Cell R29,5250,1623,87130576.47,1465,9773,8308,6814.637092,1753.836564
Cell R30,5250,1625,87237946.25,2057,8751,6694,7438.951385,801.7671717
Cell R31,5250,1629,87452685.81,5511,8751,3240,7881.648864,452.1195884
Cell R35,5250,1626,87291631.14,-1875,9245,11120,6430.282903,2100.807201
Cell R36,5250,1626,87291631.14,-1428,9522,10950,6009.354244,2536.657838
Cell R37,5250,1623,87130576.47,-195,9328,9523,6386.49353,2146.136037
Cell R38,5250,1636,87828480.04,981,9231,8250,5763.690709,2297.909599
Cell R39,5250,1623,87130576.47,1535,9401,7866,6820.809612,1502.848422
Cell R40,5250,1623,87130576.47,2159,9211,7052,7164.013555,1048.651657
Cell R46,5250,1622,87076891.58,-779,9915,10694,5357.640567,2699.438651
Cell R47,5250,1626,87291631.14,-268,9915,10183,5536.933579,2606.36085
Cell R48,5250,1633,87667425.37,-195,9388,9583,5282.102878,2422.276435
Cell R49,5250,1624,87184261.36,900,9388,8488,5790.982143,2239.020943
Cell R5,5250,1623,87130576.47,-1970,8743,10713,5605.791128,2084.043237
Cell R50,5250,1630,87506370.7,700,9569,8869,4320.058896,2398.216004
Cell R51,5250,1625,87237946.25,1506,9211,7705,6694.779692,1527.286144
Cell R52,5250,1628,87399000.92,2443,8808,6365,7325.69656,825.7439108
Cell R53,5250,1624,87184261.36,3421,8616,5195,7480.380542,513.0480902
Cell R54,5250,1631,87560055.59,5610,8932,3322,8193.611895,429.6686355
Cell R58,5250,1623,87130576.47,-268,9942,10210,4798.381392,2789.328617
Cell R59,5250,1624,87184261.36,258,9971,9713,6385.601601,2166.120139
Cell R6,5250,1621,87023206.69,1187,9230,8043,7006.737199,1642.89222
Cell R60,5250,1623,87130576.47,-471,9942,10413,6753.481824,1702.268708
Cell R61,5250,1621,87023206.69,850,9982,9132,4568.667489,2680.614333
Cell R62,5250,1624,87184261.36,716,9358,8642,4666.42303,2468.564955
Cell R63,5250,1624,87184261.36,716,8882,8166,6459.746921,1733.046907
Cell R64,5250,1624,87184261.36,3349,8458,5109,7619.017857,451.2022231
Cell R65,5250,1626,87291631.14,6585,8772,2187,7982.358549,358.7606005
Cell R66,5250,1634,87721110.26,5718,8955,3237,8367.231946,261.6136479
Cell R69,5250,1622,87076891.58,-506,9859,10365,4785.135635,2872.726938
Cell R7,5250,1623,87130576.47,-2000,9096,11096,6545.438694,1658.485104
Cell R70,5250,1633,87667425.37,-1894,9795,11689,5169.805879,2670.789087
Cell R71,5250,1624,87184261.36,-782,9509,10291,6276.831281,2153.159615
Cell R72,5250,1623,87130576.47,-10,9509,9519,5311.822551,2665.049794
Cell R73,5250,1628,87399000.92,-10,9879,9889,5108.788084,2734.516586
Cell R74,5250,1625,87237946.25,1134,9341,8207,6411.576615,2099.353495
Cell R75,5250,1623,87130576.47,5141,9288,4147,7725.269254,361.2256327
Cell R76,5250,1630,87506370.7,6613,8790,2177,8089.434969,322.3166056
Cell R77,5250,1630,87506370.7,6613,9040,2427,8225.166258,293.5458555
Cell R8,5250,1624,87184261.36,-384,8813,9197,7229.845443,1071.240154
Cell R80,5250,1621,87023206.69,-1894,9795,11689,4673.298581,2745.50728
Cell R81,5250,1624,87184261.36,-498,9583,10081,6497.329433,2097.917254
Cell R82,5250,1628,87399000.92,-10,9874,9884,5012.671376,2705.930048
Cell R83,5250,1625,87237946.25,422,9874,9452,5471.060923,2493.81325
Cell R84,5250,1624,87184261.36,1126,8839,7713,4981.889778,2398.252839
Cell R85,5250,1634,87721110.26,1302,9341,8039,6130.213586,2088.246555
Cell R86,5250,1625,87237946.25,5782,8547,2765,7497.297846,418.6193188
Cell R87,5250,1625,87237946.25,6199,8547,2348,7789.596308,388.8574816
Cell R9,5250,1621,87023206.69,-384,8813,9197,7263.165947,1023.712251
Cell R90,5250,1622,87076891.58,784,9694,8910,6422.041307,2127.550348
Cell R91,5250,1626,87291631.14,1032,9336,8304,6761.00492,1956.997049
Cell R92,5250,1625,87237946.25,1113,9683,8570,4305.673231,2376.297387
Cell R93,5250,1621,87023206.69,1418,9284,7866,6882.579889,1472.673901
Cell R97,5250,1629,87452685.81,1282,9318,8036,6864.605279,1850.669784
Cell R98,5250,1625,87237946.25,1316,8549,7233,7377.929231,1312.563037
Cell R99,5250,1626,87291631.14,1402,8549,7147,7281.708487,1410.575109
Cell S102,5250,1624,87184261.36,5785,8935,3150,8034.109606,420.1343678
Cell S108,5250,1622,87076891.58,6068,8870,2802,7970.495684,532.3858679
Cell S13,5250,1623,87130576.47,5628,9125,3497,8152.255699,478.133364
Cell S14,5250,1638,87935849.82,5313,9125,3812,8076.269231,606.4148203
Cell S2,5250,1624,87184261.36,5628,8830,3202,8094.493227,397.5614399
Cell S23,5250,1625,87237946.25,5584,8842,3258,8140.585846,498.8631915
Cell S32,5250,1625,87237946.25,5511,8938,3427,7963.839385,483.2308517
Cell S33,5250,1624,87184261.36,5452,8876,3424,7978.704433,445.8952293
Cell S34,5250,1623,87130576.47,6616,8848,2232,8055.013555,378.1156719
Cell S41,5250,1622,87076891.58,5127,8751,3624,7701.278668,419.194273
Cell S42,5250,1623,87130576.47,5514,8915,3401,8156.369686,367.7575183
Cell S44,5250,1627,87345316.03,6649,8939,2290,8195.922557,317.1626692
Cell S56,5250,1630,87506370.7,5634,8793,3159,7992.966258,491.0979318
Cell S67,5250,1627,87345316.03,5823,8982,3159,8224.846958,407.7824381
Cell S78,5250,1624,87184261.36,6692,9040,2348,8344.668103,296.9150831
Cell S88,5250,1626,87291631.14,6188,8915,2727,8096.060271,404.8785067
Cell S94,5250,1627,87345316.03,6757,8935,2178,8091.28027,316.2971732
Cell S95,5250,1636,87828480.04,6188,8935,2747,7968.191932,418.4088893
W287,5250,1623,87130576.47,807,9196,8389,4037.703019,2077.390653
W295,5250,1623,87130576.47,1643,8825,7182,7043.873691,1536.880783
W338,5250,1622,87076891.58,692,9866,9174,4149.926017,2535.667546
W342,5250,1622,87076891.58,1013,8392,7379,5314.045006,2210.368399
W345,5250,1625,87237946.25,1644,8605,6961,7449.077538,657.8179632
W387,5250,1623,87130576.47,1191,9937,8746,5766.685151,2430.048267
W393,5250,1622,87076891.58,853,9522,8669,6240.918619,2015.371151
W440,5250,1621,87023206.69,1125,9047,7922,5579.615669,2281.223518
W441,5250,1623,87130576.47,1885,8634,6749,7001.987061,993.0569347
W445,5250,1620,86969521.8,2191,8498,6307,6762.425926,982.5131451
W500,5250,1622,87076891.58,1427,8823,7396,6187.655364,1844.664994
1,5500,1783,95720158.87,-1502,9230,10732,6859.089736,1792.764014
2,5500,1776,95344364.64,1571,9110,7539,6176.598536,1739.543168
3,5500,1785,95827528.65,1373,9275,7902,7152.192157,1202.749959
4,5500,1786,95881213.54,1422,8716,7294,7089.827548,1141.965213
5,5500,1783,95720158.87,-1875,9245,11120,6370.984296,2129.012941
6,5500,1781,95612789.09,1360,9386,8026,6574.798428,1979.871349
7,5500,1782,95666473.98,1418,9773,8355,6587.597643,1795.1714
8,5500,1785,95827528.65,1422,8838,7416,6883.591597,1461.399779
9,5500,1789,96042268.21,5511,8938,3427,7849.383454,387.838737
10,5500,1778,95451734.42,193,9915,9722,5623.971879,2586.678587
11,5500,1785,95827528.65,-195,9388,9583,5327.381513,2430.885354
12,5500,1788,95988583.32,700,9569,8869,4341.157159,2402.114346
13,5500,1785,95827528.65,1466,9211,7745,6653.429132,1583.49418
14,5500,1787,95934898.43,4359,8852,4493,7946.52826,653.2989502
16,5500,1786,95881213.54,-506,9976,10482,4965.457447,2886.177071
17,5500,1786,95881213.54,-471,9942,10413,6735.99776,1742.454764
18,5500,1774,95236994.86,854,9982,9128,4588.43292,2661.712613
19,5500,1782,95666473.98,716,9358,8642,4751.276655,2461.79308
20,5500,1788,95988583.32,3906,9288,5382,7707.201902,393.062228
21,5500,1781,95612789.09,6613,9040,2427,8217.059517,296.0705237
22,5500,1780,95559104.2,-1894,9795,11689,4771.525281,2693.818159
23,5500,1780,95559104.2,-10,9874,9884,5149.506742,2693.357627
24,5500,1784,95773843.76,1032,9336,8304,6716.295964,1983.980501
25,5500,1781,95612789.09,1353,9284,7931,6847.186412,1552.821884
26,5500,1783,95720158.87,5976,8593,2617,7785.014582,406.8311805
27,5500,1786,95881213.54,1293,8549,7256,7292.68701,1453.988104
28,5500,1786,95881213.54,1401,9014,7613,7160.493281,1416.246882
29,5500,1790,96095953.1,1454,8711,7257,7311.962011,1243.131088
31,5500,1782,95666473.98,1849,9931,8082,7494.234568,1002.540796
32,5500,1784,95773843.76,1694,8797,7103,6959.257848,1156.767751
33,5500,1789,96042268.21,6135,9931,3796,7468.4673,465.4953565
34,5500,1778,95451734.42,2390,8364,5974,7033.275591,816.1383553
10A,5500,1785,95827528.65,-592,9915,10507,5375.781513,2688.405065
10NE,5500,1785,95827528.65,-195,9915,10110,5444.903081,2780.138311
10NW,5500,1783,95720158.87,-1680,9522,11202,5908.408861,2575.023546
10SW,5500,1785,95827528.65,-779,9915,10694,5478.767507,2686.715301
11NE,5500,1776,95344364.64,-195,9328,9523,6307.975788,2221.78933
11NW,5500,1787,95934898.43,-195,9388,9583,5329.980974,2593.365235
11SE,5500,1780,95559104.2,623,9388,8765,5795.555056,2254.04245
17NW,5500,1782,95666473.98,258,9971,9713,6362.360831,2147.027546
17SE,5500,1782,95666473.98,-782,9509,10291,6196.446689,2194.025406
17SW,5500,1784,95773843.76,-1894,9795,11689,5189.945628,2645.694774
22S,5500,1784,95773843.76,-1894,9795,11689,4580.343049,2718.985978
23S,5500,1788,95988583.32,1090,9773,8683,3905.743289,2228.860941
24S,5500,1783,95720158.87,1032,9336,8304,6686.03309,2004.267233
27A,5500,1784,95773843.76,1284,9694,8410,6882.954596,1853.783838
2A,5500,1786,95881213.54,1571,8957,7386,6318.956887,1701.096661
5NE,5500,1783,95720158.87,-1842,9827,11669,4554.733034,2425.210823
5NW,5500,1775,95290679.75,-1875,9827,11702,5214.303662,2473.937727
5SE,5500,1784,95773843.76,146,9784,9638,4021.17713,2474.130981
6NE,5500,1779,95505419.31,1665,9386,7721,6858.820124,1597.525853
6NW,5500,1777,95398049.53,771,9386,8615,5891.631401,2537.516067
6SW,5500,1783,95720158.87,530,9784,9254,6498.310151,2145.078609
Cell 1 2011/12,5500,1783,95720158.87,-1502,9230,10732,6859.089736,1792.764014
Cell 1 SW 2013,5500,1784,95773843.76,-1970,9374,11344,5241.707399,2253.478824
Cell 10 2011/12,5500,1778,95451734.42,193,9915,9722,5623.971879,2586.678587
Cell 10 NE 2011/12,5500,1785,95827528.65,-195,9915,10110,5444.903081,2780.138311
Cell 10 NW 2011/12,5500,1783,95720158.87,-1680,9522,11202,5908.408861,2575.023546
Cell 10 SE 2013,5500,1777,95398049.53,771,9386,8615,5891.631401,2537.516067
Cell 10 SW 2011/12,5500,1785,95827528.65,-779,9915,10694,5478.767507,2686.715301
Cell 10-A 2011/12,5500,1785,95827528.65,-592,9915,10507,5375.781513,2688.405065
Cell 11 NE 2011/12,5500,1776,95344364.64,-195,9328,9523,6307.975788,2221.78933
Cell 11 NW 2013,5500,1788,95988583.32,1571,8837,7266,6288.052573,1688.805481
Cell 11 SW 2013,5500,1784,95773843.76,1421,9386,7965,6782.867152,1798.901127
Cell 12 2013,5500,1782,95666473.98,1418,9773,8355,6590.641414,1792.342516
Cell 13 2013,5500,1787,95934898.43,1422,8838,7416,6831.5277,1477.820942
Cell 14 2013,5500,1787,95934898.43,5511,8733,3222,7999.977616,425.9450779
Cell 15 2013,5500,1785,95827528.65,5348,8876,3528,7986.261625,482.4840653
Cell 15-A 2013,5500,1789,96042268.21,5348,8876,3528,7997.722191,451.6460862
Cell 16 2013,5500,1780,95559104.2,5452,8848,3396,8026.430337,414.0776513
Cell 17 NW 2011/12,5500,1782,95666473.98,258,9971,9713,6362.360831,2147.027546
Cell 17 NW 2013,5500,1777,95398049.53,-1875,9827,11702,5847.319077,2317.365294
Cell 17 SE 2013,5500,1782,95666473.98,-1680,9522,11202,5908.058923,2575.70357
Cell 17 SW 2013,5500,1787,95934898.43,-1875,9245,11120,6382.225518,2124.0355
Cell 18 2011/12,5500,1774,95236994.86,854,9982,9128,4588.43292,2661.712613
Cell 18 NE 2013,5500,1787,95934898.43,1204,9784,8580,6577.125909,2090.161954
Cell 18 NW 2013,5500,1776,95344364.64,234,9784,9550,4024.557995,2458.911019
Cell 18 SE 2013,5500,1777,95398049.53,-195,9328,9523,6305.474958,2223.663034
Cell 18 SSE 2013,5500,1779,95505419.31,-195,9388,9583,5330.944913,2573.725903
Cell 19 NW 2013,5500,1783,95720158.87,1421,9386,7965,6595.987661,1992.39905
Cell 2 2011/12,5500,1776,95344364.64,1571,9110,7539,6176.598536,1739.543168
Cell 2 NE 2013,5500,1782,95666473.98,-2000,8957,10957,6373.215488,1742.06616
Cell 2 SW 2013,5500,1779,95505419.31,-1502,9230,10732,6862.091062,1791.749601
Cell 20 2013,5500,1788,95988583.32,1465,9773,8308,6773.464206,1753.436508
Cell 21 2013,5500,1787,95934898.43,2159,9211,7052,7177.273643,1045.589593
Cell 22 2013,5500,1786,95881213.54,5076,8751,3675,7866.983763,380.1760676
Cell 23 2013,5500,1778,95451734.42,5514,8915,3401,8149.650169,373.8690636
Cell 24 2013,5500,1780,95559104.2,6616,8848,2232,8053.185393,383.6323504
Cell 25 NE 2013,5500,1778,95451734.42,193,9915,9722,5623.971879,2586.678587
Cell 25 SE 2013,5500,1785,95827528.65,-779,9915,10694,5478.767507,2686.715301
Cell 26 NE 2013,5500,1783,95720158.87,-195,9388,9583,5324.292765,2430.192124
Cell 26 NNW 2013,5500,1785,95827528.65,-195,9915,10110,5444.903081,2780.138311
Cell 26 NW 2013,5500,1784,95773843.76,-592,9915,10507,5374.581839,2688.680734
Cell 27 NW 2013,5500,1780,95559104.2,623,9388,8765,5795.555056,2254.04245
Cell 28 2013,5500,1788,95988583.32,700,9569,8869,4341.157159,2402.114346
Cell 29 2013,5500,1785,95827528.65,1466,9211,7745,6653.429132,1583.49418
Cell 3 NE 2013,5500,1785,95827528.65,-384,8813,9197,7235.710924,1041.259996
Cell 3 NW 2013,5500,1781,95612789.09,-2000,9096,11096,6518.163391,1685.818716
Cell 30 2013,5500,1776,95344364.64,3906,8772,4866,7976.367117,389.5287178
Cell 31 2013,5500,1785,95827528.65,4887,8955,4068,8173.27507,470.1064055
Cell 32 2013,5500,1785,95827528.65,5634,8982,3348,8219.094678,416.7972033
Cell 33 NE 2013,5500,1782,95666473.98,258,9971,9713,6362.360831,2147.027546
Cell 33 SE 2013,5500,1783,95720158.87,-1894,9795,11689,5187.753225,2646.462013
Cell 33 SW 2013,5500,1785,95827528.65,-506,9976,10482,4897.14902,2876.155402
Cell 34 N 2013,5500,1786,95881213.54,-471,9455,9926,6594.181411,1888.748631
Cell 34 NW 2013,5500,1785,95827528.65,-471,9942,10413,6735.455462,1742.792095
Cell 34 SE 2013,5500,1784,95773843.76,-782,9509,10291,6201.924327,2190.522556
Cell 35 2013,5500,1779,95505419.31,850,9982,9132,4579.468241,2675.489233
Cell 37 2013,5500,1782,95666473.98,3349,9288,5939,7703.959596,408.0245635
Cell 38 2013,5500,1787,95934898.43,6613,9040,2427,8222.079463,293.8636006
Cell 39 2013,5500,1788,95988583.32,6692,9040,2348,8335.091723,300.3759082
Cell 4 2013,5500,1783,95720158.87,4531,8848,4317,7504.162086,503.6675174
Cell 40 NE 2013,5500,1780,95559104.2,-1894,9795,11689,4680.039888,2757.690011
Cell 41 N 2013,5500,1786,95881213.54,-1894,9615,11509,6180.56103,2387.300356
Cell 41 NW 2013,5500,1783,95720158.87,-1894,9795,11689,5672.801458,2600.185213
Cell 42 NW 2013,5500,1787,95934898.43,-10,9874,9884,5116.241186,2692.348965
Cell 43 2013,5500,1787,95934898.43,1302,9341,8039,6084.383324,2119.299475
Cell 44 2013,5500,1786,95881213.54,2414,9288,6874,7513.421613,583.1984614
Cell 45 2013,5500,1780,95559104.2,5976,8593,2617,7785.807865,406.5546802
Cell 47 2013,5500,1786,95881213.54,784,9694,8910,6476.754199,2109.212668
Cell 48 2013,5500,1783,95720158.87,1032,9336,8304,6687.360067,2003.694325
Cell 49 2013,5500,1781,95612789.09,1353,9284,7931,6847.186412,1552.821884
Cell 5 2011/12 Summer,5500,1788,95988583.32,-1875,9245,11120,6380.073826,2125.38867
Cell 5 2013,5500,1785,95827528.65,4407,8830,4423,7899.746218,615.1083483
Cell 50 2013,5500,1789,96042268.21,1454,8711,7257,7311.494131,1243.320904
Cell 51 2013,5500,1788,95988583.32,6188,8935,2747,7965.33557,420.6350668
Cell 52 2013,5500,1786,95881213.54,1402,8549,7147,7242.00056,1472.984703
Cell 53 2013,5500,1786,95881213.54,1401,9014,7613,7160.493281,1416.246882
Cell 54 2013,5500,1782,95666473.98,5832,8961,3129,7972.860831,560.5807242
Cell 55 2013,5500,1785,95827528.65,6068,8870,2802,7974.743978,531.933465
Cell 56 2013,5500,1786,95881213.54,6135,9931,3796,7469.194849,465.8620795
Cell 57 2013,5500,1781,95612789.09,1694,8797,7103,6958.941044,1157.699655
Cell 58 2013,5500,1787,95934898.43,5938,8815,2877,8016.376609,433.4242411
Cell 59 2013,5500,1775,95290679.75,3146,9347,6201,7452.678873,493.5071608
Cell 6 2011/12,5500,1781,95612789.09,1360,9386,8026,6574.798428,1979.871349
Cell 6 2013,5500,1782,95666473.98,5628,8830,3202,8096.741302,406.3808606
Cell 6 NE 2011/12,5500,1779,95505419.31,1665,9386,7721,6858.820124,1597.525853
Cell 6 NW 2011/12,5500,1777,95398049.53,771,9386,8615,5891.631401,2537.516067
Cell 6 SW 2011/12,5500,1783,95720158.87,530,9784,9254,6498.310151,2145.078609
Cell 60 2013,5500,1787,95934898.43,2390,8373,5983,7036.765529,832.3203906
Cell 61 2013,5500,1782,95666473.98,3613,8831,5218,7558.782828,673.4949447
Cell 7 2013,5500,1788,95988583.32,5313,9125,3812,8081.263423,605.9058156
Cell 9 NW 2013,5500,1778,95451734.42,-1842,9827,11669,4781.271654,2425.591476
Cell 9 SE 2013,5500,1783,95720158.87,-1842,9827,11669,4554.733034,2425.210823
Cell 9 SW 2013,5500,1774,95236994.86,-1875,9827,11702,5212.952649,2473.392974
Cell R1,5500,1781,95612789.09,1192,8189,6997,5800.696238,2006.930325
Cell R10,5500,1781,95612789.09,4531,8848,4317,7504.169006,503.9346823
Cell R100,5500,1790,96095953.1,1454,8711,7257,7308.330726,1250.154399
Cell R101,5500,1784,95773843.76,5222,8838,3616,7854.651345,439.2745262
Cell R104,5500,1784,95773843.76,1367,9157,7790,6913.237668,2032.90639
Cell R105,5500,1786,95881213.54,1401,9014,7613,7160.493281,1416.246882
Cell R106,5500,1780,95559104.2,1454,9014,7560,7204.781461,1358.708752
Cell R107,5500,1781,95612789.09,5832,8961,3129,7972.836609,560.7371479
Cell R11,5500,1786,95881213.54,4407,8830,4423,7899.68813,614.9410187
Cell R111,5500,1785,95827528.65,1444,9642,8198,6764.347899,2037.072293
Cell R112,5500,1788,95988583.32,3061,9014,5953,7561.5783,545.9909838
Cell R113,5500,1782,95666473.98,1694,8797,7103,6958.983726,1157.37618
Cell R114,5500,1788,95988583.32,5938,8815,2877,8016.385906,433.3031987
Cell R117,5500,1776,95344364.64,1613,9931,8318,6897.584459,1763.05851
Cell R118,5500,1786,95881213.54,6135,9931,3796,7469.194849,465.8620795
Cell R119,5500,1783,95720158.87,1694,8797,7103,6824.403253,1199.442476
Cell R120,5500,1784,95773843.76,2116,8887,6771,7414.401345,790.5814956
Cell R121,5500,1788,95988583.32,6699,8831,2132,8041.48434,345.6017922
Cell R123,5500,1786,95881213.54,1553,9347,7794,7217.642777,1154.888022
Cell R124,5500,1787,95934898.43,2277,8373,6096,6960.658646,909.7784611
Cell R125,5500,1788,95988583.32,2277,8767,6490,6759.169463,1129.140832
Cell R126,5500,1790,96095953.1,3613,8831,5218,7439.968156,721.9797546
Cell R15,5500,1785,95827528.65,-1970,9374,11344,5239.485714,2254.800993
Cell R16,5500,1779,95505419.31,-1842,9827,11669,4770.952782,2427.63754
Cell R17,5500,1785,95827528.65,771,9230,8459,6775.052661,1960.459001
Cell R18,5500,1788,95988583.32,1571,8837,7266,6290.009508,1690.173039
Cell R19,5500,1780,95559104.2,1373,9768,8395,6717.535393,1765.838466
Cell R20,5500,1787,95934898.43,1715,8716,7001,7114.284835,1146.097855
Cell R21,5500,1788,95988583.32,1984,8838,6854,7540.854586,1100.162441
Cell R22,5500,1787,95934898.43,5511,8733,3222,7999.977616,425.9450779
Cell R24,5500,1777,95398049.53,-1875,9827,11702,5847.319077,2317.365294
Cell R25,5500,1776,95344364.64,234,9784,9550,4024.557995,2458.911019
Cell R26,5500,1784,95773843.76,771,9386,8615,5902.349776,2527.643232
Cell R27,5500,1782,95666473.98,1421,9386,7965,6596.649832,1992.761858
Cell R28,5500,1785,95827528.65,1326,9773,8447,5986.956303,2237.78122
Cell R29,5500,1789,96042268.21,1465,9773,8308,6773.954723,1753.069084
Cell R30,5500,1785,95827528.65,2057,8751,6694,7441.841457,827.3251862
Cell R31,5500,1785,95827528.65,5302,8751,3449,7864.904202,467.2127789
Cell R35,5500,1788,95988583.32,-1875,9245,11120,6380.073826,2125.38867
Cell R36,5500,1783,95720158.87,-1680,9522,11202,5908.408861,2575.023546
Cell R37,5500,1777,95398049.53,-195,9328,9523,6306.429375,2222.11994
Cell R38,5500,1785,95827528.65,981,9231,8250,5720.490756,2322.638912
Cell R39,5500,1783,95720158.87,1430,9401,7971,6770.477285,1567.401176
Cell R40,5500,1787,95934898.43,2159,9211,7052,7176.745943,1045.608524
Cell R46,5500,1782,95666473.98,-779,9915,10694,5317.429293,2723.711872
Cell R47,5500,1785,95827528.65,-592,9915,10507,5375.781513,2688.405065
Cell R48,5500,1784,95773843.76,-195,9388,9583,5325.742713,2430.282248
Cell R49,5500,1781,95612789.09,623,9388,8765,5794.900618,2253.578709
Cell R5,5500,1778,95451734.42,-1970,8948,10918,5628.995501,2083.902457
Cell R50,5500,1788,95988583.32,700,9569,8869,4341.157159,2402.114346
Cell R51,5500,1786,95881213.54,1466,9211,7745,6663.962486,1573.388614
Cell R52,5500,1790,96095953.1,2443,8808,6365,7309.861453,833.8889312
Cell R53,5500,1786,95881213.54,3421,8616,5195,7482.441769,518.4168728
Cell R54,5500,1786,95881213.54,4887,8955,4068,8173.118701,470.0212099
Cell R58,5500,1783,95720158.87,-268,9971,10239,4882.010656,2829.472805
Cell R59,5500,1782,95666473.98,258,9971,9713,6362.360831,2147.027546
Cell R6,5500,1779,95505419.31,-1502,9230,10732,6862.225408,1791.442482
Cell R60,5500,1786,95881213.54,-471,9942,10413,6735.99776,1742.454764
Cell R61,5500,1779,95505419.31,850,9982,9132,4579.468241,2675.489233
Cell R62,5500,1789,96042268.21,716,9358,8642,4665.784237,2465.839133
Cell R63,5500,1787,95934898.43,716,9348,8632,6423.61052,1764.068116
Cell R64,5500,1785,95827528.65,3349,8566,5217,7618.457143,453.2309674
Cell R65,5500,1776,95344364.64,3906,8772,4866,7976.367117,389.5287178
Cell R66,5500,1789,96042268.21,5718,8955,3237,8356.667412,270.8970349
Cell R69,5500,1786,95881213.54,-506,9976,10482,4896.223404,2875.616019
Cell R7,5500,1780,95559104.2,-2000,9096,11096,6518.788202,1686.086025
Cell R70,5500,1784,95773843.76,-1894,9795,11689,5186.998879,2645.911923
Cell R71,5500,1785,95827528.65,-782,9509,10291,6203.167507,2190.538303
Cell R72,5500,1785,95827528.65,-10,9509,9519,5386.952381,2643.893172
Cell R73,5500,1785,95827528.65,-10,9982,9992,4995.071148,2750.481413
Cell R74,5500,1783,95720158.87,1134,9341,8207,6355.267527,2137.667063
Cell R75,5500,1782,95666473.98,3349,9288,5939,7703.959596,408.0245635
Cell R76,5500,1788,95988583.32,6613,8790,2177,8092.356823,324.9014274
Cell R77,5500,1787,95934898.43,6613,9040,2427,8222.079463,293.8636006
Cell R8,5500,1785,95827528.65,-384,8813,9197,7203.833053,1078.155774
Cell R80,5500,1780,95559104.2,-1894,9795,11689,4680.039888,2757.690011
Cell R81,5500,1782,95666473.98,-498,9583,10081,6503.818182,2078.499035
Cell R82,5500,1787,95934898.43,-10,9874,9884,5116.241186,2692.348965
Cell R83,5500,1785,95827528.65,422,9874,9452,5557.838095,2477.45209
Cell R84,5500,1782,95666473.98,1126,8839,7713,5013.404602,2390.407702
Cell R85,5500,1787,95934898.43,1302,9341,8039,6084.383324,2119.299475
Cell R86,5500,1783,95720158.87,4925,8754,3829,7514.40157,430.5617172
Cell R87,5500,1780,95559104.2,5976,8593,2617,7785.807865,406.5546802
Cell R9,5500,1778,95451734.42,-384,8813,9197,7274.933071,1013.045199
Cell R90,5500,1785,95827528.65,784,9694,8910,6475.892997,2109.489457
Cell R91,5500,1783,95720158.87,1032,9336,8304,6687.360067,2003.694325
Cell R92,5500,1785,95827528.65,1113,9683,8570,4432.608964,2411.286382
Cell R93,5500,1781,95612789.09,1353,9284,7931,6847.186412,1552.821884
Cell R97,5500,1787,95934898.43,1282,9318,8036,6893.452154,1842.884273
Cell R98,5500,1786,95881213.54,1293,8549,7256,7292.68701,1453.988104
Cell R99,5500,1786,95881213.54,1402,8549,7147,7242.00056,1472.984703
Cell S102,5500,1786,95881213.54,5785,8935,3150,8033.528555,418.7092903
Cell S108,5500,1786,95881213.54,6068,8870,2802,7974.780515,531.7867671
Cell S13,5500,1789,96042268.21,5628,9125,3497,8156.859139,475.1269928
Cell S14,5500,1788,95988583.32,5313,9125,3812,8081.263423,605.9058156
Cell S2,5500,1781,95612789.09,5628,8830,3202,8096.786637,406.4904275
Cell S23,5500,1786,95881213.54,5584,8842,3258,8146.577828,493.0635382
Cell S32,5500,1788,95988583.32,5511,8938,3427,7967.670582,476.8825447
Cell S33,5500,1789,96042268.21,5348,8876,3528,7997.722191,451.6460862
Cell S34,5500,1782,95666473.98,6616,8848,2232,8053.291246,383.5293159
Cell S41,5500,1788,95988583.32,5127,8751,3624,7694.021812,418.9034357
Cell S42,5500,1778,95451734.42,5514,8915,3401,8149.650169,373.8690636
Cell S44,5500,1785,95827528.65,6649,8939,2290,8200.188235,316.5866967
Cell S56,5500,1790,96095953.1,5634,8832,3198,8000.639665,482.7563091
Cell S67,5500,1785,95827528.65,5634,8982,3348,8219.094678,416.7972033
Cell S78,5500,1787,95934898.43,6692,9040,2348,8334.903749,300.3547888
Cell S88,5500,1786,95881213.54,6188,8915,2727,8094.968645,399.9545665
Cell S94,5500,1787,95934898.43,6740,8935,2195,8077.939564,321.3597679
Cell S95,5500,1788,95988583.32,6188,8935,2747,7965.33557,420.6350668
W287,5500,1784,95773843.76,807,9196,8389,4062.683296,2095.814636
W295,5500,1783,95720158.87,1643,8825,7182,7027.804262,1568.699707
W338,5500,1777,95398049.53,692,9923,9231,4098.093416,2537.011248
W342,5500,1773,95183309.97,1013,8392,7379,5289.977439,2247.939516
W345,5500,1783,95720158.87,1644,8605,6961,7432.927089,729.8778701
W387,5500,1782,95666473.98,1191,9937,8746,5735.883838,2429.874787
W393,5500,1779,95505419.31,853,9522,8669,6200.395728,2045.982464
W440,5500,1783,95720158.87,1125,9047,7922,5635.651711,2289.531237
W441,5500,1782,95666473.98,1885,8634,6749,6967.377666,1039.940401
W445,5500,1778,95451734.42,2191,8498,6307,6759.601237,1012.257044
W500,5500,1782,95666473.98,1427,8823,7396,6199.1633,1841.249296
1,5750,1948,104578165.7,-2000,9230,11230,6743.761294,1890.104982
2,5750,1950,104685535.5,1571,9110,7539,6167.841026,1760.347398
3,5750,1949,104631850.6,1373,9275,7902,7103.168805,1254.609499
4,5750,1950,104685535.5,1422,8716,7294,7084.567692,1174.20306
5,5750,1947,104524480.8,-1875,9245,11120,6327.41397,2149.438396
6,5750,1942,104256056.4,1142,9386,8244,6480.852729,2052.243463
7,5750,1949,104631850.6,1326,9773,8447,6511.750641,1852.322817
8,5750,1948,104578165.7,1422,8838,7416,6928.044661,1445.171823
9,5750,1949,104631850.6,5511,8938,3427,7854.244741,405.0598802
10,5750,1942,104256056.4,-592,9915,10507,5546.918126,2617.786595
11,5750,1954,104900275.1,-195,9388,9583,5400.979017,2429.620341
12,5750,1959,105168699.5,700,9569,8869,4395.875957,2415.460591
13,5750,1954,104900275.1,1320,9211,7891,6620.24002,1616.124275
14,5750,1950,104685535.5,4359,8924,4565,7954.008205,635.7081187
16,5750,1955,104953959.9,-506,9976,10482,5049.26087,2874.84046
17,5750,1953,104846590.2,-471,9942,10413,6714.075269,1776.441366
18,5750,1950,104685535.5,850,9982,9132,4642.837949,2668.353339
19,5750,1950,104685535.5,716,9358,8642,4732.375385,2459.409772
20,5750,1950,104685535.5,3349,9288,5939,7690.999487,423.7838473
21,5750,1948,104578165.7,6613,9040,2427,8216.336242,295.6376733
22,5750,1947,104524480.8,-1894,9795,11689,4781.377504,2694.517741
23,5750,1939,104095001.7,-10,9874,9884,5243.303765,2675.755906
24,5750,1953,104846590.2,1032,9336,8304,6634.058372,2054.965604
25,5750,1943,104309741.3,1316,9284,7968,6785.709727,1653.284446
26,5750,1945,104417111.1,5782,8642,2860,7784.17018,419.1192127
27,5750,1949,104631850.6,1293,8549,7256,7194.998461,1602.647332
28,5750,1947,104524480.8,1401,9014,7613,7126.882383,1486.127447
29,5750,1956,105007644.8,1454,8711,7257,7265.474438,1315.635732
31,5750,1944,104363426.2,1581,9931,8350,7447.762346,1111.575112
32,5750,1950,104685535.5,1694,8797,7103,6984.809744,1126.202888
33,5750,1955,104953960,5950,9931,3981,7470.731458,483.3976785
34,5750,1950,104685535.5,2390,8364,5974,6999.526667,853.3298187
10A,5750,1952,104792905.3,-779,9915,10694,5214.732582,2760.272759
10NE,5750,1948,104578165.7,-195,9915,10110,5365.650411,2795.202148
10NW,5750,1944,104363426.2,-1875,9522,11397,5845.260802,2609.96277
10SW,5750,1955,104953960,-779,9915,10694,5531.892583,2692.633296
11NE,5750,1945,104417111.1,-195,9388,9583,6232.869409,2286.283483
11NW,5750,1954,104900275.1,-195,9388,9583,5325.498976,2583.188598
11SE,5750,1945,104417111.1,623,9388,8765,5794.797943,2268.090162
17NW,5750,1945,104417111.1,258,9971,9713,6350.295116,2133.344619
17SE,5750,1950,104685535.5,-782,9509,10291,6116.840513,2247.218088
17SW,5750,1956,105007644.8,-1894,9828,11722,5213.230061,2631.025205
22S,5750,1945,104417111.1,-1894,9795,11689,4558.814396,2723.89381
23S,5750,1959,105168699.5,1090,9773,8683,4017.158754,2271.04294
24S,5750,1946,104470795.9,1024,9336,8312,6616.391059,2065.532361
27A,5750,1951,104739220.4,1284,9694,8410,6896.895951,1847.387086
2A,5750,1950,104685535.5,1571,8957,7386,6355.54,1691.041302
5NE,5750,1946,104470795.9,-1842,9827,11669,4540.866393,2436.366608
5NW,5750,1948,104578165.7,-1875,9827,11702,5176.843429,2474.56178
5SE,5750,1950,104685535.5,146,9784,9638,4144.761538,2507.881983
6NE,5750,1944,104363426.2,1470,9386,7916,6794.91358,1637.6726
6NW,5750,1943,104309741.3,585,9386,8801,5865.598559,2551.923476
6SW,5750,1943,104309741.3,234,9784,9550,6431.094184,2189.836166
Cell 1 2011/12,5750,1948,104578165.7,-2000,9230,11230,6743.761294,1890.104982
Cell 1 SW 2013,5750,1951,104739220.4,-1970,9374,11344,5287.991287,2256.586588
Cell 10 2011/12,5750,1942,104256056.4,-592,9915,10507,5546.918126,2617.786595
Cell 10 NE 2011/12,5750,1948,104578165.7,-195,9915,10110,5365.650411,2795.202148
Cell 10 NW 2011/12,5750,1944,104363426.2,-1875,9522,11397,5845.260802,2609.96277
Cell 10 SE 2013,5750,1945,104417111.1,585,9386,8801,5867.795373,2551.530208
Cell 10 SW 2011/12,5750,1955,104953960,-779,9915,10694,5531.892583,2692.633296
Cell 10-A 2011/12,5750,1952,104792905.3,-779,9915,10694,5214.732582,2760.272759
Cell 11 NE 2011/12,5750,1945,104417111.1,-195,9388,9583,6232.869409,2286.283483
Cell 11 NW 2013,5750,1949,104631850.6,1571,8957,7386,6304.613135,1691.721964
Cell 11 SW 2013,5750,1947,104524480.8,1421,9386,7965,6745.596816,1812.477962
Cell 12 2013,5750,1946,104470795.9,1326,9773,8447,6507.007708,1854.13955
Cell 13 2013,5750,1948,104578165.7,1422,8838,7416,6876.931725,1457.544116
Cell 14 2013,5750,1955,104953960,5511,8733,3222,7987.558568,441.5240335
Cell 15 2013,5750,1950,104685535.5,5348,8876,3528,7998.749744,484.9935828
Cell 15-A 2013,5750,1949,104631850.6,5348,8876,3528,8015.721396,458.7716326
Cell 16 2013,5750,1945,104417111.1,5452,8848,3396,8042.354242,416.2409939
Cell 17 NW 2011/12,5750,1945,104417111.1,258,9971,9713,6350.295116,2133.344619
Cell 17 NW 2013,5750,1944,104363426.2,-1875,9827,11702,5818.546811,2338.820058
Cell 17 SE 2013,5750,1944,104363426.2,-1875,9522,11397,5845.260802,2609.96277
Cell 17 SW 2013,5750,1953,104846590.2,-1875,9245,11120,6336.411674,2148.204633
Cell 18 2011/12,5750,1950,104685535.5,850,9982,9132,4642.837949,2668.353339
Cell 18 NE 2013,5750,1953,104846590.2,530,9784,9254,6525.336406,2128.769519
Cell 18 NW 2013,5750,1945,104417111.1,146,9784,9638,4144.383548,2490.561276
Cell 18 SE 2013,5750,1945,104417111.1,-195,9388,9583,6232.869409,2286.283483
Cell 18 SSE 2013,5750,1950,104685535.5,-195,9388,9583,5346.148718,2559.703024
Cell 19 NW 2013,5750,1947,104524480.8,1346,9386,8040,6536.945557,2027.638139
Cell 2 2011/12,5750,1950,104685535.5,1571,9110,7539,6167.841026,1760.347398
Cell 2 NE 2013,5750,1945,104417111.1,-2000,8957,10957,6404.207198,1734.958998
Cell 2 SW 2013,5750,1947,104524480.8,-2000,9230,11230,6742.285568,1893.098205
Cell 20 2013,5750,1949,104631850.6,1465,9773,8308,6739.050795,1745.278247
Cell 21 2013,5750,1949,104631850.6,2159,9211,7052,7183.373525,1039.455195
Cell 22 2013,5750,1944,104363426.2,4888,8751,3863,7866.141975,410.6119071
Cell 23 2013,5750,1944,104363426.2,5478,8915,3437,8130.103395,404.6731536
Cell 24 2013,5750,1948,104578165.7,6616,8848,2232,8052.816735,384.1557248
Cell 25 NE 2013,5750,1942,104256056.4,-592,9915,10507,5546.918126,2617.786595
Cell 25 SE 2013,5750,1955,104953960,-779,9915,10694,5531.892583,2692.633296
Cell 26 NE 2013,5750,1955,104953959.9,-195,9388,9583,5402.300767,2429.701467
Cell 26 NNW 2013,5750,1948,104578165.7,-195,9915,10110,5365.650411,2795.202148
Cell 26 NW 2013,5750,1952,104792905.3,-779,9915,10694,5214.732582,2760.272759
Cell 27 NW 2013,5750,1946,104470795.9,623,9388,8765,5792.746146,2269.312164
Cell 28 2013,5750,1960,105222384.4,700,9569,8869,4397.106633,2415.458576
Cell 29 2013,5750,1952,104792905.3,1320,9211,7891,6620.744365,1615.411241
Cell 3 NE 2013,5750,1948,104578165.7,-384,8813,9197,7209.155544,1060.799964
Cell 3 NW 2013,5750,1952,104792905.3,-2000,9096,11096,6497.151127,1704.185935
Cell 30 2013,5750,1952,104792905.3,3349,8772,5423,7970.668033,422.3457346
Cell 31 2013,5750,1954,104900275.1,4549,8955,4406,8158.093654,502.6417824
Cell 32 2013,5750,1949,104631850.6,5634,8982,3348,8215.324269,420.9819564
Cell 33 NE 2013,5750,1945,104417111.1,258,9971,9713,6350.295116,2133.344619
Cell 33 SE 2013,5750,1958,105115014.6,-1894,9828,11722,5211.882022,2630.14196
Cell 33 SW 2013,5750,1947,104524480.8,-506,9976,10482,4965.464818,2866.546142
Cell 34 N 2013,5750,1947,104524480.8,-471,9455,9926,6593.400616,1909.788164
Cell 34 NW 2013,5750,1953,104846590.2,-471,9942,10413,6714.075269,1776.441366
Cell 34 SE 2013,5750,1950,104685535.5,-782,9509,10291,6115.24359,2247.494252
Cell 35 2013,5750,1939,104095001.7,850,9982,9132,4591.24033,2672.332335
Cell 37 2013,5750,1947,104524480.8,3349,9288,5939,7686.75398,428.7697222
Cell 38 2013,5750,1953,104846590.2,6613,9040,2427,8222.135177,295.1870889
Cell 39 2013,5750,1951,104739220.4,6692,9040,2348,8326.790876,305.5131324
Cell 4 2013,5750,1946,104470795.9,4285,8848,4563,7508.158787,508.4667185
Cell 40 NE 2013,5750,1940,104148686.6,-1894,9795,11689,4694.442784,2760.063843
Cell 41 N 2013,5750,1955,104953960,-1894,9615,11509,6104.16266,2424.769029
Cell 41 NW 2013,5750,1949,104631850.6,-1894,9795,11689,5697.562853,2570.112469
Cell 42 NW 2013,5750,1952,104792905.3,-10,9874,9884,5211.214652,2673.10622
Cell 43 2013,5750,1957,105061329.7,1230,9341,8111,6029.918753,2152.566571
Cell 44 2013,5750,1955,104953960,1633,9341,7708,7484.258824,717.8064372
Cell 45 2013,5750,1945,104417111.1,5782,8642,2860,7784.17018,419.1192127
Cell 47 2013,5750,1948,104578165.7,784,9694,8910,6503.293121,2098.023793
Cell 48 2013,5750,1945,104417111.1,1024,9336,8312,6615.723393,2065.894067
Cell 49 2013,5750,1943,104309741.3,1316,9284,7968,6784.955739,1653.164879
Cell 5 2011/12 Summer,5750,1953,104846590.2,-1875,9245,11120,6336.411674,2148.204633
Cell 5 2013,5750,1949,104631850.6,4407,8830,4423,7896.621857,627.894886
Cell 50 2013,5750,1956,105007644.8,1454,8711,7257,7265.474438,1315.635732
Cell 51 2013,5750,1961,105276069.3,6188,8935,2747,7964.935747,419.4048489
Cell 52 2013,5750,1950,104685535.5,1402,8549,7147,7222.170256,1504.402441
Cell 53 2013,5750,1947,104524480.8,1401,9014,7613,7126.882383,1486.127447
Cell 54 2013,5750,1951,104739220.4,5832,8961,3129,7965.285495,566.9853964
Cell 55 2013,5750,1950,104685535.5,6068,8870,2802,7981.035385,522.0420892
Cell 56 2013,5750,1955,104953960,5950,9931,3981,7470.690026,483.5040854
Cell 57 2013,5750,1950,104685535.5,1694,8797,7103,6984.178974,1126.24069
Cell 58 2013,5750,1949,104631850.6,5938,8815,2877,8010.107234,443.7543583
Cell 59 2013,5750,1952,104792905.3,2265,9347,7082,7419.378586,613.6705331
Cell 6 2011/12,5750,1942,104256056.4,1142,9386,8244,6480.852729,2052.243463
Cell 6 2013,5750,1943,104309741.3,5628,8930,3302,8101.93824,412.3133952
Cell 6 NE 2011/12,5750,1944,104363426.2,1470,9386,7916,6794.91358,1637.6726
Cell 6 NW 2011/12,5750,1943,104309741.3,585,9386,8801,5865.598559,2551.923476
Cell 6 SW 2011/12,5750,1943,104309741.3,234,9784,9550,6431.094184,2189.836166
Cell 60 2013,5750,1955,104953960,2390,8373,5983,6997.896675,871.8313333
Cell 61 2013,5750,1946,104470795.9,3613,8831,5218,7560.204522,675.9363566
Cell 7 2013,5750,1958,105115014.6,5313,9125,3812,8090.974464,598.1085247
Cell 9 NW 2013,5750,1946,104470795.9,-1842,9827,11669,4764.763618,2422.223625
Cell 9 SE 2013,5750,1946,104470795.9,-1842,9827,11669,4540.866393,2436.366608
Cell 9 SW 2013,5750,1948,104578165.7,-1875,9827,11702,5178.959446,2473.330202
Cell R1,5750,1941,104202371.5,1192,8189,6997,5797.476043,1984.206953
Cell R10,5750,1946,104470795.9,4285,8848,4563,7508.158787,508.4667185
Cell R100,5750,1955,104953960,1454,8711,7257,7265.104348,1315.870374
Cell R101,5750,1950,104685535.5,5222,8935,3713,7851.333846,442.5476765
Cell R104,5750,1946,104470795.9,1367,9157,7790,6899.960432,2019.92166
Cell R105,5750,1947,104524480.8,1401,9014,7613,7126.882383,1486.127447
Cell R106,5750,1950,104685535.5,1401,9014,7613,7198.734359,1389.21284
Cell R107,5750,1951,104739220.4,5832,8961,3129,7965.285495,566.9853964
Cell R11,5750,1949,104631850.6,4407,8830,4423,7896.621857,627.894886
Cell R111,5750,1950,104685535.5,1444,9642,8198,6741.290769,2062.712446
Cell R112,5750,1950,104685535.5,3061,9014,5953,7547.397436,580.9163111
Cell R113,5750,1950,104685535.5,1694,8797,7103,6984.178974,1126.24069
Cell R114,5750,1951,104739220.4,5938,8815,2877,8009.786776,444.4129948
Cell R117,5750,1948,104578165.7,1505,9931,8426,6854.01694,1796.342427
Cell R118,5750,1955,104953960,5950,9931,3981,7470.690026,483.5040854
Cell R119,5750,1946,104470795.9,1694,8797,7103,6843.284687,1193.901202
Cell R120,5750,1941,104202371.5,2116,8887,6771,7411.18135,811.3796533
Cell R121,5750,1947,104524480.8,6699,8831,2132,8046.244479,345.1322782
Cell R123,5750,1948,104578165.7,1553,9347,7794,7188.896304,1198.025849
Cell R124,5750,1955,104953960,2277,8373,6096,6932.178005,940.6363493
Cell R125,5750,1959,105168699.5,2277,8767,6490,6781.885656,1106.667139
Cell R126,5750,1955,104953960,3613,8831,5218,7411.919182,771.6569037
Cell R15,5750,1952,104792905.3,-1970,9374,11344,5287.005635,2256.428537
Cell R16,5750,1943,104309741.3,-1842,9827,11669,4761.786927,2422.970463
Cell R17,5750,1953,104846590.2,771,9230,8459,6639.28469,2075.493238
Cell R18,5750,1958,105115014.6,1571,8957,7386,6305.23238,1692.830934
Cell R19,5750,1947,104524480.8,1373,9768,8395,6682.559836,1779.711254
Cell R20,5750,1949,104631850.6,1422,8716,7294,7114.421242,1176.945517
Cell R21,5750,1949,104631850.6,1848,8838,6990,7516.512571,1150.223242
Cell R22,5750,1954,104900275.1,5511,8733,3222,7987.204708,441.3597628
Cell R24,5750,1944,104363426.2,-1875,9827,11702,5818.546811,2338.820058
Cell R25,5750,1945,104417111.1,146,9784,9638,4144.383548,2490.561276
Cell R26,5750,1944,104363426.2,585,9386,8801,5881.003601,2545.372673
Cell R27,5750,1947,104524480.8,1346,9386,8040,6536.945557,2027.638139
Cell R28,5750,1947,104524480.8,1326,9773,8447,5938.235747,2258.84045
Cell R29,5750,1949,104631850.6,1465,9773,8308,6739.050795,1745.278247
Cell R30,5750,1944,104363426.2,2057,8751,6694,7440.69856,855.0369951
Cell R31,5750,1952,104792905.3,4307,8751,4444,7853.452357,488.2365881
Cell R35,5750,1953,104846590.2,-1875,9245,11120,6336.411674,2148.204633
Cell R36,5750,1944,104363426.2,-1875,9522,11397,5845.260802,2609.96277
Cell R37,5750,1945,104417111.1,-195,9388,9583,6232.869409,2286.283483
Cell R38,5750,1956,105007644.8,981,9231,8250,5661.084356,2337.623621
Cell R39,5750,1949,104631850.6,1430,9401,7971,6735.300667,1615.21296
Cell R40,5750,1950,104685535.5,2159,9211,7052,7182.904103,1039.395253
Cell R46,5750,1948,104578165.7,-779,9915,10694,5287.688398,2745.635855
Cell R47,5750,1953,104846590.2,-779,9915,10694,5216.34767,2760.488414
Cell R48,5750,1956,105007644.8,-195,9388,9583,5403.616053,2429.776368
Cell R49,5750,1946,104470795.9,623,9388,8765,5792.746146,2269.312164
Cell R5,5750,1945,104417111,-1970,8948,10918,5667.618509,2071.414755
Cell R50,5750,1960,105222384.4,700,9569,8869,4397.106633,2415.458576
Cell R51,5750,1955,104953960,1320,9211,7891,6624.995396,1612.066955
Cell R52,5750,1954,104900275.1,2443,8808,6365,7309.41044,824.2108775
Cell R53,5750,1949,104631850.6,3421,8616,5195,7489.297075,520.3890861
Cell R54,5750,1954,104900275.1,4549,8955,4406,8158.093654,502.6417824
Cell R58,5750,1950,104685535.5,-268,9971,10239,4951.657949,2847.354807
Cell R59,5750,1945,104417111.1,258,9971,9713,6350.295116,2133.344619
Cell R6,5750,1947,104524480.8,-2000,9230,11230,6741.877761,1893.927399
Cell R60,5750,1952,104792905.3,-471,9942,10413,6714.056352,1776.896143
Cell R61,5750,1939,104095001.7,850,9982,9132,4591.24033,2672.332335
Cell R62,5750,1953,104846590.2,716,9358,8642,4655.171531,2459.746311
Cell R63,5750,1951,104739220.4,716,9348,8632,6381.742183,1808.006172
Cell R64,5750,1947,104524480.8,3349,8567,5218,7623.151515,457.9038989
Cell R65,5750,1952,104792905.3,3349,8772,5423,7970.117828,422.63926
Cell R66,5750,1958,105115014.6,5718,8955,3237,8342.983146,279.2191418
Cell R69,5750,1946,104470795.9,-506,9976,10482,4964.349435,2866.860149
Cell R7,5750,1949,104631850.6,-2000,9096,11096,6498.723961,1703.14364
Cell R70,5750,1956,105007644.8,-1894,9828,11722,5210.531186,2630.836844
Cell R71,5750,1950,104685535.5,-782,9509,10291,6115.24359,2247.494252
Cell R72,5750,1948,104578165.7,-10,9754,9764,5463.545175,2625.475853
Cell R73,5750,1952,104792905.3,-10,9982,9992,4906.653176,2756.893427
Cell R74,5750,1950,104685535.5,861,9341,8480,6294.598974,2170.318027
Cell R75,5750,1948,104578165.7,3349,9288,5939,7686.962012,428.757927
Cell R76,5750,1958,105115014.6,6478,8790,2312,8088.778856,331.7803903
Cell R77,5750,1953,104846590.2,6613,9040,2427,8222.135177,295.1870889
Cell R8,5750,1948,104578165.7,-384,8813,9197,7162.752567,1106.533577
Cell R80,5750,1940,104148686.6,-1894,9795,11689,4694.584021,2760.212518
Cell R81,5750,1945,104417111.1,-1538,9583,11121,6474.703856,2086.556141
Cell R82,5750,1953,104846590.2,-10,9874,9884,5211.869432,2672.578349
Cell R83,5750,1950,104685535.5,422,9874,9452,5643.136923,2467.098667
Cell R84,5750,1951,104739220.4,1126,9305,8179,5040.261404,2390.657707
Cell R85,5750,1957,105061329.7,1230,9341,8111,6029.918753,2152.566571
Cell R86,5750,1952,104792905.3,3796,9040,5244,7526.601947,464.0602094
Cell R87,5750,1945,104417111.1,5782,8642,2860,7784.17018,419.1192127
Cell R9,5750,1941,104202371.5,-384,8813,9197,7284.032973,1003.83012
Cell R90,5750,1947,104524480.8,784,9694,8910,6502.609656,2098.345691
Cell R91,5750,1944,104363426.2,1024,9336,8312,6615.477366,2066.396863
Cell R92,5750,1952,104792905.3,1113,9683,8570,4549.089652,2427.52974
Cell R93,5750,1942,104256056.4,1316,9284,7968,6784.516993,1653.477361
Cell R97,5750,1954,104900275.1,1282,9694,8412,6925.419652,1825.682794
Cell R98,5750,1947,104524480.8,1293,8549,7256,7200.817155,1593.143537
Cell R99,5750,1948,104578165.7,1402,8549,7147,7223.911191,1502.353755
Cell S102,5750,1953,104846590.2,5785,8935,3150,8031.373272,416.7114869
Cell S108,5750,1950,104685535.5,6068,8870,2802,7981.035385,522.0420892
Cell S13,5750,1953,104846590.2,5628,9125,3497,8160.853047,470.1494772
Cell S14,5750,1959,105168699.5,5313,9125,3812,8090.739663,598.0461053
Cell S2,5750,1944,104363426.2,5628,8930,3302,8102.211934,412.3838424
Cell S23,5750,1948,104578165.7,5543,8842,3299,8145.206879,493.9723708
Cell S32,5750,1950,104685535.5,5511,8938,3427,7967.792308,473.693542
Cell S33,5750,1948,104578165.7,5348,8876,3528,8015.502567,458.7876696
Cell S34,5750,1949,104631850.6,6616,8848,2232,8053.046178,384.190646
Cell S41,5750,1948,104578165.7,5127,8751,3624,7689.011807,418.6560613
Cell S42,5750,1945,104417111.1,5478,8915,3437,8129.942931,404.6309694
Cell S44,5750,1953,104846590.2,6649,8939,2290,8200.219662,318.4430126
Cell S56,5750,1951,104739220.4,5634,8832,3198,8002.634546,478.3140735
Cell S67,5750,1950,104685535.5,5634,8982,3348,8215.467179,420.9212847
Cell S78,5750,1951,104739220.4,6692,9040,2348,8326.790876,305.5131324
Cell S88,5750,1948,104578165.7,6188,8915,2727,8091.838296,399.7198352
Cell S94,5750,1949,104631850.6,6740,8935,2195,8069.061057,323.7889888
Cell S95,5750,1962,105329754.2,6188,8935,2747,7964.836391,419.3210366
W287,5750,1948,104578165.7,807,9196,8389,4088.529774,2103.194138
W295,5750,1949,104631850.6,1643,8825,7182,7015.133402,1582.365141
W338,5750,1943,104309741.3,692,9923,9231,4041.585178,2521.491137
W342,5750,1943,104309741.3,1013,8392,7379,5261.926402,2287.244809
W345,5750,1946,104470795.9,1581,8605,7024,7413.780062,790.2999976
W387,5750,1943,104309741.3,1191,9937,8746,5709.827586,2441.298518
W393,5750,1943,104309741.3,853,9522,8669,6161.865672,2072.192194
W440,5750,1947,104524480.8,1125,9047,7922,5676.101695,2302.506733
W441,5750,1942,104256056.4,1729,8634,6905,6928.236354,1097.985594
W445,5750,1943,104309741.3,1848,8543,6695,6758.755018,1037.786314
W500,5750,1950,104685535.5,1427,8823,7396,6221.744103,1828.98273
1,6000,2124,114026706.4,-2000,9230,11230,6620.304614,1966.056108
2,6000,2118,113704597,1373,9110,7737,6163.867328,1781.525641
3,6000,2124,114026706.4,1373,9275,7902,7060.491525,1303.168225
4,6000,2123,113973021.5,1422,8716,7294,7081.603862,1201.873902
5,6000,2122,113919336.6,-1875,9245,11120,6283.437323,2170.443796
6,6000,2117,113650912.1,1142,9386,8244,6388.169107,2108.599362
7,6000,2123,113973021.5,1326,9773,8447,6438.391427,1902.020727
8,6000,2128,114241445.9,1422,8838,7416,6966.981673,1430.934263
9,6000,2128,114241445.9,5511,8938,3427,7863.022086,411.7105638
10,6000,2115,113543542.3,-779,9915,10694,5485.991017,2657.933873
11,6000,2123,113973021.5,-195,9388,9583,5480.618935,2425.781151
12,6000,2128,114241445.9,700,9569,8869,4430.521147,2419.506758
13,6000,2125,114080391.2,1320,9211,7891,6601.244235,1640.409314
14,6000,2126,114134076.1,4359,8925,4566,7962.804798,621.0979982
16,6000,2122,113919336.6,-506,9976,10482,5149.845429,2860.077243
17,6000,2123,113973021.5,-471,9942,10413,6670.892605,1825.549286
18,6000,2119,113758281.9,850,9982,9132,4687.276074,2672.933887
19,6000,2125,114080391.2,716,9358,8642,4708.032471,2462.564124
20,6000,2123,113973021.5,3349,9288,5939,7669.957607,455.5161138
21,6000,2121,113865651.7,6613,9040,2427,8213.826968,299.7962309
22,6000,2120,113811966.8,-1894,9795,11689,4791.259906,2705.011372
23,6000,2113,113436172.6,-10,9874,9884,5329.955987,2648.499379
24,6000,2124,114026706.4,1024,9336,8312,6589.729755,2098.570763
25,6000,2116,113597227.2,1249,9284,8035,6747.684783,1713.569279
26,6000,2125,114080391.2,5782,8659,2877,7782.952,429.887743
27,6000,2124,114026706.4,1274,8549,7275,7104.422787,1735.364537
28,6000,2125,114080391.2,1401,9014,7613,7099.177412,1548.091491
29,6000,2125,114080391.2,1401,8711,7310,7212.892235,1406.081889
31,6000,2120,113811966.8,1522,9931,8409,7399.975943,1195.39761
32,6000,2125,114080391.2,1694,8797,7103,7006.744941,1103.937467
33,6000,2127,114187761,2182,9931,7749,7460.06347,552.163281
34,6000,2122,113919336.6,2390,8373,5983,6974.679548,871.0988998
10A,6000,2121,113865651.7,-779,9915,10694,5086.811881,2802.337972
10NE,6000,2120,113811966.8,-195,9915,10110,5296.162736,2805.585765
10NW,6000,2121,113865651.7,-1875,9522,11397,5795.877416,2638.43336
10SW,6000,2121,113865651.7,-779,9915,10694,5583.677982,2700.031544
11NE,6000,2113,113436172.6,-195,9388,9583,6187.177,2329.245793
11NW,6000,2126,114134076.1,-195,9388,9583,5342.731891,2572.496037
11SE,6000,2119,113758281.9,623,9388,8765,5800.330345,2278.820463
17NW,6000,2123,113973021.5,258,9971,9713,6344.363165,2132.216382
17SE,6000,2124,114026706.4,-1616,9509,11125,6046.44209,2302.005487
17SW,6000,2123,113973021.5,-1894,9828,11722,5216.610457,2626.183362
22S,6000,2121,113865651.7,-1894,9795,11689,4546.05422,2724.669776
23S,6000,2128,114241445.9,981,9773,8792,4126.381109,2291.717331
24S,6000,2123,113973021.5,784,9336,8552,6567.391427,2110.438314
27A,6000,2126,114134076.1,1284,9694,8410,6904.5127,1839.1795
2A,6000,2124,114026706.4,1571,8957,7386,6385.743409,1691.25772
5NE,6000,2119,113758281.9,-1846,9827,11673,4540.961774,2463.241783
5NW,6000,2118,113704597,-1875,9827,11702,5141.831917,2475.995235
5SE,6000,2122,113919336.6,146,9784,9638,4270.113101,2540.101468
6NE,6000,2112,113382487.7,1470,9386,7916,6738.896307,1671.849632
6NW,6000,2116,113597227.2,585,9386,8801,5858.898866,2550.933714
6SW,6000,2124,114026706.4,234,9784,9550,6354.293785,2252.569192
Cell 1 2011/12,6000,2124,114026706.4,-2000,9230,11230,6620.304614,1966.056108
Cell 1 SW 2013,6000,2124,114026706.4,-1970,9374,11344,5344.071563,2255.412811
Cell 10 2011/12,6000,2115,113543542.3,-779,9915,10694,5485.991017,2657.933873
Cell 10 NE 2011/12,6000,2120,113811966.8,-195,9915,10110,5296.162736,2805.585765
Cell 10 NW 2011/12,6000,2121,113865651.7,-1875,9522,11397,5795.877416,2638.43336
Cell 10 SE 2013,6000,2116,113597227.2,585,9386,8801,5858.898866,2550.933714
Cell 10 SW 2011/12,6000,2121,113865651.7,-779,9915,10694,5583.677982,2700.031544
Cell 10-A 2011/12,6000,2121,113865651.7,-779,9915,10694,5086.811881,2802.337972
Cell 11 NE 2011/12,6000,2113,113436172.6,-195,9388,9583,6187.177,2329.245793
Cell 11 NW 2013,6000,2123,113973021.5,1571,8957,7386,6308.882713,1707.901437
Cell 11 SW 2013,6000,2122,113919336.6,1421,9386,7965,6711.586711,1827.363985
Cell 12 2013,6000,2122,113919336.6,1326,9773,8447,6440.653157,1899.454285
Cell 13 2013,6000,2125,114080391.2,1422,8838,7416,6919.943529,1441.044935
Cell 14 2013,6000,2127,114187761,5302,8733,3431,7980.288669,456.3889451
Cell 15 2013,6000,2126,114134076.1,5348,8876,3528,8012.129821,488.6919185
Cell 15-A 2013,6000,2129,114295130.8,5348,8876,3528,8034.683419,459.5591781
Cell 16 2013,6000,2126,114134076.1,5452,8848,3396,8057.345249,414.377417
Cell 17 NW 2011/12,6000,2123,113973021.5,258,9971,9713,6344.363165,2132.216382
Cell 17 NW 2013,6000,2112,113382487.7,-1875,9827,11702,5767.100852,2363.409351
Cell 17 SE 2013,6000,2121,113865651.7,-1875,9522,11397,5795.877416,2638.43336
Cell 17 SW 2013,6000,2125,114080391.2,-1875,9245,11120,6284.240471,2177.841056
Cell 18 2011/12,6000,2119,113758281.9,850,9982,9132,4687.276074,2672.933887
Cell 18 NE 2013,6000,2123,113973021.5,234,9784,9550,6460.850683,2179.989075
Cell 18 NW 2013,6000,2116,113597227.2,146,9784,9638,4269.965974,2529.101437
Cell 18 SE 2013,6000,2113,113436172.6,-195,9388,9583,6187.177,2329.245793
Cell 18 SSE 2013,6000,2123,113973021.5,-195,9388,9583,5382.700424,2548.624571
Cell 19 NW 2013,6000,2123,113973021.5,1261,9386,8125,6493.376354,2048.501442
Cell 2 2011/12,6000,2118,113704597,1373,9110,7737,6163.867328,1781.525641
Cell 2 NE 2013,6000,2118,113704597,-2000,8957,10957,6432.635505,1730.433615
Cell 2 SW 2013,6000,2123,113973021.5,-2000,9230,11230,6620.457372,1966.506489
Cell 20 2013,6000,2125,114080391.2,1465,9773,8308,6684.716706,1758.873463
Cell 21 2013,6000,2124,114026706.4,1920,9211,7291,7195.919021,1037.413785
Cell 22 2013,6000,2125,114080391.2,4888,8751,3863,7863.926118,433.9447779
Cell 23 2013,6000,2117,113650912.1,4549,8915,4366,8096.63675,465.9947176
Cell 24 2013,6000,2122,113919336.6,6616,8848,2232,8058.065975,383.5192688
Cell 25 NE 2013,6000,2114,113489857.5,-779,9915,10694,5484.940397,2658.123352
Cell 25 SE 2013,6000,2122,113919336.6,-779,9915,10694,5584.8459,2699.931097
Cell 26 NE 2013,6000,2123,113973021.5,-195,9388,9583,5480.618935,2425.781151
Cell 26 NNW 2013,6000,2120,113811966.8,-195,9915,10110,5296.308491,2805.438699
Cell 26 NW 2013,6000,2121,113865651.7,-779,9915,10694,5086.811881,2802.337972
Cell 27 NW 2013,6000,2119,113758281.9,623,9388,8765,5800.330345,2278.820463
Cell 28 2013,6000,2128,114241445.9,700,9569,8869,4430.521147,2419.506758
Cell 29 2013,6000,2126,114134076.1,1320,9211,7891,6600.157103,1642.240647
Cell 3 NE 2013,6000,2124,114026706.4,-384,8813,9197,7188.578625,1081.455974
Cell 3 NW 2013,6000,2125,114080391.2,-2000,9096,11096,6483.063529,1706.970457
Cell 30 2013,6000,2120,113811966.8,3349,8772,5423,7966.193396,452.1229601
Cell 31 2013,6000,2125,114080391.2,4359,8955,4596,8138.245647,529.6788789
Cell 32 2013,6000,2123,113973021.5,5634,8982,3348,8214.601507,422.4494144
Cell 33 NE 2013,6000,2123,113973021.5,258,9971,9713,6344.363165,2132.216382
Cell 33 SE 2013,6000,2123,113973021.5,-1894,9828,11722,5214.306642,2627.482209
Cell 33 SW 2013,6000,2121,113865651.7,-506,9976,10482,5071.478548,2845.302113
Cell 34 N 2013,6000,2123,113973021.5,-471,9455,9926,6580.130476,1941.013116
Cell 34 NW 2013,6000,2123,113973021.5,-471,9942,10413,6670.892605,1825.549286
Cell 34 SE 2013,6000,2124,114026706.4,-1616,9509,11125,6049.146422,2300.292448
Cell 35 2013,6000,2113,113436172.6,850,9982,9132,4597.425935,2673.6155
Cell 37 2013,6000,2121,113865651.7,3349,9288,5939,7669.862329,458.81538
Cell 38 2013,6000,2124,114026706.4,6613,9040,2427,8221.132298,297.4904213
Cell 39 2013,6000,2126,114134076.1,6692,9040,2348,8320.221072,308.5032709
Cell 4 2013,6000,2124,114026706.4,4285,8848,4563,7509.109228,511.6234586
Cell 40 NE 2013,6000,2114,113489857.5,-1894,9795,11689,4729.955061,2755.143597
Cell 41 N 2013,6000,2122,113919336.6,-1894,9795,11689,6069.705467,2439.840399
Cell 41 NW 2013,6000,2124,114026706.4,-1894,9795,11689,5712.675612,2541.374936
Cell 42 NW 2013,6000,2124,114026706.4,-10,9874,9884,5308.246704,2645.10689
Cell 43 2013,6000,2126,114134076.1,1211,9341,8130,5961.462371,2195.31381
Cell 44 2013,6000,2123,113973021.5,1633,9341,7708,7445.820537,854.172125
Cell 45 2013,6000,2124,114026706.4,5782,8659,2877,7784.318267,428.059006
Cell 47 2013,6000,2124,114026706.4,784,9694,8910,6535.371469,2084.86137
Cell 48 2013,6000,2124,114026706.4,784,9336,8552,6567.553672,2109.908488
Cell 49 2013,6000,2116,113597227.2,1249,9284,8035,6747.684783,1713.569279
Cell 5 2011/12 Summer,6000,2125,114080391.2,-1875,9245,11120,6284.240471,2177.841056
Cell 5 2013,6000,2123,113973021.5,4407,8869,4462,7884.941121,649.9577847
Cell 50 2013,6000,2123,113973021.5,1401,8711,7310,7212.143665,1406.531016
Cell 51 2013,6000,2128,114241445.9,6188,8935,2747,7962.351504,419.282829
Cell 52 2013,6000,2123,113973021.5,1402,8549,7147,7179.591145,1561.533095
Cell 53 2013,6000,2125,114080391.2,1401,9014,7613,7099.177412,1548.091491
Cell 54 2013,6000,2124,114026706.4,5832,8961,3129,7958.053672,567.1670746
Cell 55 2013,6000,2130,114348815.7,6068,8870,2802,7985.3277,513.5217497
Cell 56 2013,6000,2123,113973021.5,2182,9931,7749,7461.128592,552.0320514
Cell 57 2013,6000,2125,114080391.2,1694,8797,7103,7007.180706,1104.24849
Cell 58 2013,6000,2127,114187761,5938,8870,2932,8002.669488,449.89325
Cell 59 2013,6000,2120,113811966.8,1613,9347,7734,7376.725472,760.1705799
Cell 6 2011/12,6000,2117,113650912.1,1142,9386,8244,6388.169107,2108.599362
Cell 6 2013,6000,2119,113758281.9,5628,8930,3302,8106.648891,417.6149062
Cell 6 NE 2011/12,6000,2112,113382487.7,1470,9386,7916,6738.896307,1671.849632
Cell 6 NW 2011/12,6000,2116,113597227.2,585,9386,8801,5858.898866,2550.933714
Cell 6 SW 2011/12,6000,2124,114026706.4,234,9784,9550,6354.293785,2252.569192
Cell 60 2013,6000,2125,114080391.2,2277,8373,6096,6950.380706,922.2532522
Cell 61 2013,6000,2122,113919336.6,3613,8831,5218,7562.455231,682.2363529
Cell 7 2013,6000,2125,114080391.2,5313,9137,3824,8101.160941,592.046462
Cell 9 NW 2013,6000,2118,113704597,-1842,9827,11669,4765.077432,2430.542693
Cell 9 SE 2013,6000,2120,113811966.8,-1846,9827,11673,4539.636792,2463.415939
Cell 9 SW 2013,6000,2117,113650912.1,-1875,9827,11702,5141.528106,2476.540486
Cell R1,6000,2110,113275117.9,1192,8189,6997,5782.6,1966.931434
Cell R10,6000,2124,114026706.4,4285,8848,4563,7509.109228,511.6234586
Cell R100,6000,2123,113973021.5,1401,8711,7310,7212.143665,1406.531016
Cell R101,6000,2125,114080391.2,5222,8935,3713,7844.512,452.9537169
Cell R104,6000,2122,113919336.6,1367,9157,7790,6894.232328,2000.158191
Cell R105,6000,2125,114080391.2,1401,9014,7613,7099.177412,1548.091491
Cell R106,6000,2124,114026706.4,1401,9014,7613,7196.417608,1402.514212
Cell R107,6000,2125,114080391.2,5832,8961,3129,7957.718588,567.2438611
Cell R11,6000,2123,113973021.5,4407,8869,4462,7884.941121,649.9577847
Cell R111,6000,2121,113865651.7,1444,9852,8408,6704.863272,2094.805957
Cell R112,6000,2127,114187761,3061,9014,5953,7539.359191,591.0298048
Cell R113,6000,2125,114080391.2,1694,8797,7103,7007.180706,1104.24849
Cell R114,6000,2127,114187761,5938,8870,2932,8002.669488,449.89325
Cell R117,6000,2120,113811966.8,1505,9931,8426,6826.874528,1805.434943
Cell R118,6000,2123,113973021.5,2182,9931,7749,7461.09138,552.0475961
Cell R119,6000,2125,114080391.2,1694,8797,7103,6869.074353,1178.239295
Cell R120,6000,2115,113543542.3,2116,8887,6771,7411.791962,829.6914908
Cell R121,6000,2127,114187761,6699,8831,2132,8048.252938,347.0781227
Cell R123,6000,2127,114187761,1505,9347,7842,7145.180066,1262.651205
Cell R124,6000,2126,114134076.1,2277,8373,6096,6911.613358,951.1415314
Cell R125,6000,2126,114134076.1,2277,8767,6490,6795.675447,1089.394578
Cell R126,6000,2128,114241445.9,2116,8831,6715,7376.266447,847.0144061
Cell R15,6000,2124,114026706.4,-1970,9374,11344,5344.071563,2255.412811
Cell R16,6000,2114,113489857.5,-1842,9827,11669,4756.967833,2430.38634
Cell R17,6000,2122,113919336.6,771,9230,8459,6533.696041,2159.939302
Cell R18,6000,2128,114241445.9,1571,8957,7386,6320.990132,1701.998268
Cell R19,6000,2121,113865651.7,1373,9768,8395,6649.605846,1771.793058
Cell R20,6000,2125,114080391.2,1422,8716,7294,7112.959059,1203.523813
Cell R21,6000,2125,114080391.2,1676,8838,7162,7485.298824,1202.241262
Cell R22,6000,2127,114187761,5302,8733,3431,7980.288669,456.3889451
Cell R24,6000,2112,113382487.7,-1875,9827,11702,5767.100852,2363.409351
Cell R25,6000,2116,113597227.2,146,9784,9638,4270.074197,2529.246515
Cell R26,6000,2120,113811966.8,585,9386,8801,5866.094811,2549.467471
Cell R27,6000,2123,113973021.5,1261,9386,8125,6493.376354,2048.501442
Cell R28,6000,2124,114026706.4,1326,9773,8447,5905.711394,2269.333424
Cell R29,6000,2124,114026706.4,1465,9773,8308,6686.45339,1757.464998
Cell R30,6000,2124,114026706.4,2057,8751,6694,7433.679379,880.1306509
Cell R31,6000,2125,114080391.2,4307,8751,4444,7844.033882,510.7298932
Cell R35,6000,2123,113973021.5,-1875,9245,11120,6282.943005,2178.453273
Cell R36,6000,2121,113865651.7,-1875,9522,11397,5795.877416,2638.43336
Cell R37,6000,2114,113489857.5,-195,9388,9583,6187.746925,2328.842178
Cell R38,6000,2123,113973021.5,981,9231,8250,5620.446067,2347.219159
Cell R39,6000,2122,113919336.6,1430,9715,8285,6713.569274,1657.30673
Cell R40,6000,2124,114026706.4,1920,9211,7291,7195.923258,1037.416152
Cell R46,6000,2121,113865651.7,-779,9915,10694,5269.001886,2760.400134
Cell R47,6000,2121,113865651.7,-779,9915,10694,5086.811881,2802.337972
Cell R48,6000,2122,113919336.6,-195,9388,9583,5479.714892,2425.99508
Cell R49,6000,2118,113704597,623,9388,8765,5799.813031,2279.233969
Cell R5,6000,2115,113543542.3,-1970,8948,10918,5709.807092,2055.110819
Cell R50,6000,2128,114241445.9,700,9569,8869,4430.521147,2419.506758
Cell R51,6000,2127,114187761,1320,9211,7891,6611.651622,1630.765691
Cell R52,6000,2126,114134076.1,2443,8808,6365,7316.415334,821.2619446
Cell R53,6000,2124,114026706.4,3421,8616,5195,7496.776836,527.6699975
Cell R54,6000,2124,114026706.4,4359,8955,4596,8138.335687,529.7872942
Cell R58,6000,2125,114080391.2,-268,9971,10239,5031.420706,2853.676718
Cell R59,6000,2123,113973021.5,258,9971,9713,6344.363165,2132.216382
Cell R6,6000,2124,114026706.4,-2000,9230,11230,6620.572976,1966.050725
Cell R60,6000,2124,114026706.4,-471,9942,10413,6672.145009,1826.031522
Cell R61,6000,2113,113436172.6,850,9982,9132,4597.425935,2673.6155
Cell R62,6000,2122,113919336.6,716,9358,8642,4642.140434,2466.256975
Cell R63,6000,2124,114026706.4,716,9348,8632,6348.416196,1846.94654
Cell R64,6000,2128,114241445.9,3349,8632,5283,7621.289944,475.5377329
Cell R65,6000,2120,113811966.8,3349,8772,5423,7966.193396,452.1229601
Cell R66,6000,2124,114026706.4,5718,8955,3237,8329.520716,289.130297
Cell R69,6000,2122,113919336.6,-506,9976,10482,5072.53393,2845.046819
Cell R7,6000,2124,114026706.4,-2000,9096,11096,6482.614878,1707.246972
Cell R70,6000,2122,113919336.6,-1894,9828,11722,5216.156456,2626.718794
Cell R71,6000,2124,114026706.4,-1616,9509,11125,6049.146422,2300.292448
Cell R72,6000,2125,114080391.2,-10,9754,9764,5507.52,2601.728555
Cell R73,6000,2125,114080391.2,-10,9982,9992,4846.560471,2748.190335
Cell R74,6000,2125,114080391.2,861,9341,8480,6260.648941,2180.204417
Cell R75,6000,2122,113919336.6,3349,9288,5939,7669.538643,458.9494218
Cell R76,6000,2122,113919336.6,6478,8790,2312,8087.93591,335.3299564
Cell R77,6000,2125,114080391.2,6613,9040,2427,8220.936941,297.5566568
Cell R8,6000,2124,114026706.4,-384,8813,9197,7118.355932,1141.216861
Cell R80,6000,2114,113489857.5,-1894,9795,11689,4729.955061,2755.143597
Cell R81,6000,2123,113973021.5,-1538,9583,11121,6445.546397,2093.190549
Cell R82,6000,2124,114026706.4,-10,9874,9884,5308.246704,2645.10689
Cell R83,6000,2126,114134076.1,422,9874,9452,5712.142992,2462.951132
Cell R84,6000,2124,114026706.4,1113,9341,8228,5078.987759,2400.459094
Cell R85,6000,2126,114134076.1,1211,9341,8130,5961.462371,2195.31381
Cell R86,6000,2125,114080391.2,1682,9040,7358,7525.782118,550.2783886
Cell R87,6000,2124,114026706.4,5782,8659,2877,7784.318267,428.059006
Cell R9,6000,2115,113543542.3,-384,8813,9197,7275.757447,1013.447256
Cell R90,6000,2124,114026706.4,784,9694,8910,6535.371469,2084.86137
Cell R91,6000,2125,114080391.2,784,9336,8552,6567.909647,2109.475777
Cell R92,6000,2125,114080391.2,1113,9683,8570,4656.847059,2437.993031
Cell R93,6000,2115,113543542.3,1249,9284,8035,6747.232624,1713.848125
Cell R97,6000,2126,114134076.1,1282,9694,8412,6955.693321,1800.458918
Cell R98,6000,2124,114026706.4,1274,8549,7275,7104.422787,1735.364537
Cell R99,6000,2122,113919336.6,1402,8549,7147,7179.510368,1561.819386
Cell S102,6000,2125,114080391.2,5785,8935,3150,8026.431529,417.3300307
Cell S108,6000,2130,114348815.7,6068,8870,2802,7985.3277,513.5217497
Cell S13,6000,2125,114080391.2,5628,9125,3497,8161.974588,466.6466761
Cell S14,6000,2125,114080391.2,5313,9137,3824,8101.160941,592.046462
Cell S2,6000,2120,113811966.8,5628,8930,3302,8106.823585,417.5938365
Cell S23,6000,2129,114295130.8,5543,8842,3299,8143.048849,494.1512334
Cell S32,6000,2125,114080391.2,5511,8938,3427,7967.904,475.7957082
Cell S33,6000,2129,114295130.8,5348,8876,3528,8034.683419,459.5591781
Cell S34,6000,2122,113919336.6,6616,8848,2232,8058.065975,383.5192688
Cell S41,6000,2125,114080391.2,5127,8751,3624,7687.691294,415.3282685
Cell S42,6000,2116,113597227.2,4549,8915,4366,8096.502363,466.0638018
Cell S44,6000,2124,114026706.4,6649,8939,2290,8197.741525,320.1984768
Cell S56,6000,2125,114080391.2,5634,8832,3198,8010.491765,472.1953779
Cell S67,6000,2122,113919336.6,5634,8982,3348,8214.923657,422.2881522
Cell S78,6000,2127,114187761,6692,9040,2348,8320.374706,308.5120792
Cell S88,6000,2124,114026706.4,6188,8915,2727,8090.666667,396.6150242
Cell S94,6000,2125,114080391.2,6717,8935,2218,8060.825412,330.2945283
Cell S95,6000,2128,114241445.9,6188,8935,2747,7962.351504,419.282829
W287,6000,2122,113919336.6,807,9196,8389,4095.341188,2092.57475
W295,6000,2124,114026706.4,1643,8825,7182,7008.37194,1593.641412
W338,6000,2115,113543542.3,692,9923,9231,3992.149409,2507.289129
W342,6000,2117,113650912.1,1013,8392,7379,5224.290033,2315.191564
W345,6000,2124,114026706.4,1581,8605,7024,7400.464218,830.5664587
W387,6000,2120,113811966.8,1191,9937,8746,5642.046226,2464.948957
W393,6000,2114,113489857.5,853,9522,8669,6108.015137,2112.59993
W440,6000,2121,113865651.7,1125,9047,7922,5700.459217,2309.387323
W441,6000,2122,113919336.6,1729,8634,6905,6883.685674,1170.701576
W445,6000,2114,113489857.5,1848,8543,6695,6756.666982,1064.326692
W500,6000,2122,113919336.6,1427,8823,7396,6237.565975,1807.417734
1,6250,2301,123528931.9,-2000,9230,11230,6534.500217,1998.870398
2,6250,2301,123528931.9,1373,9110,7737,6165.110387,1805.280344
3,6250,2302,123582616.8,1373,9275,7902,7013.507819,1360.411509
4,6250,2305,123743671.5,1422,8716,7294,7088.308894,1210.559402
5,6250,2299,123421562.1,-1875,9245,11120,6230.478034,2198.858946
6,6250,2301,123528931.9,1142,9386,8244,6309.136462,2148.090895
7,6250,2301,123528931.9,1326,9773,8447,6381.803998,1946.350666
8,6250,2303,123636301.7,1422,8838,7416,6998.574902,1412.494182
9,6250,2302,123582616.8,5511,8938,3427,7870.581668,413.4659578
10,6250,2304,123689986.6,-779,9915,10694,5436.559462,2689.017161
11,6250,2303,123636301.7,-195,9388,9583,5561.583587,2421.644451
12,6250,2304,123689986.6,700,9569,8869,4421.940104,2414.840608
13,6250,2305,123743671.4,1320,9211,7891,6571.750976,1670.356685
14,6250,2302,123582616.8,4359,8925,4566,7968.630321,609.6260887
16,6250,2305,123743671.5,-506,9976,10482,5213.799566,2837.864937
17,6250,2304,123689986.6,-471,9942,10413,6597.646267,1912.181372
18,6250,2301,123528931.9,850,9982,9132,4731.141678,2676.91886
19,6250,2302,123582616.8,716,9358,8642,4689.251955,2469.187147
20,6250,2303,123636301.7,3349,9288,5939,7650.838472,476.7945118
21,6250,2304,123689986.6,6613,9040,2427,8211.734375,307.7099014
22,6250,2300,123475247,-1894,9795,11689,4785.833478,2713.377238
23,6250,2305,123743671.4,-10,9874,9884,5419.26551,2616.834892
24,6250,2306,123797356.3,784,9336,8552,6545.826973,2128.063161
25,6250,2306,123797356.3,1249,9284,8035,6698.663487,1783.792392
26,6250,2302,123582616.8,5782,8692,2910,7783.052997,433.337035
27,6250,2300,123475247,1273,8920,7647,7027.64913,1830.97872
28,6250,2302,123582616.8,1401,9069,7668,7087.249348,1580.242768
29,6250,2305,123743671.4,1401,8734,7333,7160.299783,1501.881492
31,6250,2307,123851041.2,1522,9931,8409,7340.963589,1289.395526
32,6250,2304,123689986.6,1694,8797,7103,7034.262153,1084.077893
33,6250,2306,123797356.3,2182,9931,7749,7447.987424,632.7100067
34,6250,2302,123582616.8,2390,8373,5983,6955.579496,886.5761431
10A,6250,2307,123851041.2,-779,9915,10694,4982.805375,2827.59591
10NE,6250,2302,123582616.8,-195,9915,10110,5207.659427,2798.206044
10NW,6250,2297,123314192.3,-1875,9522,11397,5750.450152,2651.566647
10SW,6250,2308,123904726.1,-779,9915,10694,5602.818024,2700.920216
11NE,6250,2301,123528931.9,-195,9388,9583,6122.116471,2375.512415
11NW,6250,2304,123689986.6,-195,9388,9583,5388.378906,2567.07142
11SE,6250,2301,123528931.9,623,9388,8765,5811.29422,2289.4979
17NW,6250,2299,123421562.1,-471,9971,10442,6333.751631,2141.471165
17SE,6250,2302,123582616.8,-1616,9509,11125,5951.705039,2379.736214
17SW,6250,2305,123743671.5,-1894,9828,11722,5235.5718,2631.457511
22S,6250,2299,123421562.1,-1894,9795,11689,4536.039582,2723.729085
23S,6250,2305,123743671.5,981,9773,8792,4233.449024,2312.230493
24S,6250,2299,123421562.1,784,9336,8552,6539.53458,2129.393562
27A,6250,2304,123689986.6,1282,9694,8412,6905.075955,1833.163094
2A,6250,2303,123636301.7,1254,8957,7703,6413.280069,1691.068565
5NE,6250,2299,123421562.1,-1875,9827,11702,4544.955198,2496.271967
5NW,6250,2300,123475247,-1875,9827,11702,5125.018696,2481.144344
5SE,6250,2306,123797356.3,146,9784,9638,4418.169558,2577.856616
6NE,6250,2303,123636301.7,1470,9386,7916,6690.948762,1705.039918
6NW,6250,2304,123689986.6,585,9386,8801,5873.918403,2536.180208
6SW,6250,2300,123475247,108,9784,9676,6292.768261,2306.665042
Cell 1 2011/12,6250,2301,123528931.9,-2000,9230,11230,6534.500217,1998.870398
Cell 1 SW 2013,6250,2303,123636301.7,-1970,9374,11344,5398.499783,2258.247459
Cell 10 2011/12,6250,2304,123689986.6,-779,9915,10694,5436.559462,2689.017161
Cell 10 NE 2011/12,6250,2302,123582616.8,-195,9915,10110,5207.659427,2798.206044
Cell 10 NW 2011/12,6250,2297,123314192.3,-1875,9522,11397,5750.450152,2651.566647
Cell 10 SE 2013,6250,2304,123689986.6,585,9386,8801,5873.918403,2536.180208
Cell 10 SW 2011/12,6250,2308,123904726.1,-779,9915,10694,5602.818024,2700.920216
Cell 10-A 2011/12,6250,2307,123851041.2,-779,9915,10694,4982.805375,2827.59591
Cell 11 NE 2011/12,6250,2301,123528931.9,-195,9388,9583,6122.116471,2375.512415
Cell 11 NW 2013,6250,2303,123636301.7,1571,8957,7386,6330.907512,1718.024476
Cell 11 SW 2013,6250,2302,123582616.8,1421,9386,7965,6656.573414,1873.981175
Cell 12 2013,6250,2299,123421562.1,1326,9773,8447,6381.913441,1947.110784
Cell 13 2013,6250,2302,123582616.8,1422,8838,7416,6956.990009,1421.338802
Cell 14 2013,6250,2307,123851041.2,4307,8733,4426,7964.120069,488.6939574
Cell 15 2013,6250,2305,123743671.4,5348,8876,3528,8014.870282,495.9782674
Cell 15-A 2013,6250,2300,123475247,5348,8876,3528,8052.607391,459.8267625
Cell 16 2013,6250,2302,123582616.8,5452,8848,3396,8069.968288,412.4212242
Cell 17 NW 2011/12,6250,2299,123421562.1,-471,9971,10442,6333.751631,2141.471165
Cell 17 NW 2013,6250,2302,123582616.8,-1875,9827,11702,5708.320591,2386.21631
Cell 17 SE 2013,6250,2298,123367877.2,-1875,9522,11397,5748.923412,2651.999305
Cell 17 SW 2013,6250,2302,123582616.8,-1875,9245,11120,6232.28801,2203.941195
Cell 18 2011/12,6250,2301,123528931.9,850,9982,9132,4731.141678,2676.91886
Cell 18 NE 2013,6250,2303,123636301.7,234,9784,9550,6409.864959,2223.07853
Cell 18 NW 2013,6250,2300,123475247,146,9784,9638,4398.306957,2558.160098
Cell 18 SE 2013,6250,2302,123582616.8,-195,9388,9583,6120.571677,2376.15213
Cell 18 SSE 2013,6250,2299,123421562.1,-195,9388,9583,5420.776425,2543.193697
Cell 19 NW 2013,6250,2301,123528931.9,1210,9386,8176,6434.932638,2074.602544
Cell 2 2011/12,6250,2301,123528931.9,1373,9110,7737,6165.110387,1805.280344
Cell 2 NE 2013,6250,2299,123421562.1,-2000,8957,10957,6451.709874,1733.586676
Cell 2 SW 2013,6250,2301,123528931.9,-2000,9230,11230,6533.257714,2000.228374
Cell 20 2013,6250,2304,123689986.6,1465,9773,8308,6623.28342,1786.01064
Cell 21 2013,6250,2304,123689986.6,1920,9211,7291,7210.094184,1030.803333
Cell 22 2013,6250,2301,123528931.9,4888,8751,3863,7866.182529,446.6799897
Cell 23 2013,6250,2305,123743671.4,4549,8915,4366,8075.196095,488.8772162
Cell 24 2013,6250,2301,123528931.9,6616,8848,2232,8060.164276,381.8624695
Cell 25 NE 2013,6250,2302,123582616.8,-779,9915,10694,5436.739357,2689.017617
Cell 25 SE 2013,6250,2308,123904726.1,-779,9915,10694,5602.670277,2700.795997
Cell 26 NE 2013,6250,2304,123689986.6,-195,9388,9583,5562.585938,2421.596662
Cell 26 NNW 2013,6250,2302,123582616.8,-195,9915,10110,5207.659427,2798.206044
Cell 26 NW 2013,6250,2307,123851041.2,-779,9915,10694,4982.805375,2827.59591
Cell 27 NW 2013,6250,2301,123528931.9,623,9388,8765,5811.135593,2289.364781
Cell 28 2013,6250,2305,123743671.5,700,9569,8869,4421.762256,2414.331817
Cell 29 2013,6250,2304,123689986.6,1320,9211,7891,6571.121962,1670.246869
Cell 3 NE 2013,6250,2303,123636301.7,-384,8813,9197,7153.683891,1124.121561
Cell 3 NW 2013,6250,2301,123528931.9,-2000,9096,11096,6471.478053,1717.207399
Cell 30 2013,6250,2302,123582616.8,3349,8777,5428,7963.93093,457.486835
Cell 31 2013,6250,2306,123797356.3,4359,8955,4596,8122.369905,540.8764896
Cell 32 2013,6250,2303,123636301.7,5634,8982,3348,8215.961355,420.4841747
Cell 33 NE 2013,6250,2299,123421562.1,-471,9971,10442,6333.751631,2141.471165
Cell 33 SE 2013,6250,2304,123689986.6,-1894,9828,11722,5234.746094,2632.3629
Cell 33 SW 2013,6250,2303,123636301.7,-506,9976,10482,5179.900999,2817.156438
Cell 34 N 2013,6250,2304,123689986.6,-471,9455,9926,6548.473958,1969.786745
Cell 34 NW 2013,6250,2303,123636301.7,-471,9942,10413,6597.202779,1912.478007
Cell 34 SE 2013,6250,2303,123636301.7,-1616,9509,11125,5949.250543,2382.640129
Cell 35 2013,6250,2303,123636301.7,850,9982,9132,4603.066435,2676.214546
Cell 37 2013,6250,2303,123636301.7,3349,9288,5939,7650.909249,476.7243555
Cell 38 2013,6250,2309,123958411,6613,9040,2427,8218.816804,304.0011351
Cell 39 2013,6250,2305,123743671.5,6692,9040,2348,8311.728416,311.7540259
Cell 4 2013,6250,2300,123475247,4285,8848,4563,7504.023913,531.5954688
Cell 40 NE 2013,6250,2304,123689986.6,-1894,9795,11689,4747.088976,2742.777534
Cell 41 N 2013,6250,2305,123743671.4,-1894,9795,11689,6030.696746,2454.309652
Cell 41 NW 2013,6250,2302,123582616.8,-1894,9795,11689,5686.467854,2534.740122
Cell 42 NW 2013,6250,2308,123904726.1,-10,9874,9884,5403.664645,2619.407288
Cell 43 2013,6250,2309,123958411,1211,9341,8130,5911.792118,2222.287199
Cell 44 2013,6250,2307,123851041.2,1570,9341,7771,7400.961855,974.8830458
Cell 45 2013,6250,2302,123582616.8,5782,8692,2910,7784.85013,432.4404276
Cell 47 2013,6250,2304,123689986.6,651,9694,9043,6558.394097,2070.374887
Cell 48 2013,6250,2300,123475247,784,9336,8552,6535.241739,2131.727075
Cell 49 2013,6250,2307,123851041.2,1249,9284,8035,6697.573906,1784.173116
Cell 5 2011/12 Summer,6250,2302,123582616.8,-1875,9245,11120,6232.28801,2203.941195
Cell 5 2013,6250,2302,123582616.8,4285,8869,4584,7876.678106,661.2820173
Cell 50 2013,6250,2305,123743671.4,1401,8734,7333,7160.299783,1501.881492
Cell 51 2013,6250,2309,123958411,6188,8935,2747,7961.644435,421.0621842
Cell 52 2013,6250,2302,123582616.8,1402,8969,7567,7139.745439,1611.817386
Cell 53 2013,6250,2300,123475247,1401,9069,7668,7086.636957,1580.78062
Cell 54 2013,6250,2303,123636301.7,5726,8961,3235,7955.692141,563.855943
Cell 55 2013,6250,2305,123743671.4,6068,8870,2802,7987.330152,504.6228659
Cell 56 2013,6250,2306,123797356.3,2182,9931,7749,7447.402428,631.6657738
Cell 57 2013,6250,2304,123689986.6,1694,8797,7103,7034.044271,1084.044359
Cell 58 2013,6250,2303,123636301.7,5832,8870,3038,7994.557099,458.0583928
Cell 59 2013,6250,2302,123582616.8,1605,9347,7742,7315.786707,919.0298828
Cell 6 2011/12,6250,2301,123528931.9,1142,9386,8244,6309.136462,2148.090895
Cell 6 2013,6250,2304,123689986.6,5628,8930,3302,8108.786024,418.3316191
Cell 6 NE 2011/12,6250,2303,123636301.7,1470,9386,7916,6690.948762,1705.039918
Cell 6 NW 2011/12,6250,2304,123689986.6,585,9386,8801,5873.918403,2536.180208
Cell 6 SW 2011/12,6250,2300,123475247,108,9784,9676,6292.768261,2306.665042
Cell 60 2013,6250,2309,123958411,2277,8373,6096,6919.922044,948.8911456
Cell 61 2013,6250,2308,123904726.1,3613,8831,5218,7557.62695,695.5414452
Cell 7 2013,6250,2307,123851041.2,5313,9137,3824,8112.073689,586.2158847
Cell 9 NW 2013,6250,2301,123528931.9,-1842,9827,11669,4784.132116,2439.197885
Cell 9 SE 2013,6250,2299,123421562.1,-1875,9827,11702,4544.955198,2496.271967
Cell 9 SW 2013,6250,2300,123475247,-1875,9827,11702,5119.297391,2482.398429
Cell R1,6250,2307,123851041.2,1192,8189,6997,5775.258778,1941.134308
Cell R10,6250,2301,123528931.9,4285,8848,4563,7504.072143,531.4849753
Cell R100,6250,2305,123743671.4,1401,8734,7333,7160.299783,1501.881492
Cell R101,6250,2301,123528931.9,5222,8935,3713,7842.10691,465.4622119
Cell R104,6250,2302,123582616.8,1367,9157,7790,6878.688532,1987.314772
Cell R105,6250,2302,123582616.8,1401,9069,7668,7087.249348,1580.242768
Cell R106,6250,2302,123582616.8,1401,9014,7613,7192.844049,1410.245208
Cell R107,6250,2302,123582616.8,5726,8961,3235,7955.879235,563.9069259
Cell R11,6250,2302,123582616.8,4285,8869,4584,7876.678106,661.2820173
Cell R111,6250,2300,123475247,1444,9931,8487,6684.047826,2115.137693
Cell R112,6250,2302,123582616.8,2636,9014,6378,7525.443962,622.0705177
Cell R113,6250,2304,123689986.6,1694,8797,7103,7034.044271,1084.044359
Cell R114,6250,2302,123582616.8,5832,8870,3038,7994.736751,458.0767497
Cell R117,6250,2302,123582616.8,1505,9931,8426,6787.640747,1820.084501
Cell R118,6250,2305,123743671.4,2182,9931,7749,7447.798265,631.5167725
Cell R119,6250,2300,123475247,1694,8887,7193,6890.716087,1160.555169
Cell R120,6250,2309,123958411,2116,8887,6771,7404.281074,867.0794297
Cell R121,6250,2302,123582616.8,5960,8831,2871,8048.694613,355.5478796
Cell R123,6250,2301,123528931.9,1505,9347,7842,7098.425033,1325.420345
Cell R124,6250,2308,123904726.1,2277,8373,6096,6895.260399,962.2406744
Cell R125,6250,2306,123797356.3,2277,8767,6490,6810.821769,1070.744215
Cell R126,6250,2306,123797356.3,2116,8831,6715,7345.094102,905.3831442
Cell R15,6250,2303,123636301.7,-1970,9374,11344,5398.499783,2258.247459
Cell R16,6250,2301,123528931.9,-1842,9827,11669,4787.381139,2442.839705
Cell R17,6250,2302,123582616.8,585,9230,8645,6438.664639,2225.15041
Cell R18,6250,2303,123636301.7,1571,8957,7386,6329.154147,1716.471753
Cell R19,6250,2300,123475247,1373,9768,8395,6646.273478,1744.876068
Cell R20,6250,2303,123636301.7,1422,8716,7294,7113.154581,1224.621735
Cell R21,6250,2305,123743671.4,1423,8838,7415,7451.951844,1246.976367
Cell R22,6250,2307,123851041.2,4307,8733,4426,7963.841352,488.5191089
Cell R24,6250,2302,123582616.8,-1875,9827,11702,5705.964379,2387.572788
Cell R25,6250,2299,123421562.1,146,9784,9638,4399.508482,2558.067473
Cell R26,6250,2298,123367877.2,585,9386,8801,5880.011314,2539.357011
Cell R27,6250,2301,123528931.9,1210,9386,8176,6434.932638,2074.602544
Cell R28,6250,2300,123475247,1326,9773,8447,5873.297826,2269.788595
Cell R29,6250,2304,123689986.6,1465,9773,8308,6623.28342,1786.01064
Cell R30,6250,2300,123475247,2057,8751,6694,7431.291304,890.7831705
Cell R31,6250,2308,123904726.1,4307,8751,4444,7838.649047,526.6064017
Cell R35,6250,2302,123582616.8,-1875,9245,11120,6232.28801,2203.941195
Cell R36,6250,2298,123367877.2,-1875,9522,11397,5748.923412,2651.999305
Cell R37,6250,2301,123528931.9,-195,9388,9583,6122.116471,2375.512415
Cell R38,6250,2305,123743671.4,981,9231,8250,5582.005206,2366.456989
Cell R39,6250,2300,123475247,1430,9773,8343,6661.031304,1727.197579
Cell R40,6250,2305,123743671.5,1920,9211,7291,7209.465076,1031.022018
Cell R46,6250,2303,123636301.7,-779,9951,10730,5268.351281,2769.848542
Cell R47,6250,2307,123851041.2,-779,9915,10694,4982.805375,2827.59591
Cell R48,6250,2305,123743671.4,-195,9388,9583,5563.582646,2421.543962
Cell R49,6250,2300,123475247,623,9388,8765,5810.062609,2289.283894
Cell R5,6250,2302,123582616.8,-1970,8948,10918,5755.610773,2036.397833
Cell R50,6250,2302,123582616.8,700,9569,8869,4420.910078,2414.032444
Cell R51,6250,2306,123797356.3,1320,9211,7891,6578.359931,1664.736594
Cell R52,6250,2306,123797356.3,2443,8808,6365,7324.959237,812.4372224
Cell R53,6250,2302,123582616.8,3421,8651,5230,7504.461338,529.812062
Cell R54,6250,2306,123797356.3,4359,8955,4596,8122.369905,540.8764896
Cell R58,6250,2301,123528931.9,-268,9976,10244,5071.938722,2844.511928
Cell R59,6250,2300,123475247,-471,9971,10442,6333.95087,2141.02689
Cell R6,6250,2301,123528931.9,-2000,9230,11230,6533.257714,2000.228374
Cell R60,6250,2304,123689986.6,-471,9942,10413,6597.646267,1912.181372
Cell R61,6250,2303,123636301.7,850,9982,9132,4603.066435,2676.214546
Cell R62,6250,2303,123636301.7,716,9358,8642,4622.17195,2472.586844
Cell R63,6250,2306,123797356.3,716,9348,8632,6299.208586,1882.836583
Cell R64,6250,2302,123582616.8,3349,8690,5341,7616.764118,505.3720778
Cell R65,6250,2301,123528931.9,3349,8777,5428,7963.598001,457.3073418
Cell R66,6250,2310,124012095.9,5718,8955,3237,8316.77013,297.1439293
Cell R69,6250,2304,123689986.6,-506,9976,10482,5180.592448,2816.740467
Cell R7,6250,2301,123528931.9,-2000,9096,11096,6471.478053,1717.207399
Cell R70,6250,2305,123743671.4,-1894,9828,11722,5235.288069,2631.9204
Cell R71,6250,2303,123636301.7,-1616,9509,11125,5952.152844,2380.501762
Cell R72,6250,2304,123689986.6,-10,9754,9764,5560.579427,2586.202986
Cell R73,6250,2308,123904726.1,-10,9982,9992,4804.954939,2749.897317
Cell R74,6250,2301,123528931.9,861,9341,8480,6224.324641,2206.260239
Cell R75,6250,2302,123582616.8,3349,9288,5939,7650.687663,476.709302
Cell R76,6250,2309,123958411,6478,8790,2312,8086.888696,337.5578486
Cell R77,6250,2309,123958411,6613,9040,2427,8218.816804,304.0011351
Cell R8,6250,2298,123367877.2,-384,8813,9197,7081.734552,1179.462921
Cell R80,6250,2305,123743671.4,-1894,9795,11689,4748.503254,2743.022662
Cell R81,6250,2299,123421562.1,-1538,9583,11121,6393.879078,2121.228425
Cell R82,6250,2308,123904726.1,-10,9874,9884,5403.664645,2619.407288
Cell R83,6250,2303,123636301.7,422,9874,9452,5780.146765,2454.15063
Cell R84,6250,2302,123582616.8,1032,9341,8309,5122.129453,2408.514965
Cell R85,6250,2309,123958411,1211,9341,8130,5911.792118,2222.287199
Cell R86,6250,2302,123582616.8,1682,9040,7358,7512.380104,648.3836585
Cell R87,6250,2303,123636301.7,5782,8692,2910,7784.247503,433.3122613
Cell R9,6250,2301,123528931.9,-384,8813,9197,7266.89787,1026.14002
Cell R90,6250,2303,123636301.7,651,9694,9043,6557.956144,2070.717631
Cell R91,6250,2301,123528931.9,784,9336,8552,6535.90352,2131.500108
Cell R92,6250,2303,123636301.7,1032,9683,8651,4756.833695,2443.702683
Cell R93,6250,2307,123851041.2,1249,9284,8035,6697.573906,1784.173116
Cell R97,6250,2303,123636301.7,1282,9694,8412,6973.592271,1788.599081
Cell R98,6250,2300,123475247,1273,8920,7647,7027.64913,1830.97872
Cell R99,6250,2301,123528931.9,1402,8969,7567,7142.068231,1608.310981
Cell S102,6250,2304,123689986.6,5785,8935,3150,8022.44401,414.4963795
Cell S108,6250,2305,123743671.4,6068,8870,2802,7987.330152,504.6228659
Cell S13,6250,2305,123743671.4,5628,9125,3497,8167.488503,462.4789349
Cell S14,6250,2306,123797356.3,5313,9137,3824,8112.117086,586.3392726
Cell S2,6250,2305,123743671.4,5628,8930,3302,8108.813449,418.2429365
Cell S23,6250,2300,123475247,5543,8842,3299,8144.632174,491.5409739
Cell S32,6250,2304,123689986.6,5348,8938,3590,7961.409722,480.1788373
Cell S33,6250,2300,123475247,5348,8876,3528,8052.607391,459.8267625
Cell S34,6250,2301,123528931.9,6616,8848,2232,8060.164276,381.8624695
Cell S41,6250,2305,123743671.4,5127,8751,3624,7685.895011,417.7651275
Cell S42,6250,2305,123743671.4,4549,8915,4366,8075.230803,488.8563994
Cell S44,6250,2306,123797356.3,6649,8939,2290,8191.082394,327.1786304
Cell S56,6250,2307,123851041.2,5634,8832,3198,8015.370178,468.9103666
Cell S67,6250,2303,123636301.7,5634,8982,3348,8216.846722,418.8155449
Cell S78,6250,2305,123743671.5,6692,9040,2348,8311.728416,311.7540259
Cell S88,6250,2302,123582616.8,6077,8921,2844,8088.095569,399.2958828
Cell S94,6250,2300,123475247,6602,8935,2333,8046.031304,345.1290331
Cell S95,6250,2309,123958411,6188,8935,2747,7961.644435,421.0621842
W287,6250,2304,123689986.6,807,9196,8389,4094.921007,2081.240422
W295,6250,2301,123528931.9,1643,8825,7182,6984.167753,1618.666203
W338,6250,2303,123636301.7,692,9923,9231,3932.224056,2480.179885
W342,6250,2301,123528931.9,1013,8392,7379,5211.876141,2330.63719
W345,6250,2300,123475247,1581,8605,7024,7385.922174,862.4897955
W387,6250,2296,123260507.4,1182,9937,8755,5583.455139,2473.860175
W393,6250,2299,123421562.1,853,9522,8669,6045.863854,2150.529081
W440,6250,2305,123743671.4,1125,9047,7922,5708.269414,2322.500128
W441,6250,2299,123421562.1,1617,8634,7017,6823.820792,1266.61944
W445,6250,2304,123689986.6,1848,8692,6844,6762.06467,1070.963273
W500,6250,2301,123528931.9,1427,8823,7396,6253.610604,1782.843526
1,6500,2488,133568006.3,-2000,9230,11230,6447.515273,2033.232722
2,6500,2489,133621691.2,1373,9110,7737,6157.531941,1827.445014
3,6500,2486,133460636.5,1373,9275,7902,6981.676589,1403.437079
4,6500,2492,133782745.9,1422,8716,7294,7089.617978,1214.618991
5,6500,2493,133836430.8,-1875,9245,11120,6153.464902,2243.135566
6,6500,2492,133782745.9,1142,9386,8244,6262.974318,2155.013225
7,6500,2491,133729061,1326,9773,8447,6292.916098,2012.085038
8,6500,2491,133729061,1422,8838,7416,7025.96387,1393.326872
9,6500,2490,133675376.1,5511,8938,3427,7880.458233,416.9082947
10,6500,2494,133890115.7,-779,9915,10694,5407.137931,2708.288862
11,6500,2488,133568006.3,-195,9388,9583,5622.910772,2421.309749
12,6500,2489,133621691.2,700,9943,9243,4401.783447,2420.41526
13,6500,2489,133621691.2,1210,9211,8001,6538.39775,1701.039365
14,6500,2493,133836430.8,4359,8925,4566,7976.910951,598.1660615
16,6500,2488,133568006.3,-506,9981,10487,5282.607717,2809.120948
17,6500,2485,133406951.7,-782,9942,10724,6541.076861,1970.534056
18,6500,2491,133729061,850,9982,9132,4738.801686,2669.05871
19,6500,2496,133997485.4,716,9358,8642,4676.161058,2478.663077
20,6500,2492,133782745.9,3349,9288,5939,7638.941814,493.1831691
21,6500,2493,133836430.8,6613,9040,2427,8208.685921,312.0858704
22,6500,2490,133675376.1,-1894,9795,11689,4755.875502,2722.978103
23,6500,2489,133621691.2,-10,9874,9884,5490.157895,2593.366079
24,6500,2488,133568006.3,784,9336,8552,6519.117765,2148.462824
25,6500,2491,133729061,1249,9284,8035,6656.948214,1842.190178
26,6500,2497,134051170.3,5782,8692,2910,7786.412895,436.3841531
27,6500,2495,133943800.5,1273,9383,8110,6977.924248,1889.05907
28,6500,2497,134051170.3,1401,9069,7668,7076.115739,1605.967789
29,6500,2489,133621691.2,1401,8734,7333,7119.923262,1564.578722
31,6500,2496,133997485.4,1522,9931,8409,7293.820112,1351.067149
32,6500,2491,133729061,1694,8797,7103,7053.977519,1071.022715
33,6500,2490,133675376.1,2018,9931,7913,7422.462651,716.7151689
34,6500,2490,133675376.1,2277,8373,6096,6939.723695,897.3980697
10A,6500,2490,133675376.1,-779,9915,10694,4904.894378,2837.298586
10NE,6500,2490,133675376.1,-195,9915,10110,5152.331727,2783.593489
10NW,6500,2497,134051170.3,-1875,9522,11397,5704.439327,2646.693736
10SW,6500,2487,133514321.4,-779,9915,10694,5614.013671,2710.492984
11NE,6500,2486,133460636.5,-195,9388,9583,6064.273532,2415.441584
11NW,6500,2487,133514321.4,-195,9388,9583,5454.98271,2553.623811
11SE,6500,2492,133782745.9,623,9388,8765,5838.732745,2289.7392
17NW,6500,2493,133836430.8,-471,9971,10442,6323.458083,2158.843546
17SE,6500,2489,133621691.2,-1813,9509,11322,5886.137405,2424.011014
17SW,6500,2488,133568006.3,-1894,9828,11722,5266.186495,2646.694599
22S,6500,2498,134104855.2,-1894,9795,11689,4548.435548,2716.469238
23S,6500,2489,133621691.2,981,9773,8792,4302.76135,2317.157831
24S,6500,2498,134104855.2,784,9336,8552,6501.194556,2157.025212
27A,6500,2489,133621691.2,1282,9694,8412,6900.761752,1833.136116
2A,6500,2485,133406951.7,352,8957,8605,6417.500604,1705.428734
5NE,6500,2493,133836430.8,-1875,9827,11702,4561.81789,2523.994353
5NW,6500,2488,133568006.3,-1875,9827,11702,5111.088826,2489.479912
5SE,6500,2489,133621691.2,146,9784,9638,4542.337485,2612.124961
6NE,6500,2488,133568006.3,1470,9386,7916,6648.104502,1727.436732
6NW,6500,2489,133621691.2,383,9386,9003,5902.687826,2517.416225
6SW,6500,2494,133890115.7,-195,9784,9979,6215.873697,2370.288723
Cell 1 2011/12,6500,2488,133568006.3,-2000,9230,11230,6447.515273,2033.232722
Cell 1 SW 2013,6500,2488,133568006.3,-1970,9374,11344,5443.134244,2262.211482
Cell 10 2011/12,6500,2494,133890115.7,-779,9915,10694,5407.137931,2708.288862
Cell 10 NE 2011/12,6500,2490,133675376.1,-195,9915,10110,5152.331727,2783.593489
Cell 10 NW 2011/12,6500,2497,134051170.3,-1875,9522,11397,5704.439327,2646.693736
Cell 10 SE 2013,6500,2489,133621691.2,383,9386,9003,5902.687826,2517.416225
Cell 10 SW 2011/12,6500,2487,133514321.4,-779,9915,10694,5614.013671,2710.492984
Cell 10-A 2011/12,6500,2490,133675376.1,-779,9915,10694,4904.894378,2837.298586
Cell 11 NE 2011/12,6500,2486,133460636.5,-195,9388,9583,6064.273532,2415.441584
Cell 11 NW 2013,6500,2486,133460636.5,1571,9110,7539,6335.277554,1736.291106
Cell 11 SW 2013,6500,2489,133621691.2,1346,9386,8040,6605.428284,1912.744351
Cell 12 2013,6500,2494,133890115.7,1326,9773,8447,6294.62911,2011.033155
Cell 13 2013,6500,2491,133729061,1422,8838,7416,6984.991168,1407.731846
Cell 14 2013,6500,2487,133514321.4,4307,8761,4454,7957.526337,504.1337955
Cell 15 2013,6500,2491,133729061,5348,8876,3528,8018.915697,499.366564
Cell 15-A 2013,6500,2494,133890115.7,5348,8876,3528,8070.930634,455.1766425
Cell 16 2013,6500,2498,134104855.2,5452,8848,3396,8080.457566,409.8723561
Cell 17 NW 2011/12,6500,2493,133836430.8,-471,9971,10442,6323.458083,2158.843546
Cell 17 NW 2013,6500,2488,133568006.3,-1875,9827,11702,5656.895498,2411.40486
Cell 17 SE 2013,6500,2496,133997485.4,-1875,9522,11397,5703.755609,2647.003389
Cell 17 SW 2013,6500,2487,133514321.4,-1875,9245,11120,6161.616405,2242.986294
Cell 18 2011/12,6500,2491,133729061,850,9982,9132,4738.801686,2669.05871
Cell 18 NE 2013,6500,2488,133568006.3,234,9784,9550,6341.745981,2271.88157
Cell 18 NW 2013,6500,2490,133675376.1,146,9784,9638,4530.639759,2593.650219
Cell 18 SE 2013,6500,2486,133460636.5,-195,9388,9583,6064.273532,2415.441584
Cell 18 SSE 2013,6500,2488,133568006.3,-195,9388,9583,5465.219051,2536.745187
Cell 19 NW 2013,6500,2490,133675376.1,1142,9386,8244,6371.493976,2097.136167
Cell 2 2011/12,6500,2489,133621691.2,1373,9110,7737,6157.531941,1827.445014
Cell 2 NE 2013,6500,2498,134104855.2,-2000,8957,10957,6460.526821,1747.6831
Cell 2 SW 2013,6500,2489,133621691.2,-2000,9230,11230,6446.723986,2034.850736
Cell 20 2013,6500,2487,133514321.4,1465,9773,8308,6566.394451,1820.300722
Cell 21 2013,6500,2492,133782745.9,1920,9211,7291,7212.857143,1027.96159
Cell 22 2013,6500,2497,134051170.3,4425,8938,4513,7863.798959,471.9282106
Cell 23 2013,6500,2488,133568006.3,4549,8938,4389,8060.53537,504.2886616
Cell 24 2013,6500,2491,133729061,6616,8848,2232,8064.007226,380.6154389
Cell 25 NE 2013,6500,2494,133890115.7,-779,9915,10694,5407.137931,2708.288862
Cell 25 SE 2013,6500,2487,133514321.4,-779,9915,10694,5614.013671,2710.492984
Cell 26 NE 2013,6500,2488,133568006.3,-195,9388,9583,5622.450965,2420.983038
Cell 26 NNW 2013,6500,2489,133621691.2,-195,9915,10110,5154.146243,2782.679916
Cell 26 NW 2013,6500,2489,133621691.2,-779,9915,10694,4903.652471,2837.19178
Cell 27 NW 2013,6500,2492,133782745.9,623,9388,8765,5838.732745,2289.7392
Cell 28 2013,6500,2489,133621691.2,700,9943,9243,4401.783447,2420.41526
Cell 29 2013,6500,2490,133675376.1,1210,9211,8001,6537.804016,1701.349529
Cell 3 NE 2013,6500,2487,133514321.4,-384,8813,9197,7118.283072,1174.817757
Cell 3 NW 2013,6500,2491,133729061,-2000,9096,11096,6444.289442,1729.927718
Cell 30 2013,6500,2491,133729061,3349,8777,5428,7957.609394,467.795839
Cell 31 2013,6500,2492,133782745.9,4359,8955,4596,8113.539326,547.4836597
Cell 32 2013,6500,2499,134158540.1,5634,8982,3348,8219.161665,414.1037999
Cell 33 NE 2013,6500,2492,133782745.9,-471,9971,10442,6322.880819,2159.084281
Cell 33 SE 2013,6500,2488,133568006.3,-1894,9828,11722,5263.331592,2647.464935
Cell 33 SW 2013,6500,2489,133621691.2,-506,9981,10487,5278.900763,2791.529027
Cell 34 N 2013,6500,2489,133621691.2,-471,9455,9926,6491.712736,2006.436551
Cell 34 NW 2013,6500,2485,133406951.7,-782,9942,10724,6541.076861,1970.534056
Cell 34 SE 2013,6500,2489,133621691.2,-1813,9509,11322,5883.554038,2429.309117
Cell 35 2013,6500,2491,133729061,850,9982,9132,4604.732236,2669.520542
Cell 37 2013,6500,2493,133836430.8,3349,9288,5939,7639.58203,492.2059004
Cell 38 2013,6500,2491,133729061,6613,9040,2427,8214.943798,309.5866776
Cell 39 2013,6500,2492,133782745.9,6692,9040,2348,8301.140449,320.5376545
Cell 4 2013,6500,2496,133997485.4,4285,8848,4563,7501.315705,551.6671024
Cell 40 NE 2013,6500,2488,133568006.3,-1894,9795,11689,4761.701367,2737.036885
Cell 41 N 2013,6500,2491,133729061,-1894,9795,11689,6008.937776,2443.595568
Cell 41 NW 2013,6500,2489,133621691.2,-1894,9795,11689,5651.182403,2549.776717
Cell 42 NW 2013,6500,2488,133568006.3,-10,9874,9884,5481.082395,2595.287538
Cell 43 2013,6500,2489,133621691.2,1211,9341,8130,5864.032543,2253.145257
Cell 44 2013,6500,2491,133729061,1376,9341,7965,7362.395825,1057.348312
Cell 45 2013,6500,2498,134104855.2,5782,8692,2910,7787.428743,436.3794981
Cell 47 2013,6500,2491,133729061,422,9694,9272,6584.387395,2054.135064
Cell 48 2013,6500,2498,134104855.2,784,9336,8552,6498.328663,2157.770669
Cell 49 2013,6500,2492,133782745.9,1249,9284,8035,6654.827849,1844.858322
Cell 5 2011/12 Summer,6500,2487,133514321.4,-1875,9245,11120,6161.616405,2242.986294
Cell 5 2013,6500,2492,133782745.9,4285,8869,4584,7869.621589,664.7633874
Cell 50 2013,6500,2488,133568006.3,1401,8734,7333,7119.744373,1564.867666
Cell 51 2013,6500,2490,133675376.1,5785,8935,3150,7961.625703,423.6056765
Cell 52 2013,6500,2492,133782745.9,1387,8969,7582,7088.527287,1671.949861
Cell 53 2013,6500,2496,133997485.4,1401,9069,7668,7075.762821,1606.192654
Cell 54 2013,6500,2494,133890115.7,5726,8961,3235,7955.957498,555.8971081
Cell 55 2013,6500,2492,133782745.9,6068,8870,2802,7988.836276,495.944909
Cell 56 2013,6500,2493,133836430.8,2018,9931,7913,7424.099077,717.2100804
Cell 57 2013,6500,2493,133836430.8,1694,8797,7103,7054.642198,1070.86737
Cell 58 2013,6500,2494,133890115.7,5832,8870,3038,7985.124298,462.7743476
Cell 59 2013,6500,2493,133836430.8,1605,9347,7742,7263.117529,1033.914653
Cell 6 2011/12,6500,2492,133782745.9,1142,9386,8244,6262.974318,2155.013225
Cell 6 2013,6500,2495,133943800.6,5628,8930,3302,8106.467735,425.1832052
Cell 6 NE 2011/12,6500,2488,133568006.3,1470,9386,7916,6648.104502,1727.436732
Cell 6 NW 2011/12,6500,2489,133621691.2,383,9386,9003,5902.687826,2517.416225
Cell 6 SW 2011/12,6500,2494,133890115.7,-195,9784,9979,6215.873697,2370.288723
Cell 60 2013,6500,2489,133621691.2,2277,8373,6096,6903.500201,952.6833584
Cell 61 2013,6500,2496,133997485.4,3613,8831,5218,7541.923878,722.7780739
Cell 7 2013,6500,2489,133621691.2,5313,9137,3824,8122.634391,578.4221876
Cell 9 NW 2013,6500,2493,133836430.8,-1842,9827,11669,4808.674288,2446.571085
Cell 9 SE 2013,6500,2493,133836430.8,-1875,9827,11702,4561.81789,2523.994353
Cell 9 SW 2013,6500,2488,133568006.3,-1875,9827,11702,5111.088826,2489.479912
Cell R1,6500,2481,133192212.1,1192,8687,7495,5776.752116,1923.065785
Cell R10,6500,2496,133997485.4,4285,8848,4563,7501.315705,551.6671024
Cell R100,6500,2489,133621691.2,1401,8734,7333,7117.700683,1567.870693
Cell R101,6500,2491,133729061,3827,8935,5108,7831.92493,494.7386039
Cell R104,6500,2498,134104855.2,1367,9157,7790,6877.57446,1968.058254
Cell R105,6500,2496,133997485.4,1401,9069,7668,7075.762821,1606.192654
Cell R106,6500,2491,133729061,1401,9014,7613,7185.862706,1419.090877
Cell R107,6500,2494,133890115.7,5726,8961,3235,7956.030473,555.9133867
Cell R11,6500,2492,133782745.9,4285,8869,4584,7869.621589,664.7633874
Cell R111,6500,2499,134158540.1,1351,9931,8580,6661.141257,2128.842312
Cell R112,6500,2492,133782745.9,2636,9014,6378,7511.740369,639.3033449
Cell R113,6500,2492,133782745.9,1694,8797,7103,7054.396469,1071.011935
Cell R114,6500,2495,133943800.5,5832,8870,3038,7985.167535,462.6866363
Cell R117,6500,2490,133675376.1,1505,9931,8426,6747.755823,1831.763316
Cell R118,6500,2493,133836430.8,2018,9931,7913,7424.099077,717.2100804
Cell R119,6500,2499,134158540.1,1694,8887,7193,6900.592237,1147.483415
Cell R120,6500,2489,133621691.2,2116,8887,6771,7400.70229,892.6239128
Cell R121,6500,2497,134051170.3,5960,8831,2871,8042.943532,376.9441421
Cell R123,6500,2497,134051170.3,1505,9347,7842,7045.279135,1392.820629
Cell R124,6500,2488,133568006.3,2277,8373,6096,6883.934887,971.8621763
Cell R125,6500,2490,133675376.1,2277,8767,6490,6815.725703,1056.13874
Cell R126,6500,2491,133729061,2116,8887,6771,7324.401044,947.2847746
Cell R15,6500,2488,133568006.3,-1970,9374,11344,5443.134244,2262.211482
Cell R16,6500,2490,133675376.1,-1842,9827,11669,4803.479116,2446.801404
Cell R17,6500,2488,133568006.3,585,9230,8645,6353.551849,2266.748798
Cell R18,6500,2488,133568006.3,1571,9110,7539,6344.180064,1732.251961
Cell R19,6500,2491,133729061,1373,9768,8395,6640.201525,1723.28147
Cell R20,6500,2485,133406951.7,1422,8716,7294,7122.620926,1227.214151
Cell R21,6500,2487,133514321.4,1423,8838,7415,7429.313229,1271.234732
Cell R22,6500,2487,133514321.4,4307,8761,4454,7957.526337,504.1337955
Cell R24,6500,2488,133568006.3,-1875,9827,11702,5656.895498,2411.40486
Cell R25,6500,2490,133675376.1,146,9784,9638,4530.639759,2593.650219
Cell R26,6500,2498,134104855.2,383,9386,9003,5903.805444,2523.553915
Cell R27,6500,2491,133729061,1142,9386,8244,6371.088318,2096.812892
Cell R28,6500,2496,133997485.4,1326,9773,8447,5845.625801,2263.444625
Cell R29,6500,2487,133514321.4,1465,9773,8308,6566.394451,1820.300722
Cell R30,6500,2497,134051170.3,2057,8838,6781,7424.237085,914.7746992
Cell R31,6500,2490,133675376.1,4307,8751,4444,7831.986747,541.6368938
Cell R35,6500,2486,133460636.5,-1875,9245,11120,6160.95535,2243.19514
Cell R36,6500,2497,134051170.3,-1875,9522,11397,5704.439327,2646.693736
Cell R37,6500,2486,133460636.5,-195,9388,9583,6064.273532,2415.441584
Cell R38,6500,2488,133568006.3,981,9231,8250,5551.280547,2383.035477
Cell R39,6500,2491,133729061,1423,9773,8350,6621.735448,1766.82316
Cell R40,6500,2491,133729061,1920,9211,7291,7212.754717,1028.15519
Cell R46,6500,2487,133514321.4,-779,9951,10730,5268.650985,2792.632481
Cell R47,6500,2489,133621691.2,-779,9915,10694,4903.652471,2837.19178
Cell R48,6500,2488,133568006.3,-195,9388,9583,5622.450965,2420.983038
Cell R49,6500,2493,133836430.8,623,9388,8765,5839.169675,2289.383825
Cell R5,6500,2486,133460636.5,-1970,8948,10918,5788.699115,2030.375277
Cell R50,6500,2490,133675376.1,700,9943,9243,4401.75743,2419.929532
Cell R51,6500,2489,133621691.2,1320,9211,7891,6548.876657,1689.66811
Cell R52,6500,2488,133568006.3,2443,8808,6365,7329.478296,804.1784415
Cell R53,6500,2493,133836430.8,3421,8651,5230,7504.859607,534.0791945
Cell R54,6500,2491,133729061,4359,8955,4596,8113.511441,547.5917717
Cell R58,6500,2488,133568006.3,-268,9976,10244,5124.480305,2831.635357
Cell R59,6500,2493,133836430.8,-471,9971,10442,6323.458083,2158.843546
Cell R6,6500,2489,133621691.2,-2000,9230,11230,6446.723986,2034.850736
Cell R60,6500,2485,133406951.7,-782,9942,10724,6541.076861,1970.534056
Cell R61,6500,2491,133729061,850,9982,9132,4604.732236,2669.520542
Cell R62,6500,2490,133675376.1,716,9358,8642,4619.046586,2481.965881
Cell R63,6500,2487,133514321.4,716,9348,8632,6254.526739,1920.692609
Cell R64,6500,2492,133782745.9,3349,9288,5939,7618.331862,529.2208614
Cell R65,6500,2491,133729061,3349,8777,5428,7957.609394,467.795839
Cell R66,6500,2491,133729061,5718,8955,3237,8306.435568,299.9258883
Cell R69,6500,2489,133621691.2,-506,9981,10487,5278.900763,2791.529027
Cell R7,6500,2491,133729061,-2000,9096,11096,6444.289442,1729.927718
Cell R70,6500,2488,133568006.3,-1894,9828,11722,5263.331592,2647.464935
Cell R71,6500,2488,133568006.3,-1813,9509,11322,5882.930466,2429.598107
Cell R72,6500,2486,133460636.5,-10,9879,9889,5600.292438,2580.263803
Cell R73,6500,2490,133675376.1,-10,9982,9992,4785.90241,2753.006324
Cell R74,6500,2490,133675376.1,716,9341,8625,6173.920482,2240.593354
Cell R75,6500,2493,133836430.8,3349,9288,5939,7639.58203,492.2059004
Cell R76,6500,2489,133621691.2,6478,8790,2312,8088.38409,338.2166396
Cell R77,6500,2492,133782745.9,6613,9040,2427,8214.903692,309.5310276
Cell R8,6500,2493,133836430.8,-384,8813,9197,7046.809467,1217.357006
Cell R80,6500,2488,133568006.3,-1894,9795,11689,4758.788585,2737.65485
Cell R81,6500,2494,133890115.7,-1616,9615,11231,6323.368885,2182.822363
Cell R82,6500,2488,133568006.3,-10,9874,9884,5481.082395,2595.287538
Cell R83,6500,2489,133621691.2,422,9874,9452,5827.032141,2451.829249
Cell R84,6500,2491,133729061,1032,9341,8309,5174.342834,2406.664753
Cell R85,6500,2489,133621691.2,1211,9341,8130,5864.032543,2253.145257
Cell R86,6500,2492,133782745.9,1648,9040,7392,7488.097111,760.4982053
Cell R87,6500,2497,134051170.3,5782,8692,2910,7787.204245,436.3226229
Cell R9,6500,2491,133729061,-384,8813,9197,7257.359293,1042.739507
Cell R90,6500,2491,133729061,422,9694,9272,6584.387395,2054.135064
Cell R91,6500,2498,134104855.2,784,9336,8552,6498.328663,2157.770669
Cell R92,6500,2491,133729061,1032,9683,8651,4856.578884,2444.248407
Cell R93,6500,2491,133729061,1249,9284,8035,6654.702128,1845.217917
Cell R97,6500,2490,133675376.1,1282,9694,8412,6979.683936,1789.529031
Cell R98,6500,2496,133997485.4,1273,9383,8110,6978.377804,1888.816486
Cell R99,6500,2492,133782745.9,1387,8969,7582,7088.527287,1671.949861
Cell S102,6500,2493,133836430.8,5785,8935,3150,8018.499398,412.9260654
Cell S108,6500,2491,133729061,6068,8870,2802,7988.651546,495.9587205
Cell S13,6500,2488,133568006.3,5628,9125,3497,8168.700563,458.4920472
Cell S14,6500,2489,133621691.2,5313,9137,3824,8122.634391,578.4221876
Cell S2,6500,2496,133997485.4,5628,8930,3302,8106.264423,425.2193116
Cell S23,6500,2494,133890115.7,5543,9084,3541,8141.769447,494.9410755
Cell S32,6500,2488,133568006.3,5348,8938,3590,7958.036576,477.7701975
Cell S33,6500,2494,133890115.7,5348,8876,3528,8070.930634,455.1766425
Cell S34,6500,2492,133782745.9,6616,8848,2232,8063.903692,380.5741464
Cell S41,6500,2490,133675376.1,5127,8751,3624,7685.339759,419.0954931
Cell S42,6500,2490,133675376.1,4549,8938,4389,8060.548996,504.0986734
Cell S44,6500,2489,133621691.2,6649,8939,2290,8180.768582,335.1695952
Cell S56,6500,2490,133675376.1,5634,8832,3198,8022.598394,466.7271669
Cell S67,6500,2499,134158540.1,5634,8982,3348,8219.136455,414.1028653
Cell S78,6500,2492,133782745.9,6692,9040,2348,8301.140449,320.5376545
Cell S88,6500,2497,134051170.3,6077,8986,2909,8086.677613,400.9455352
Cell S94,6500,2497,134051170.3,6556,8935,2379,8031.817781,355.4687058
Cell S95,6500,2490,133675376.1,5785,8935,3150,7961.625703,423.6056765
W287,6500,2488,133568006.3,807,9196,8389,4099.36455,2072.400978
W295,6500,2489,133621691.2,1533,8825,7292,6968.556448,1644.436928
W338,6500,2488,133568006.3,692,9923,9231,3887.532556,2469.660691
W342,6500,2487,133514321.4,1013,8392,7379,5198.690792,2342.852063
W345,6500,2494,133890115.7,1581,8605,7024,7370.944667,886.8909434
W387,6500,2490,133675376.1,1182,9937,8755,5507.198795,2474.6184
W393,6500,2490,133675376.1,853,9522,8669,5972.025301,2196.040008
W440,6500,2486,133460636.5,1125,9047,7922,5712.082864,2331.019723
W441,6500,2491,133729061,1541,8634,7093,6762.262144,1366.964969
W445,6500,2485,133406951.7,1848,8692,6844,6763.517103,1083.491897
W500,6500,2484,133353266.8,1427,8823,7396,6273.429952,1757.760989
1,6750,2683,144036559.9,-2000,9230,11230,6365.742452,2072.465741
2,6750,2686,144197614.5,1373,9275,7902,6169.327625,1858.367695
3,6750,2686,144197614.5,1373,9275,7902,6958.657856,1433.113035
4,6750,2686,144197614.5,1422,8716,7294,7101.956441,1202.601917
5,6750,2683,144036559.9,-1875,9522,11397,6084.55833,2283.630947
6,6750,2684,144090244.8,1142,9386,8244,6233.842027,2157.792057
7,6750,2684,144090244.8,1326,9773,8447,6225.591282,2055.43612
8,6750,2687,144251299.4,1422,8838,7416,7049.42166,1372.17674
9,6750,2687,144251299.4,5219,8938,3719,7884.857834,430.471802
10,6750,2682,143982875,-779,9915,10694,5379.56264,2721.122268
11,6750,2684,144090244.8,-195,9388,9583,5675.252235,2416.986728
12,6750,2680,143875505.2,700,9982,9282,4367.676493,2428.415156
13,6750,2685,144143929.6,1210,9358,8148,6497.651024,1732.456843
14,6750,2688,144304984.3,4359,8925,4566,7984.535714,586.7447078
16,6750,2684,144090244.8,-506,9981,10487,5325.621088,2781.87428
17,6750,2684,144090244.8,-782,9942,10724,6467.406483,2028.695178
18,6750,2690,144412354.1,850,9982,9132,4739.247955,2654.660517
19,6750,2678,143768135.4,716,9358,8642,4691.445108,2488.139038
20,6750,2690,144412354.1,3349,9288,5939,7633.386989,502.4954227
21,6750,2691,144466039,6613,9040,2427,8204.134151,317.8244624
22,6750,2684,144090244.8,-1894,9795,11689,4754.9538,2714.735919
23,6750,2701,145002887.9,-10,9874,9884,5589.251018,2568.577459
24,6750,2688,144304984.3,784,9336,8552,6475.318824,2174.779512
25,6750,2698,144841833.2,1249,9284,8035,6617.867309,1882.425231
26,6750,2685,144143929.6,5782,8699,2917,7788.439479,439.1821006
27,6750,2683,144036559.9,1273,9383,8110,6928.59262,1939.993883
28,6750,2682,143982875,1401,9069,7668,7073.007084,1607.99688
29,6750,2683,144036559.9,1401,8734,7333,7086.029072,1605.588455
31,6750,2686,144197614.5,1522,9931,8409,7250.639613,1409.640279
32,6750,2689,144358669.2,1694,8797,7103,7076.407586,1056.318543
33,6750,2684,144090244.8,2018,9931,7913,7386.292474,812.6438342
34,6750,2691,144466039,2277,8373,6096,6922.150873,920.9220862
10A,6750,2685,144143929.6,-779,9915,10694,4852.880819,2848.131933
10NE,6750,2687,144251299.4,-592,9915,10507,5122.017119,2782.016064
10NW,6750,2681,143929190.1,-1875,9522,11397,5672.18053,2644.102112
10SW,6750,2685,144143929.7,-779,9915,10694,5588.467039,2721.170619
11NE,6750,2690,144412354.1,-195,9388,9583,5984.752416,2463.302864
11NW,6750,2680,143875505.2,-195,9388,9583,5526.196642,2541.331048
11SE,6750,2681,143929190.1,623,9388,8765,5870.777322,2281.59536
17NW,6750,2683,144036559.9,-471,9971,10442,6314.561685,2180.088488
17SE,6750,2685,144143929.6,-1813,9509,11322,5818.787709,2464.725122
17SW,6750,2684,144090244.8,-1894,9942,11836,5295.222057,2666.571834
22S,6750,2683,144036559.9,-1894,9795,11689,4561.612374,2712.037556
23S,6750,2680,143875505.2,981,9773,8792,4361.775,2327.525816
24S,6750,2686,144197614.5,784,9336,8552,6455.87863,2180.524914
27A,6750,2686,144197614.5,1282,9694,8412,6889.71035,1841.332485
2A,6750,2684,144090244.8,-384,8957,9341,6419.478763,1715.156338
5NE,6750,2685,144143929.7,-1875,9827,11702,4586.896462,2540.249376
5NW,6750,2685,144143929.6,-1875,9827,11702,5119.531844,2499.018109
5SE,6750,2685,144143929.6,146,9784,9638,4678.604842,2646.513861
6NE,6750,2691,144466039,1470,9386,7916,6599.608696,1763.386604
6NW,6750,2692,144519723.9,383,9386,9003,5924.946137,2501.66029
6SW,6750,2684,144090244.8,-195,9784,9979,6138.126677,2419.344244
Cell 1 2011/12,6750,2683,144036559.9,-2000,9230,11230,6365.742452,2072.465741
Cell 1 SW 2013,6750,2684,144090244.8,-1970,9468,11438,5491.703055,2268.64789
Cell 10 2011/12,6750,2682,143982875,-779,9915,10694,5379.56264,2721.122268
Cell 10 NE 2011/12,6750,2687,144251299.4,-592,9915,10507,5122.017119,2782.016064
Cell 10 NW 2011/12,6750,2681,143929190.1,-1875,9522,11397,5672.18053,2644.102112
Cell 10 SE 2013,6750,2692,144519723.9,383,9386,9003,5924.946137,2501.66029
Cell 10 SW 2011/12,6750,2685,144143929.7,-779,9915,10694,5588.467039,2721.170619
Cell 10-A 2011/12,6750,2685,144143929.6,-779,9915,10694,4852.880819,2848.131933
Cell 11 NE 2011/12,6750,2690,144412354.1,-195,9388,9583,5984.752416,2463.302864
Cell 11 NW 2013,6750,2685,144143929.6,1254,9110,7856,6354.530354,1744.227829
Cell 11 SW 2013,6750,2687,144251299.4,1261,9386,8125,6539.800521,1962.828407
Cell 12 2013,6750,2683,144036559.9,1326,9773,8447,6222.904212,2055.825049
Cell 13 2013,6750,2687,144251299.4,1422,8838,7416,7013.653145,1382.851097
Cell 14 2013,6750,2684,144090244.8,4153,8761,4608,7942.279061,541.6949424
Cell 15 2013,6750,2686,144197614.5,5348,8938,3590,8026.684661,501.1930004
Cell 15-A 2013,6750,2688,144304984.3,5348,8876,3528,8082.811756,453.9359757
Cell 16 2013,6750,2684,144090244.8,5452,8848,3396,8089.244411,406.4731527
Cell 17 NW 2011/12,6750,2683,144036559.9,-471,9971,10442,6314.561685,2180.088488
Cell 17 NW 2013,6750,2690,144412354.1,-1875,9827,11702,5609.441636,2438.331504
Cell 17 SE 2013,6750,2681,143929190.1,-1875,9522,11397,5672.18053,2644.102112
Cell 17 SW 2013,6750,2681,143929190.1,-1875,9522,11397,6090.217456,2283.813562
Cell 18 2011/12,6750,2690,144412354.1,850,9982,9132,4739.247955,2654.660517
Cell 18 NE 2013,6750,2682,143982875,-195,9784,9979,6260.058166,2331.823978
Cell 18 NW 2013,6750,2687,144251299.4,-1842,9827,11669,4658.354298,2634.232859
Cell 18 SE 2013,6750,2690,144412354.1,-195,9388,9583,5984.752416,2463.302864
Cell 18 SSE 2013,6750,2684,144090244.8,-195,9388,9583,5517.611773,2526.531958
Cell 19 NW 2013,6750,2684,144090244.8,1142,9386,8244,6327.782042,2109.377641
Cell 2 2011/12,6750,2686,144197614.5,1373,9275,7902,6169.327625,1858.367695
Cell 2 NE 2013,6750,2682,143982875,-2000,8957,10957,6470.112603,1760.479974
Cell 2 SW 2013,6750,2686,144197614.5,-2000,9230,11230,6360.699181,2076.379433
Cell 20 2013,6750,2684,144090244.8,1465,9773,8308,6510.393815,1856.469159
Cell 21 2013,6750,2687,144251299.4,1920,9211,7291,7209.672497,1030.670839
Cell 22 2013,6750,2687,144251299.4,4425,8938,4513,7858.771865,492.9130212
Cell 23 2013,6750,2698,144841833.2,4549,8938,4389,8051.628984,514.4477509
Cell 24 2013,6750,2687,144251299.4,5536,8852,3316,8069.184965,384.3421734
Cell 25 NE 2013,6750,2682,143982875,-779,9915,10694,5379.56264,2721.122268
Cell 25 SE 2013,6750,2685,144143929.7,-779,9915,10694,5588.467039,2721.170619
Cell 26 NE 2013,6750,2684,144090244.8,-195,9388,9583,5675.252235,2416.986728
Cell 26 NNW 2013,6750,2687,144251299.4,-592,9915,10507,5122.017119,2782.016064
Cell 26 NW 2013,6750,2685,144143929.6,-779,9915,10694,4852.880819,2848.131933
Cell 27 NW 2013,6750,2681,143929190.1,623,9388,8765,5870.777322,2281.59536
Cell 28 2013,6750,2680,143875505.2,700,9982,9282,4367.676493,2428.415156
Cell 29 2013,6750,2686,144197614.5,1210,9358,8148,6496.530901,1734.251699
Cell 3 NE 2013,6750,2685,144143929.6,-384,8813,9197,7086.363501,1202.573408
Cell 3 NW 2013,6750,2685,144143929.6,-2000,9096,11096,6416.79851,1752.691319
Cell 30 2013,6750,2688,144304984.3,3349,8777,5428,7950.96689,474.0845957
Cell 31 2013,6750,2685,144143929.6,4359,8955,4596,8107.032402,549.03397
Cell 32 2013,6750,2684,144090244.8,5634,8982,3348,8222.020864,408.0035125
Cell 33 NE 2013,6750,2683,144036559.9,-471,9971,10442,6314.561685,2180.088488
Cell 33 SE 2013,6750,2684,144090244.8,-1894,9942,11836,5295.222057,2666.571834
Cell 33 SW 2013,6750,2687,144251299.4,-506,9981,10487,5340.866022,2770.245726
Cell 34 N 2013,6750,2687,144251299.4,-471,9455,9926,6425.177521,2051.361299
Cell 34 NW 2013,6750,2685,144143929.6,-782,9942,10724,6466.785847,2028.572197
Cell 34 SE 2013,6750,2685,144143929.6,-1894,9509,11403,5821.731471,2465.690918
Cell 35 2013,6750,2703,145110257.7,850,9982,9132,4621.652608,2663.445856
Cell 37 2013,6750,2687,144251299.4,3349,9288,5939,7633.672125,502.6893243
Cell 38 2013,6750,2687,144251299.4,6613,9040,2427,8210.692222,314.6199499
Cell 39 2013,6750,2690,144412354.1,6550,9040,2490,8290.257993,330.9277097
Cell 4 2013,6750,2685,144143929.6,3928,8848,4920,7506.380633,561.2446474
Cell 40 NE 2013,6750,2694,144627093.7,-1894,9828,11722,4772.047884,2727.759795
Cell 41 N 2013,6750,2684,144090244.8,-1894,9795,11689,5987.722802,2433.068357
Cell 41 NW 2013,6750,2683,144036559.9,-1894,9795,11689,5614.732762,2552.968269
Cell 42 NW 2013,6750,2686,144197614.5,-10,9874,9884,5573.523083,2574.092064
Cell 43 2013,6750,2685,144143929.6,1211,9341,8130,5821.271881,2277.592757
Cell 44 2013,6750,2686,144197614.5,1376,9341,7965,7311.993671,1133.6618
Cell 45 2013,6750,2683,144036559.9,5782,8699,2917,7789.338054,438.5292782
Cell 47 2013,6750,2689,144358669.2,422,9694,9272,6597.239494,2048.823687
Cell 48 2013,6750,2685,144143929.6,784,9336,8552,6454.831285,2181.043187
Cell 49 2013,6750,2699,144895518.1,1249,9284,8035,6616.047054,1884.449841
Cell 5 2011/12 Summer,6750,2680,143875505.2,-1875,9522,11397,6089.776119,2284.125299
Cell 5 2013,6750,2686,144197614.5,4285,8869,4584,7869.062547,663.1614498
Cell 50 2013,6750,2684,144090244.8,1401,8734,7333,7086.256706,1605.332625
Cell 51 2013,6750,2682,143982875,5785,8935,3150,7964.149142,423.175801
Cell 52 2013,6750,2690,144412354.1,1387,9383,7996,7046.49145,1718.775159
Cell 53 2013,6750,2682,143982875,1401,9069,7668,7073.007084,1607.99688
Cell 54 2013,6750,2688,144304984.3,5726,8961,3235,7948.922619,552.1653829
Cell 55 2013,6750,2691,144466039,6068,8870,2802,7986.209216,487.7479441
Cell 56 2013,6750,2685,144143929.6,2018,9931,7913,7386.217132,812.4763229
Cell 57 2013,6750,2688,144304984.3,1694,8797,7103,7076.478051,1056.328306
Cell 58 2013,6750,2690,144412354.1,4790,8870,4080,7973.481041,474.8179802
Cell 59 2013,6750,2694,144627093.7,1505,9347,7842,7205.897179,1127.428691
Cell 6 2011/12,6750,2684,144090244.8,1142,9386,8244,6233.842027,2157.792057
Cell 6 2013,6750,2684,144090244.8,5526,9007,3481,8101.57228,433.4377848
Cell 6 NE 2011/12,6750,2691,144466039,1470,9386,7916,6599.608696,1763.386604
Cell 6 NW 2011/12,6750,2692,144519723.9,383,9386,9003,5924.946137,2501.66029
Cell 6 SW 2011/12,6750,2684,144090244.8,-195,9784,9979,6138.126677,2419.344244
Cell 60 2013,6750,2687,144251299.4,2277,8373,6096,6893.632304,949.8830337
Cell 61 2013,6750,2688,144304984.3,2116,8831,6715,7521.02939,763.9026265
Cell 7 2013,6750,2684,144090244.8,5313,9137,3824,8129.160209,573.9421271
Cell 9 NW 2013,6750,2680,143875505.2,-1842,9827,11669,4841.016045,2447.368861
Cell 9 SE 2013,6750,2685,144143929.7,-1875,9827,11702,4586.896462,2540.249376
Cell 9 SW 2013,6750,2685,144143929.6,-1875,9827,11702,5115.524395,2500.639872
Cell R1,6750,2701,145002887.9,1192,8687,7495,5773.308034,1910.271219
Cell R10,6750,2684,144090244.8,3928,8848,4920,7505.871833,561.0473612
Cell R100,6750,2683,144036559.9,1401,8734,7333,7085.916511,1605.535032
Cell R101,6750,2687,144251299.4,3827,8935,5108,7829.219576,504.2235832
Cell R104,6750,2687,144251299.4,1367,9157,7790,6876.339412,1955.428414
Cell R105,6750,2681,143929190.1,1401,9069,7668,7072.710929,1608.223607
Cell R106,6750,2685,144143929.6,1401,9014,7613,7182.554935,1413.68972
Cell R107,6750,2688,144304984.3,5726,8961,3235,7948.922619,552.1653829
Cell R11,6750,2688,144304984.3,4285,8869,4584,7869.146949,662.9753155
Cell R111,6750,2684,144090244.8,1351,9931,8580,6653.144933,2121.098202
Cell R112,6750,2687,144251299.4,2166,9014,6848,7492.262747,665.3685337
Cell R113,6750,2687,144251299.4,1694,8797,7103,7076.455899,1056.529088
Cell R114,6750,2688,144304984.3,4790,8870,4080,7973.06436,474.744926
Cell R117,6750,2691,144466039,1505,9931,8426,6708.551839,1850.398715
Cell R118,6750,2685,144143929.6,2018,9931,7913,7386.217132,812.4763229
Cell R119,6750,2686,144197614.5,1694,8887,7193,6909.265823,1134.019727
Cell R120,6750,2702,145056572.8,2116,8887,6771,7385.128423,933.3919449
Cell R121,6750,2689,144358669.2,5960,8831,2871,8036.737821,394.0092896
Cell R123,6750,2684,144090244.8,1505,9347,7842,7009.39158,1432.117495
Cell R124,6750,2683,144036559.9,2277,8505,6228,6889.345136,968.7156015
Cell R125,6750,2687,144251299.4,2277,8767,6490,6816.384444,1043.665375
Cell R126,6750,2683,144036559.9,2116,8887,6771,7306.316437,976.7035136
Cell R15,6750,2684,144090244.8,-1970,9468,11438,5491.188525,2268.204666
Cell R16,6750,2685,144143929.6,-1842,9827,11669,4845.861453,2448.109787
Cell R17,6750,2681,143929190.1,383,9386,9003,6275.715405,2304.378986
Cell R18,6750,2681,143929190.1,1254,9110,7856,6349.81201,1745.858433
Cell R19,6750,2687,144251299.4,1373,9768,8395,6628.2754,1711.168137
Cell R20,6750,2686,144197614.5,1422,8716,7294,7140.154877,1218.328724
Cell R21,6750,2689,144358669.2,1422,8838,7416,7403.670881,1306.438235
Cell R22,6750,2685,144143929.6,4153,8761,4608,7941.833892,542.0848896
Cell R24,6750,2689,144358669.2,-1875,9827,11702,5610.930457,2437.562086
Cell R25,6750,2687,144251299.4,-1842,9827,11669,4658.354298,2634.232859
Cell R26,6750,2682,143982875,383,9386,9003,5918.193139,2507.682698
Cell R27,6750,2685,144143929.6,1142,9386,8244,6327.89162,2108.992438
Cell R28,6750,2681,143929190.1,1326,9773,8447,5847.531891,2250.531158
Cell R29,6750,2685,144143929.6,1465,9773,8308,6510.765363,1856.223223
Cell R30,6750,2684,144090244.8,2057,8838,6781,7428.164307,933.9159265
Cell R31,6750,2686,144197614.5,4307,8938,4631,7825.017498,557.125468
Cell R35,6750,2680,143875505.2,-1875,9522,11397,6089.776119,2284.125299
Cell R36,6750,2681,143929190.1,-1875,9522,11397,5672.18053,2644.102112
Cell R37,6750,2690,144412354.1,-195,9388,9583,5984.752416,2463.302864
Cell R38,6750,2685,144143929.6,981,9231,8250,5526.27635,2395.255387
Cell R39,6750,2684,144090244.8,1128,9773,8645,6576.170641,1812.089314
Cell R40,6750,2687,144251299.4,1920,9211,7291,7209.672497,1030.670839
Cell R46,6750,2685,144143929.7,-779,9951,10730,5297.66108,2809.714166
Cell R47,6750,2686,144197614.5,-779,9915,10694,4852.682427,2847.620259
Cell R48,6750,2684,144090244.8,-195,9388,9583,5675.252235,2416.986728
Cell R49,6750,2682,143982875,623,9388,8765,5870.186055,2281.375394
Cell R5,6750,2690,144412354.1,-1970,8948,10918,5816.919703,2029.43825
Cell R50,6750,2680,143875505.2,700,9982,9282,4367.676493,2428.415156
Cell R51,6750,2683,144036559.9,1210,9358,8148,6508.152441,1725.689529
Cell R52,6750,2681,143929190.1,2443,8808,6365,7333.993659,792.3308075
Cell R53,6750,2687,144251299.4,2761,8651,5890,7497.297358,565.0411828
Cell R54,6750,2685,144143929.6,4359,8955,4596,8107.032402,549.03397
Cell R58,6750,2685,144143929.6,-268,9976,10244,5174.994041,2823.246824
Cell R59,6750,2685,144143929.6,-471,9971,10442,6315.081192,2179.635069
Cell R6,6750,2686,144197614.5,-2000,9230,11230,6360.699181,2076.379433
Cell R60,6750,2686,144197614.5,-782,9942,10724,6465.008563,2030.284295
Cell R61,6750,2701,145002887.9,850,9982,9132,4621.824139,2663.116915
Cell R62,6750,2683,144036559.9,716,9358,8642,4633.44577,2490.844673
Cell R63,6750,2688,144304984.3,716,9358,8642,6190.090774,1978.410019
Cell R64,6750,2688,144304984.3,3349,9288,5939,7617.166667,550.6562898
Cell R65,6750,2689,144358669.2,3349,8777,5428,7950.959464,473.9965913
Cell R66,6750,2688,144304984.3,5718,8955,3237,8296.80506,302.1689685
Cell R69,6750,2686,144197614.5,-506,9981,10487,5341.533135,2770.545558
Cell R7,6750,2685,144143929.6,-2000,9096,11096,6415.513222,1752.828926
Cell R70,6750,2684,144090244.8,-1894,9942,11836,5295.222057,2666.571834
Cell R71,6750,2685,144143929.6,-1894,9509,11403,5821.731471,2465.690918
Cell R72,6750,2687,144251299.4,-10,9982,9992,5618.399702,2578.591262
Cell R73,6750,2685,144143929.6,-10,9982,9992,4769.256238,2752.273854
Cell R74,6750,2686,144197614.5,716,9341,8625,6138.874162,2262.763391
Cell R75,6750,2687,144251299.4,3349,9288,5939,7633.533309,502.7119963
Cell R76,6750,2691,144466039,6095,8790,2695,8086.871795,340.029906
Cell R77,6750,2687,144251299.4,6613,9040,2427,8210.692222,314.6199499
Cell R8,6750,2688,144304984.3,-384,8957,9341,7030.252232,1231.024236
Cell R80,6750,2694,144627093.7,-1894,9828,11722,4772.047884,2727.759795
Cell R81,6750,2685,144143929.6,-1813,9615,11428,6242.424581,2240.018025
Cell R82,6750,2686,144197614.5,-10,9874,9884,5573.523083,2574.092064
Cell R83,6750,2686,144197614.5,422,9874,9452,5872.511541,2449.800773
Cell R84,6750,2687,144251299.4,1032,9341,8309,5204.403424,2405.779755
Cell R85,6750,2684,144090244.8,1211,9341,8130,5820.679583,2277.810252
Cell R86,6750,2686,144197614.5,1627,9284,7657,7460.023827,859.3544293
Cell R87,6750,2683,144036559.9,5782,8699,2917,7789.338054,438.5292782
Cell R9,6750,2698,144841833.2,-384,8813,9197,7239.32765,1067.241108
Cell R90,6750,2688,144304984.3,422,9694,9272,6598.995908,2047.179671
Cell R91,6750,2685,144143929.6,784,9336,8552,6454.831285,2181.043187
Cell R92,6750,2688,144304984.3,1032,9683,8651,4955.547619,2451.553501
Cell R93,6750,2699,144895518.1,1249,9284,8035,6616.047054,1884.449841
Cell R97,6750,2686,144197614.5,1282,9694,8412,6981.07446,1791.655056
Cell R98,6750,2682,143982875,1273,9383,8110,6930.052573,1938.881334
Cell R99,6750,2689,144358669.2,1387,9383,7996,7046.197843,1719.027276
Cell S102,6750,2687,144251299.4,5785,8935,3150,8017.00521,412.9472599
Cell S108,6750,2691,144466039,6068,8870,2802,7986.209216,487.7479441
Cell S13,6750,2684,144090244.8,5628,9125,3497,8167.410581,455.3880069
Cell S14,6750,2684,144090244.8,5313,9137,3824,8129.160209,573.9421271
Cell S2,6750,2686,144197614.5,5526,9007,3481,8101.468727,433.2940148
Cell S23,6750,2689,144358669.2,5543,9125,3582,8138.990331,493.9679527
Cell S32,6750,2686,144197614.5,5348,8938,3590,7955.100149,471.331601
Cell S33,6750,2687,144251299.4,5348,8876,3528,8082.780796,454.0175994
Cell S34,6750,2687,144251299.4,5536,8852,3316,8069.353554,384.2830531
Cell S41,6750,2687,144251299.4,5127,8751,3624,7683.020841,422.5713157
Cell S42,6750,2697,144788148.3,4549,8938,4389,8051.437152,514.4466281
Cell S44,6750,2689,144358669.2,6649,8939,2290,8170.886947,339.0039704
Cell S56,6750,2685,144143929.6,5634,8939,3305,8025.087151,462.2473205
Cell S67,6750,2684,144090244.8,5634,8982,3348,8222.020864,408.0035125
Cell S78,6750,2690,144412354.1,6550,9040,2490,8290.257993,330.9277097
Cell S88,6750,2683,144036559.9,6077,8986,2909,8084.059262,402.3226952
Cell S94,6750,2683,144036559.9,6475,8935,2460,8021.909057,358.0670379
Cell S95,6750,2682,143982875,5785,8935,3150,7964.149142,423.175801
W287,6750,2686,144197614.5,807,9258,8451,4098.51787,2063.575451
W295,6750,2685,144143929.6,1437,8825,7388,6950.684916,1674.3703
W338,6750,2692,144519723.9,692,9923,9231,3829.253343,2449.328752
W342,6750,2695,144680778.5,1013,8392,7379,5207.387384,2333.059824
W345,6750,2681,143929190.1,1581,8605,7024,7356.678105,906.0512165
W387,6750,2684,144090244.8,1182,9937,8755,5445.880775,2473.297114
W393,6750,2683,144036559.9,853,9522,8669,5895.501677,2239.076727
W440,6750,2683,144036559.9,1125,9047,7922,5708.920239,2343.624103
W441,6750,2682,143982875,1392,8634,7242,6700.659955,1451.381309
W445,6750,2690,144412354.1,1848,8692,6844,6764.024164,1089.080695
W500,6750,2683,144036559.9,1427,8823,7396,6290.041372,1736.4602
1,7000,2887,154988277.4,-2000,9230,11230,6281.805334,2112.957652
2,7000,2894,155364071.7,1373,9275,7902,6182.662405,1884.563063
3,7000,2887,154988277.4,1373,9275,7902,6938.963284,1452.380764
4,7000,2887,154988277.4,1422,8716,7294,7110.969865,1198.623765
5,7000,2886,154934592.5,-1875,9522,11397,6041.458073,2306.388414
6,7000,2891,155203017,1142,9386,8244,6201.230024,2161.831323
7,7000,2894,155364071.7,1326,9773,8447,6141.540083,2099.534317
8,7000,2887,154988277.4,1422,8838,7416,7068.855213,1353.274336
9,7000,2886,154934592.5,4888,8938,4050,7887.836452,443.0212099
10,7000,2893,155310386.8,-779,9915,10694,5343.834774,2745.11435
11,7000,2880,154612483.2,-195,9388,9583,5719.874306,2416.224609
12,7000,2876,154397743.6,700,9982,9282,4351.410292,2439.883884
13,7000,2883,154773537.9,1210,9358,8148,6459.013528,1770.705357
14,7000,2888,155041962.3,4359,8925,4566,7992.92867,576.9179735
16,7000,2880,154612483.2,-506,9981,10487,5340.781944,2760.326391
17,7000,2884,154827222.8,-782,9971,10753,6399.643551,2073.998414
18,7000,2895,155417756.6,850,9982,9132,4720.230397,2635.159082
19,7000,2897,155525126.3,716,9358,8642,4716.732482,2497.021474
20,7000,2890,155149332.1,3349,9341,5992,7628.801384,509.1193237
21,7000,2896,155471441.4,6613,9040,2427,8200.327003,320.1605397
22,7000,2893,155310386.8,-1894,9795,11689,4758.608019,2711.466775
23,7000,2886,154934592.5,-10,9874,9884,5663.343382,2548.109195
24,7000,2887,154988277.4,784,9336,8552,6434.296848,2199.786454
25,7000,2889,155095647.2,1249,9284,8035,6605.336449,1901.573477
26,7000,2893,155310386.8,5782,8935,3153,7789.393709,444.7575082
27,7000,2891,155203017,1273,9383,8110,6884.867866,1979.863969
28,7000,2892,155256701.9,1401,9157,7756,7064.987898,1615.020749
29,7000,2886,154934592.5,1387,8734,7347,7064.90887,1627.49164
31,7000,2896,155471441.4,1522,9931,8409,7214.782459,1461.507423
32,7000,2895,155417756.6,1694,8797,7103,7092.307427,1044.26819
33,7000,2883,154773537.9,1936,9931,7995,7337.265002,923.3374931
34,7000,2895,155417756.6,2277,8373,6096,6910.255959,939.4976696
10A,7000,2880,154612483.2,-779,9971,10750,4837.908681,2862.67187
10NE,7000,2888,155041962.3,-779,9915,10694,5097.897507,2794.633845
10NW,7000,2893,155310386.8,-1875,9522,11397,5640.154857,2644.818702
10SW,7000,2881,154666168.1,-779,9915,10694,5566.88858,2735.631247
11NE,7000,2893,155310386.8,-195,9388,9583,5931.020394,2486.115149
11NW,7000,2883,154773537.9,-195,9388,9583,5575.793271,2533.99651
11SE,7000,2892,155256701.9,428,9388,8960,5916.090941,2271.621313
17NW,7000,2892,155256701.9,-471,9971,10442,6281.60823,2216.803469
17SE,7000,2890,155149332.1,-1894,9509,11403,5785.675779,2475.959661
17SW,7000,2880,154612483.2,-1894,9942,11836,5331.157986,2686.928171
22S,7000,2893,155310386.8,-1894,9795,11689,4603.829589,2703.489957
23S,7000,2876,154397743.6,981,9773,8792,4419.589013,2341.055054
24S,7000,2895,155417756.6,784,9336,8552,6412.702245,2208.700032
27A,7000,2887,154988277.4,1024,9694,8670,6866.208175,1871.452027
2A,7000,2886,154934592.5,-384,8957,9341,6418.596674,1726.625061
5NE,7000,2888,155041962.3,-1875,9827,11702,4620.979917,2545.341292
5NW,7000,2893,155310386.8,-1875,9827,11702,5121.004494,2509.468643
5SE,7000,2884,154827222.8,-1842,9827,11669,4782.06172,2674.85172
6NE,7000,2889,155095647.2,1421,9386,7965,6544.847006,1812.679653
6NW,7000,2889,155095647.2,383,9386,9003,5934.883004,2487.338452
6SW,7000,2890,155149332.1,-195,9784,9979,6055.119031,2470.686794
Cell 1 2011/12,7000,2887,154988277.4,-2000,9230,11230,6281.805334,2112.957652
Cell 1 SW 2013,7000,2880,154612483.2,-1970,9468,11438,5543.228819,2268.862165
Cell 10 2011/12,7000,2893,155310386.8,-779,9915,10694,5343.834774,2745.11435
Cell 10 NE 2011/12,7000,2888,155041962.3,-779,9915,10694,5097.897507,2794.633845
Cell 10 NW 2011/12,7000,2893,155310386.8,-1875,9522,11397,5640.154857,2644.818702
Cell 10 SE 2013,7000,2889,155095647.2,383,9386,9003,5934.883004,2487.338452
Cell 10 SW 2011/12,7000,2881,154666168.1,-779,9915,10694,5566.88858,2735.631247
Cell 10-A 2011/12,7000,2880,154612483.2,-779,9971,10750,4837.908681,2862.67187
Cell 11 NE 2011/12,7000,2893,155310386.8,-195,9388,9583,5931.020394,2486.115149
Cell 11 NW 2013,7000,2887,154988277.4,352,9110,8758,6358.019744,1764.608514
Cell 11 SW 2013,7000,2887,154988277.4,1210,9386,8176,6480.450987,1993.4151
Cell 12 2013,7000,2893,155310386.8,1326,9773,8447,6147.828897,2096.562101
Cell 13 2013,7000,2886,154934592.5,1422,8838,7416,7037.331947,1361.546861
Cell 14 2013,7000,2884,154827222.8,3117,8761,5644,7929.903606,581.994966
Cell 15 2013,7000,2895,155417756.6,5348,8938,3590,8033.200691,505.1004607
Cell 15-A 2013,7000,2888,155041962.3,5348,8876,3528,8087.703947,452.8883291
Cell 16 2013,7000,2894,155364071.7,5452,8848,3396,8094.876987,405.0964479
Cell 17 NW 2011/12,7000,2892,155256701.9,-471,9971,10442,6281.60823,2216.803469
Cell 17 NW 2013,7000,2889,155095647.2,-1875,9827,11702,5567.771547,2462.317497
Cell 17 SE 2013,7000,2892,155256701.9,-1875,9522,11397,5639.650761,2645.136969
Cell 17 SW 2013,7000,2881,154666168.1,-1875,9522,11397,6044.469976,2307.654756
Cell 18 2011/12,7000,2895,155417756.6,850,9982,9132,4720.230397,2635.159082
Cell 18 NE 2013,7000,2883,154773537.9,-195,9784,9979,6181.252515,2382.730714
Cell 18 NW 2013,7000,2891,155203017,-1842,9827,11669,4759.261847,2662.585895
Cell 18 SE 2013,7000,2892,155256701.9,-195,9388,9583,5930.401798,2486.322322
Cell 18 SSE 2013,7000,2892,155256701.9,-195,9388,9583,5593.718534,2513.341135
Cell 19 NW 2013,7000,2891,155203017,1142,9386,8244,6283.600138,2115.666223
Cell 2 2011/12,7000,2894,155364071.7,1373,9275,7902,6182.662405,1884.563063
Cell 2 NE 2013,7000,2893,155310386.8,-2000,9096,11096,6472.969927,1773.158585
Cell 2 SW 2013,7000,2892,155256701.9,-2000,9230,11230,6281.389696,2113.291211
Cell 20 2013,7000,2888,155041962.3,1418,9773,8355,6450.578947,1896.752384
Cell 21 2013,7000,2890,155149332.1,1920,9211,7291,7197.744983,1041.084888
Cell 22 2013,7000,2894,155364071.7,4359,8938,4579,7853.946786,507.1180152
Cell 23 2013,7000,2889,155095647.2,4549,8938,4389,8035.948079,536.279062
Cell 24 2013,7000,2895,155417756.6,5452,8852,3400,8074.262522,388.3319167
Cell 25 NE 2013,7000,2893,155310386.8,-779,9915,10694,5343.834774,2745.11435
Cell 25 SE 2013,7000,2881,154666168.1,-779,9915,10694,5566.88858,2735.631247
Cell 26 NE 2013,7000,2880,154612483.2,-195,9388,9583,5719.874306,2416.224609
Cell 26 NNW 2013,7000,2887,154988277.4,-779,9915,10694,5099.033253,2794.451336
Cell 26 NW 2013,7000,2880,154612483.2,-779,9971,10750,4837.908681,2862.67187
Cell 27 NW 2013,7000,2892,155256701.9,428,9388,8960,5916.090941,2271.621313
Cell 28 2013,7000,2876,154397743.6,700,9982,9282,4351.410292,2439.883884
Cell 29 2013,7000,2888,155041962.3,1210,9358,8148,6460.045014,1769.474391
Cell 3 NE 2013,7000,2888,155041962.3,-384,8813,9197,7062.479917,1230.091926
Cell 3 NW 2013,7000,2888,155041962.3,-2000,9096,11096,6384.224723,1774.727949
Cell 30 2013,7000,2895,155417756.6,3349,8777,5428,7943.223143,479.3431638
Cell 31 2013,7000,2883,154773537.9,4359,8955,4596,8103.944155,548.9157875
Cell 32 2013,7000,2895,155417756.6,5634,9004,3370,8226.329188,402.4339014
Cell 33 NE 2013,7000,2892,155256701.9,-471,9971,10442,6281.60823,2216.803469
Cell 33 SE 2013,7000,2881,154666168.1,-1894,9942,11836,5327.225269,2688.213592
Cell 33 SW 2013,7000,2888,155041962.3,-506,9981,10487,5374.765928,2746.017287
Cell 34 N 2013,7000,2890,155149332.1,-471,9455,9926,6326.279239,2121.92207
Cell 34 NW 2013,7000,2884,154827222.8,-782,9971,10753,6399.643551,2073.998414
Cell 34 SE 2013,7000,2887,154988277.4,-1894,9509,11403,5785.070662,2476.773148
Cell 35 2013,7000,2885,154880907.7,850,9982,9132,4628.497054,2663.480524
Cell 37 2013,7000,2896,155471441.4,3349,9341,5992,7631.368094,507.4868503
Cell 38 2013,7000,2883,154773537.9,6613,9040,2427,8206.216094,318.1301795
Cell 39 2013,7000,2891,155203017,6550,9040,2490,8283.746455,334.975149
Cell 4 2013,7000,2893,155310386.8,3928,8849,4921,7506.30833,580.0795841
Cell 40 NE 2013,7000,2886,154934592.5,-1894,9828,11722,4792.563063,2727.357595
Cell 41 N 2013,7000,2880,154612483.2,-1894,9795,11689,5985.527431,2413.878972
Cell 41 NW 2013,7000,2888,155041962.3,-1894,9795,11689,5592.316482,2552.995915
Cell 42 NW 2013,7000,2880,154612483.2,-10,9874,9884,5656.017361,2556.098267
Cell 43 2013,7000,2882,154719853,1144,9341,8197,5788.00347,2296.308314
Cell 44 2013,7000,2882,154719853,1376,9341,7965,7263.75399,1202.099921
Cell 45 2013,7000,2894,155364071.7,5782,8935,3153,7789.481341,444.7149637
Cell 47 2013,7000,2889,155095647.2,422,9694,9272,6608.650398,2046.821664
Cell 48 2013,7000,2892,155256701.9,784,9336,8552,6409.742739,2210.110726
Cell 49 2013,7000,2888,155041962.3,1249,9284,8035,6605.132271,1901.871006
Cell 5 2011/12 Summer,7000,2881,154666168.1,-1875,9522,11397,6044.469976,2307.654756
Cell 5 2013,7000,2887,154988277.4,4285,8869,4584,7870.837894,658.7080474
Cell 50 2013,7000,2886,154934592.5,1387,8734,7347,7064.90887,1627.49164
Cell 51 2013,7000,2877,154451428.5,5785,8935,3150,7969.959333,421.265529
Cell 52 2013,7000,2889,155095647.2,1274,9383,8109,7006.712357,1762.302312
Cell 53 2013,7000,2893,155310386.8,1401,9157,7756,7065.268925,1614.812321
Cell 54 2013,7000,2896,155471441.4,4044,8961,4917,7935.546616,569.9513566
Cell 55 2013,7000,2889,155095647.2,6068,8870,2802,7980.326757,483.7653398
Cell 56 2013,7000,2883,154773537.9,1936,9931,7995,7335.815123,924.3643349
Cell 57 2013,7000,2894,155364071.7,1694,8797,7103,7092.023842,1044.380821
Cell 58 2013,7000,2889,155095647.2,2653,8961,6308,7952.94081,517.9345622
Cell 59 2013,7000,2895,155417756.6,1505,9347,7842,7167.253886,1176.681775
Cell 6 2011/12,7000,2891,155203017,1142,9386,8244,6201.230024,2161.831323
Cell 6 2013,7000,2893,155310386.8,5526,9007,3481,8094.933287,442.7440009
Cell 6 NE 2011/12,7000,2889,155095647.2,1421,9386,7965,6544.847006,1812.679653
Cell 6 NW 2011/12,7000,2889,155095647.2,383,9386,9003,5934.883004,2487.338452
Cell 6 SW 2011/12,7000,2890,155149332.1,-195,9784,9979,6055.119031,2470.686794
Cell 60 2013,7000,2883,154773537.9,2277,8505,6228,6895.067291,946.4967696
Cell 61 2013,7000,2900,155686181,2116,8831,6715,7491.044138,823.071639
Cell 7 2013,7000,2881,154666168.1,5313,9137,3824,8130.059354,571.2230686
Cell 9 NW 2013,7000,2893,155310386.8,-1842,9827,11669,4897.508123,2453.732989
Cell 9 SE 2013,7000,2889,155095647.2,-1875,9827,11702,4621.342333,2544.975256
Cell 9 SW 2013,7000,2895,155417756.5,-1875,9827,11702,5118.912608,2509.974702
Cell R1,7000,2885,154880907.6,1192,8687,7495,5767.50156,1902.712643
Cell R10,7000,2893,155310386.8,3928,8849,4921,7506.30833,580.0795841
Cell R100,7000,2886,154934592.5,1387,8734,7347,7064.6535,1627.516005
Cell R101,7000,2896,155471441.4,3827,8935,5108,7831.985152,506.4908987
Cell R104,7000,2896,155471441.4,1358,9157,7799,6880.431285,1946.642956
Cell R105,7000,2893,155310386.8,1401,9157,7756,7065.268925,1614.812321
Cell R106,7000,2897,155525126.3,1401,9014,7613,7189.751812,1397.87246
Cell R107,7000,2897,155525126.3,4044,8961,4917,7935.412151,569.8989209
Cell R11,7000,2888,155041962.3,4285,8869,4584,7870.765928,658.6053467
Cell R111,7000,2894,155364071.7,1351,9931,8580,6640.316171,2116.420463
Cell R112,7000,2887,154988277.4,2166,9014,6848,7472.086595,691.2547003
Cell R113,7000,2894,155364071.7,1694,8797,7103,7092.739115,1044.477808
Cell R114,7000,2889,155095647.2,2653,8961,6308,7952.94081,517.9345622
Cell R117,7000,2895,155417756.6,1505,9931,8426,6681.734024,1861.175853
Cell R118,7000,2883,154773537.9,1936,9931,7995,7335.815123,924.3643349
Cell R119,7000,2895,155417756.6,1694,8887,7193,6929.689465,1119.027869
Cell R120,7000,2888,155041962.3,2116,8887,6771,7371.326524,966.284336
Cell R121,7000,2895,155417756.6,5600,8831,3231,8029.270466,413.750069
Cell R123,7000,2890,155149332.1,1505,9347,7842,6970.90692,1469.736706
Cell R124,7000,2885,154880907.7,2277,8505,6228,6899.423917,967.348418
Cell R125,7000,2886,154934592.5,2277,8767,6490,6814.410256,1025.590416
Cell R126,7000,2884,154827222.8,2116,8887,6771,7287.108183,1004.176358
Cell R15,7000,2878,154505113.4,-1970,9468,11438,5542.433287,2269.444585
Cell R16,7000,2894,155364071.7,-1842,9827,11669,4896.628196,2452.284757
Cell R17,7000,2884,154827222.8,383,9386,9003,6205.113037,2333.876818
Cell R18,7000,2876,154397743.6,352,9110,8758,6358.066759,1766.337329
Cell R19,7000,2894,155364071.7,1373,9768,8395,6610.770905,1702.316615
Cell R20,7000,2888,155041962.3,1422,8838,7416,7158.556787,1215.197761
Cell R21,7000,2887,154988277.4,1422,8838,7416,7381.063388,1326.039713
Cell R22,7000,2886,154934592.5,3117,8761,5644,7929.558905,582.0303613
Cell R24,7000,2889,155095647.2,-1875,9827,11702,5567.771547,2462.317497
Cell R25,7000,2891,155203017,-1842,9827,11669,4759.261847,2662.585895
Cell R26,7000,2892,155256701.9,383,9386,9003,5927.375519,2491.936006
Cell R27,7000,2891,155203017,1142,9386,8244,6284.795918,2115.801473
Cell R28,7000,2891,155203017,1090,9773,8683,5840.217918,2240.324421
Cell R29,7000,2888,155041962.3,1418,9773,8355,6450.578947,1896.752384
Cell R30,7000,2894,155364071.7,2057,8838,6781,7422.960608,952.572251
Cell R31,7000,2883,154773537.9,4129,8938,4809,7815.894207,576.7719554
Cell R35,7000,2881,154666168.1,-1875,9522,11397,6044.469976,2307.654756
Cell R36,7000,2893,155310386.8,-1875,9522,11397,5640.154857,2644.818702
Cell R37,7000,2893,155310386.8,-195,9388,9583,5931.020394,2486.115149
Cell R38,7000,2882,154719853,981,9231,8250,5499.950729,2404.248267
Cell R39,7000,2893,155310386.8,1128,9773,8645,6534.95299,1841.826611
Cell R40,7000,2891,155203017,1920,9211,7291,7197.040125,1042.13485
Cell R46,7000,2886,154934592.5,-779,9961,10740,5318.463271,2817.268013
Cell R47,7000,2880,154612483.2,-779,9971,10750,4837.908681,2862.67187
Cell R48,7000,2882,154719853,-195,9388,9583,5721.55864,2416.233069
Cell R49,7000,2892,155256701.9,428,9388,8960,5914.376556,2271.710541
Cell R5,7000,2887,154988277.4,-1970,9374,11344,5832.024593,2037.484599
Cell R50,7000,2876,154397743.6,700,9982,9282,4351.410292,2439.883884
Cell R51,7000,2883,154773537.9,1210,9358,8148,6474.078737,1756.368892
Cell R52,7000,2885,154880907.7,2443,8808,6365,7330.19688,787.9720091
Cell R53,7000,2889,155095647.2,2761,8651,5890,7483.54171,605.5491205
Cell R54,7000,2883,154773537.9,4359,8955,4596,8103.705862,548.9480523
Cell R58,7000,2885,154880907.7,-268,9976,10244,5223.159445,2812.061394
Cell R59,7000,2892,155256701.9,-471,9971,10442,6281.60823,2216.803469
Cell R6,7000,2890,155149332.1,-2000,9230,11230,6282.232872,2112.674836
Cell R60,7000,2885,154880907.7,-782,9971,10753,6399.02669,2073.903531
Cell R61,7000,2885,154880907.7,850,9982,9132,4628.497054,2663.480524
Cell R62,7000,2885,154880907.7,716,9358,8642,4674.596534,2502.344732
Cell R63,7000,2887,154988277.4,716,9358,8642,6142.785244,2014.14149
Cell R64,7000,2889,155095647.2,3349,9288,5939,7617.802354,567.7772015
Cell R65,7000,2896,155471441.4,3349,8777,5428,7943.084945,479.3180775
Cell R66,7000,2884,154827222.8,5718,8955,3237,8282.635576,311.5001063
Cell R69,7000,2886,154934592.5,-506,9981,10487,5375.204782,2745.305713
Cell R7,7000,2890,155149332.1,-2000,9096,11096,6384.82526,1774.308491
Cell R70,7000,2881,154666168.1,-1894,9942,11836,5327.225269,2688.213592
Cell R71,7000,2888,155041962.3,-1894,9509,11403,5785.84626,2476.694937
Cell R72,7000,2888,155041962.3,-10,9982,9992,5620.23615,2583.585669
Cell R73,7000,2879,154558798.3,-10,9982,9992,4753.602987,2755.094867
Cell R74,7000,2892,155256701.9,716,9341,8625,6097.647994,2290.307659
Cell R75,7000,2894,155364071.7,3349,9341,5992,7631.429509,507.6543893
Cell R76,7000,2885,154880907.7,6008,8798,2790,8085.05234,341.2814891
Cell R77,7000,2883,154773537.9,6613,9040,2427,8206.308706,318.1017183
Cell R8,7000,2886,154934592.5,-384,8957,9341,7026.13271,1235.317843
Cell R80,7000,2885,154880907.7,-1894,9828,11722,4792.526863,2727.82954
Cell R81,7000,2892,155256701.9,-1813,9615,11428,6147.143154,2316.269695
Cell R82,7000,2880,154612483.2,-10,9874,9884,5656.017361,2556.098267
Cell R83,7000,2887,154988277.4,-10,9874,9884,5913.013509,2443.10802
Cell R84,7000,2894,155364071.7,847,9341,8494,5240.327574,2415.56091
Cell R85,7000,2881,154666168.1,1144,9341,8197,5787.288442,2296.386005
Cell R86,7000,2892,155256701.9,1627,9284,7657,7437.518326,931.8573784
Cell R87,7000,2895,155417756.6,5782,8935,3153,7789.607599,444.6900247
Cell R9,7000,2887,154988277.4,-384,8813,9197,7217.363353,1095.436639
Cell R90,7000,2889,155095647.2,422,9694,9272,6608.650398,2046.821664
Cell R91,7000,2893,155310386.8,784,9336,8552,6410.33149,2209.955532
Cell R92,7000,2888,155041962.3,1032,9683,8651,5054.746191,2457.760504
Cell R93,7000,2887,154988277.4,1249,9284,8035,6604.647731,1902.022128
Cell R97,7000,2882,154719853,1282,9694,8412,6987.184247,1794.483695
Cell R98,7000,2892,155256701.9,1273,9383,8110,6885.061895,1979.54913
Cell R99,7000,2889,155095647.2,1274,9383,8109,7006.712357,1762.302312
Cell S102,7000,2892,155256701.9,5785,8935,3150,8013.061549,414.1493419
Cell S108,7000,2887,154988277.4,6068,8870,2802,7980.227918,483.9167163
Cell S13,7000,2887,154988277.4,5628,9125,3497,8169.206443,453.580724
Cell S14,7000,2880,154612483.2,5313,9137,3824,8130.195486,571.2755036
Cell S2,7000,2894,155364071.7,5526,9007,3481,8094.750173,442.7770559
Cell S23,7000,2887,154988277.4,5543,9125,3582,8135.740215,496.5009507
Cell S32,7000,2888,155041962.3,5348,8938,3590,7953.956371,467.6721432
Cell S33,7000,2890,155149332.1,5348,8876,3528,8087.811419,452.7563413
Cell S34,7000,2894,155364071.7,5452,8852,3400,8074.36973,388.3561658
Cell S41,7000,2887,154988277.4,4846,8751,3905,7679.958434,434.2737213
Cell S42,7000,2891,155203017,4549,8938,4389,8036.073331,536.1391989
Cell S44,7000,2889,155095647.2,6649,8939,2290,8163.948079,342.8891319
Cell S56,7000,2891,155203017,5634,8939,3305,8030.918021,456.3283556
Cell S67,7000,2895,155417756.6,5634,9004,3370,8226.329188,402.4339014
Cell S78,7000,2891,155203017,6550,9040,2490,8283.746455,334.975149
Cell S88,7000,2895,155417756.6,6077,8986,2909,8079.106045,404.1472151
Cell S94,7000,2893,155310386.8,6475,8935,2460,8013.634981,363.9631503
Cell S95,7000,2876,154397743.6,5785,8935,3150,7969.845271,421.2943407
W287,7000,2887,154988277.4,807,9258,8451,4114.914444,2060.80007
W295,7000,2891,155203017,1437,8825,7388,6943.491525,1690.642467
W338,7000,2887,154988277.4,692,9923,9231,3784.289228,2422.208905
W342,7000,2889,155095647.2,1013,8392,7379,5223.96504,2324.615969
W345,7000,2890,155149332.1,1581,8605,7024,7345.988235,913.3330848
W387,7000,2888,155041962.3,1182,9937,8755,5382.149931,2471.742966
W393,7000,2890,155149332.1,853,9522,8669,5801.842907,2289.549227
W440,7000,2881,154666168.1,1125,9047,7922,5722.47067,2347.835946
W441,7000,2887,154988277.4,1392,8634,7242,6637.713197,1529.362266
W445,7000,2887,154988277.4,1848,8692,6844,6762.675095,1089.508643
W500,7000,2885,154880907.7,1427,8823,7396,6314.422184,1722.160603
1,7250,3099,166369474.1,-2000,9230,11230,6210.931268,2143.764373
2,7250,3102,166530528.8,1373,9275,7902,6207.693101,1897.769807
3,7250,3097,166262104.3,1373,9275,7902,6925.135615,1451.909075
4,7250,3098,166315789.2,1422,8838,7416,7128.14009,1182.380491
5,7250,3091,165939995,-1875,9522,11397,5992.959236,2324.567058
6,7250,3100,166423159,1142,9386,8244,6163.605806,2172.961101
7,7250,3102,166530528.8,1326,9773,8447,6091.054159,2122.043655
8,7250,3096,166208419.4,1422,8838,7416,7084.181202,1332.806689
9,7250,3098,166315789.2,4888,8938,4050,7887.181407,456.3416333
10,7250,3098,166315789.2,-779,9915,10694,5308.727889,2769.371797
11,7250,3090,165886310.1,-195,9388,9583,5770.878317,2411.036316
12,7250,3092,165993679.9,700,9982,9282,4328.782018,2442.397298
13,7250,3098,166315789.2,1210,9358,8148,6426.225307,1806.341258
14,7250,3100,166423159,4359,8925,4566,7999.435806,567.576592
16,7250,3092,165993679.9,-506,9981,10487,5324.141332,2740.236205
17,7250,3097,166262104.3,-1894,9971,11865,6334.226994,2112.64834
18,7250,3101,166476843.9,850,9982,9132,4713.644308,2619.580103
19,7250,3090,165886310.1,716,9358,8642,4739.770874,2504.750348
20,7250,3100,166423159,3349,9341,5992,7626.069032,516.9291326
21,7250,3106,166745268.3,6613,9040,2427,8194.943657,324.0413397
22,7250,3103,166584213.7,-1894,9795,11689,4773.910409,2706.670203
23,7250,3111,167013692.8,-10,9874,9884,5740.090968,2525.551377
24,7250,3098,166315789.2,784,9336,8552,6394.745965,2218.416479
25,7250,3111,167013692.8,1249,9284,8035,6602.708132,1914.362928
26,7250,3101,166476843.9,5782,8935,3153,7788.558852,454.2736783
27,7250,3094,166101049.7,1273,9383,8110,6830.260827,2025.004598
28,7250,3094,166101049.7,1401,9157,7756,7053.967679,1639.441003
29,7250,3104,166637898.6,1387,8734,7347,7039.737113,1648.492738
31,7250,3103,166584213.7,1522,9931,8409,7186.282307,1506.197723
32,7250,3101,166476843.9,1694,8797,7103,7111.941954,1032.918078
33,7250,3101,166476843.9,1843,9931,8088,7275.022251,1055.061631
34,7250,3102,166530528.8,2277,8505,6228,6904.529014,947.1035139
10A,7250,3093,166047364.8,-779,9971,10750,4853.082444,2870.133181
10NE,7250,3095,166154734.5,-779,9915,10694,5087.226817,2805.046368
10NW,7250,3089,165832625.2,-1875,9522,11397,5607.304306,2646.35189
10SW,7250,3088,165778940.3,-779,9915,10694,5531.010363,2750.566962
11NE,7250,3103,166584213.7,-195,9388,9583,5878.049629,2495.954736
11NW,7250,3097,166262104.3,-195,9405,9600,5638.501453,2526.922133
11SE,7250,3100,166423159,428,9388,8960,5961.023871,2264.996796
17NW,7250,3100,166423159,-471,9971,10442,6235.542581,2256.700221
17SE,7250,3102,166530528.8,-1894,9509,11403,5783.899097,2481.563689
17SW,7250,3090,165886310.1,-1894,9942,11836,5356.20712,2698.409166
22S,7250,3092,165993679.9,-1894,9795,11689,4638.332794,2699.719608
23S,7250,3092,165993679.9,981,9773,8792,4488.19793,2355.275041
24S,7250,3097,166262104.3,784,9336,8552,6380.939296,2222.417946
27A,7250,3098,166315789.2,784,9694,8910,6847.251775,1901.449963
2A,7250,3097,166262104.3,-384,9110,9494,6435.228285,1739.745844
5NE,7250,3096,166208419.4,-1875,9827,11702,4660.246124,2535.483836
5NW,7250,3102,166530528.8,-1875,9827,11702,5118.677305,2514.337913
5SE,7250,3095,166154734.5,-1842,9827,11669,4881.06042,2686.591984
6NE,7250,3105,166691583.4,1421,9386,7965,6470.776167,1877.799264
6NW,7250,3105,166691583.4,383,9386,9003,5951.811916,2469.650366
6SW,7250,3091,165939995,-195,9784,9979,5981.367842,2513.438893
Cell 1 2011/12,7250,3099,166369474.1,-2000,9230,11230,6210.931268,2143.764373
Cell 1 SW 2013,7250,3096,166208419.4,-1970,9468,11438,5590.881137,2265.85765
Cell 10 2011/12,7250,3098,166315789.2,-779,9915,10694,5308.727889,2769.371797
Cell 10 NE 2011/12,7250,3095,166154734.5,-779,9915,10694,5087.226817,2805.046368
Cell 10 NW 2011/12,7250,3089,165832625.2,-1875,9522,11397,5607.304306,2646.35189
Cell 10 SE 2013,7250,3105,166691583.4,383,9386,9003,5951.811916,2469.650366
Cell 10 SW 2011/12,7250,3088,165778940.3,-779,9915,10694,5531.010363,2750.566962
Cell 10-A 2011/12,7250,3093,166047364.8,-779,9971,10750,4853.082444,2870.133181
Cell 11 NE 2011/12,7250,3103,166584213.7,-195,9388,9583,5878.049629,2495.954736
Cell 11 NW 2013,7250,3097,166262104.3,-384,9110,9494,6372.842751,1782.043008
Cell 11 SW 2013,7250,3101,166476843.9,1079,9386,8307,6429.577556,2019.966383
Cell 12 2013,7250,3100,166423159,1326,9773,8447,6091.045161,2121.398764
Cell 13 2013,7250,3098,166315789.2,1422,8838,7416,7063.338283,1332.792996
Cell 14 2013,7250,3099,166369474.1,2520,8838,6318,7911.077767,644.9447738
Cell 15 2013,7250,3100,166423159,5348,8938,3590,8045.056774,506.3680843
Cell 15-A 2013,7250,3096,166208419.4,5348,8876,3528,8091.949289,452.721369
Cell 16 2013,7250,3103,166584213.7,5452,8876,3424,8098.881083,403.5610904
Cell 17 NW 2011/12,7250,3100,166423159,-471,9971,10442,6235.542581,2256.700221
Cell 17 NW 2013,7250,3103,166584213.7,-1875,9827,11702,5535.590396,2472.528034
Cell 17 SE 2013,7250,3091,165939995,-1875,9522,11397,5604.78583,2647.349676
Cell 17 SW 2013,7250,3095,166154734.5,-1875,9522,11397,5998.434249,2322.648197
Cell 18 2011/12,7250,3101,166476843.9,850,9982,9132,4713.644308,2619.580103
Cell 18 NE 2013,7250,3099,166369474.1,-195,9784,9979,6101.227493,2431.600928
Cell 18 NW 2013,7250,3100,166423159,-1842,9827,11669,4851.206129,2686.631036
Cell 18 SE 2013,7250,3103,166584213.7,-195,9388,9583,5878.049629,2495.954736
Cell 18 SSE 2013,7250,3102,166530528.8,-195,9388,9583,5666.822373,2502.927799
Cell 19 NW 2013,7250,3101,166476843.9,1142,9386,8244,6239.58336,2128.620859
Cell 2 2011/12,7250,3102,166530528.8,1373,9275,7902,6207.693101,1897.769807
Cell 2 NE 2013,7250,3090,165886310.1,-2000,9096,11096,6472.219741,1783.791063
Cell 2 SW 2013,7250,3099,166369474.1,-2000,9230,11230,6210.923524,2143.759998
Cell 20 2013,7250,3097,166262104.3,1090,9773,8683,6396.019051,1936.824868
Cell 21 2013,7250,3099,166369474.1,1920,9211,7291,7170.00484,1072.084073
Cell 22 2013,7250,3094,166101049.7,4359,8938,4579,7847.598901,521.4723274
Cell 23 2013,7250,3110,166960007.9,4549,8938,4389,8025.029904,548.93902
Cell 24 2013,7250,3104,166637898.6,5452,8852,3400,8080.597616,388.5824797
Cell 25 NE 2013,7250,3099,166369474.1,-779,9915,10694,5307.405937,2769.902394
Cell 25 SE 2013,7250,3088,165778940.3,-779,9915,10694,5531.010363,2750.566962
Cell 26 NE 2013,7250,3090,165886310.1,-195,9388,9583,5770.878317,2411.036316
Cell 26 NNW 2013,7250,3094,166101049.7,-779,9915,10694,5088.010343,2805.160984
Cell 26 NW 2013,7250,3093,166047364.8,-779,9971,10750,4853.082444,2870.133181
Cell 27 NW 2013,7250,3100,166423159,428,9388,8960,5961.023871,2264.996796
Cell 28 2013,7250,3092,165993679.9,700,9982,9282,4328.782018,2442.397298
Cell 29 2013,7250,3097,166262104.3,1210,9358,8148,6425.490475,1807.90046
Cell 3 NE 2013,7250,3097,166262104.3,-384,8957,9341,7048.442364,1239.614034
Cell 3 NW 2013,7250,3097,166262104.3,-2000,9096,11096,6373.736842,1785.139033
Cell 30 2013,7250,3101,166476843.9,3349,8777,5428,7929.009352,500.3165785
Cell 31 2013,7250,3100,166423159,4359,8955,4596,8100.253226,552.8259985
Cell 32 2013,7250,3094,166101049.7,5634,9004,3370,8228.81254,398.8806783
Cell 33 NE 2013,7250,3100,166423159,-471,9971,10442,6235.542581,2256.700221
Cell 33 SE 2013,7250,3090,165886310.1,-1894,9942,11836,5356.20712,2698.409166
Cell 33 SW 2013,7250,3097,166262104.3,-1021,9981,11002,5378.682273,2731.454081
Cell 34 N 2013,7250,3097,166262104.3,-471,9509,9980,6241.31805,2174.282296
Cell 34 NW 2013,7250,3098,166315789.2,-1894,9971,11865,6334.037766,2112.333593
Cell 34 SE 2013,7250,3097,166262104.3,-1894,9509,11403,5784.453019,2481.338641
Cell 35 2013,7250,3111,167013692.8,850,9982,9132,4648.667952,2666.750409
Cell 37 2013,7250,3104,166637898.6,3349,9341,5992,7628.488402,514.56008
Cell 38 2013,7250,3099,166369474.1,6613,9040,2427,8200.745079,321.1857733
Cell 39 2013,7250,3100,166423159,6375,9040,2665,8275.948065,338.731365
Cell 4 2013,7250,3096,166208419.4,3037,9275,6238,7501.979651,599.5367887
Cell 40 NE 2013,7250,3107,166798953.2,-1894,9828,11722,4818.503379,2726.890529
Cell 41 N 2013,7250,3094,166101049.7,-1894,9795,11689,5965.506464,2409.022356
Cell 41 NW 2013,7250,3099,166369474.1,-1894,9795,11689,5592.710874,2554.382825
Cell 42 NW 2013,7250,3096,166208419.4,-10,9874,9884,5738.650517,2532.771414
Cell 43 2013,7250,3092,165993679.9,1126,9341,8215,5750.424644,2316.968915
Cell 44 2013,7250,3094,166101049.7,1376,9341,7965,7197.457337,1297.774082
Cell 45 2013,7250,3101,166476843.9,5782,8935,3153,7788.681716,454.323853
Cell 47 2013,7250,3099,166369474.1,422,9694,9272,6624.053243,2040.525486
Cell 48 2013,7250,3097,166262104.3,784,9336,8552,6382.226994,2223.000831
Cell 49 2013,7250,3111,167013692.8,1249,9284,8035,6602.708132,1914.362928
Cell 5 2011/12 Summer,7250,3096,166208419.4,-1875,9522,11397,5996.88469,2323.872561
Cell 5 2013,7250,3100,166423159,4285,8869,4584,7872.827742,651.1808713
Cell 50 2013,7250,3103,166584213.7,1387,8734,7347,7039.472124,1648.692245
Cell 51 2013,7250,3093,166047364.8,5785,8935,3150,7976.433236,416.6583976
Cell 52 2013,7250,3101,166476843.9,1274,9383,8109,6979.300548,1791.233102
Cell 53 2013,7250,3096,166208419.4,1401,9157,7756,7054.49354,1639.049001
Cell 54 2013,7250,3103,166584213.7,3061,8961,5900,7919.606832,598.4236749
Cell 55 2013,7250,3099,166369474.1,6068,8870,2802,7972.586964,484.8329085
Cell 56 2013,7250,3097,166262104.3,1843,9931,8088,7273.307717,1058.670678
Cell 57 2013,7250,3105,166691583.4,1694,8797,7103,7110.943961,1033.262643
Cell 58 2013,7250,3100,166423159,2313,8961,6648,7916.5,625.580855
Cell 59 2013,7250,3103,166584213.7,1505,9347,7842,7126.437641,1224.27539
Cell 6 2011/12,7250,3100,166423159,1142,9386,8244,6163.605806,2172.961101
Cell 6 2013,7250,3101,166476843.9,5526,9007,3481,8089.885198,448.5035058
Cell 6 NE 2011/12,7250,3105,166691583.4,1421,9386,7965,6470.776167,1877.799264
Cell 6 NW 2011/12,7250,3105,166691583.4,383,9386,9003,5951.811916,2469.650366
Cell 6 SW 2011/12,7250,3091,165939995,-195,9784,9979,5981.367842,2513.438893
Cell 60 2013,7250,3101,166476843.9,2277,8505,6228,6897.460497,946.0402093
Cell 61 2013,7250,3106,166745268.3,2116,8887,6771,7469.763039,868.6000989
Cell 7 2013,7250,3092,165993679.9,5313,9137,3824,8129.284929,570.3712137
Cell 9 NW 2013,7250,3100,166423159,-1842,9827,11669,4954.590645,2455.382439
Cell 9 SE 2013,7250,3095,166154734.5,-1875,9827,11702,4659.201939,2535.227753
Cell 9 SW 2013,7250,3102,166530528.8,-1875,9827,11702,5117.194391,2514.662235
Cell R1,7250,3107,166798953.2,1192,8687,7495,5755.246862,1900.777876
Cell R10,7250,3094,166101049.7,3037,9275,6238,7501.614092,599.5505991
Cell R100,7250,3101,166476843.9,1387,8734,7347,7039.167043,1649.149147
Cell R101,7250,3102,166530528.8,3827,8935,5108,7824.95648,530.1898165
Cell R104,7250,3095,166154734.5,1358,9157,7799,6888.081422,1939.6123
Cell R105,7250,3095,166154734.5,1401,9157,7756,7054.292084,1639.275446
Cell R106,7250,3104,166637898.6,1401,9014,7613,7198.60116,1372.787981
Cell R107,7250,3103,166584213.7,3061,8961,5900,7919.606832,598.4236749
Cell R11,7250,3100,166423159,4285,8869,4584,7872.827742,651.1808713
Cell R111,7250,3095,166154734.5,1351,9931,8580,6649.690145,2091.325005
Cell R112,7250,3100,166423159,2166,9014,6848,7453.550323,717.4201705
Cell R113,7250,3105,166691583.4,1694,8797,7103,7110.943961,1033.262643
Cell R114,7250,3100,166423159,2313,8961,6648,7916.5,625.580855
Cell R117,7250,3104,166637898.6,1505,9931,8426,6656.184278,1870.621044
Cell R118,7250,3097,166262104.3,1843,9931,8088,7273.494349,1058.631999
Cell R119,7250,3098,166315789.2,1694,8887,7193,6952.425113,1104.870396
Cell R120,7250,3113,167121062.6,2116,8887,6771,7358.212978,1000.381074
Cell R121,7250,3097,166262104.3,5600,8831,3231,8021.567646,430.0596718
Cell R123,7250,3095,166154734.5,1505,9347,7842,6937.42391,1497.835404
Cell R124,7250,3101,166476843.9,2277,8505,6228,6913.240245,960.4307355
Cell R125,7250,3093,166047364.8,2277,8767,6490,6817.697381,1009.67909
Cell R126,7250,3102,166530528.8,2116,8887,6771,7271.660864,1026.379737
Cell R15,7250,3094,166101049.7,-1970,9468,11438,5590.252101,2266.401857
Cell R16,7250,3100,166423159,-1842,9827,11669,4954.860968,2454.924997
Cell R17,7250,3095,166154734.5,383,9386,9003,6137.5063,2358.19425
Cell R18,7250,3090,165886310.1,-384,9110,9494,6372.854369,1779.377298
Cell R19,7250,3104,166637898.6,1373,9768,8395,6590.278028,1697.932208
Cell R20,7250,3097,166262104.3,1422,8848,7426,7179.367129,1206.03664
Cell R21,7250,3099,166369474.1,1422,8838,7416,7365.462085,1338.46481
Cell R22,7250,3099,166369474.1,2520,8838,6318,7911.077767,644.9447738
Cell R24,7250,3103,166584213.7,-1875,9827,11702,5535.590396,2472.528034
Cell R25,7250,3101,166476843.9,-1842,9827,11669,4851.728797,2686.350597
Cell R26,7250,3086,165671570.5,383,9386,9003,5941.721646,2473.419446
Cell R27,7250,3101,166476843.9,1142,9386,8244,6239.58336,2128.620859
Cell R28,7250,3092,165993679.9,1090,9773,8683,5815.433053,2240.575164
Cell R29,7250,3097,166262104.3,1090,9773,8683,6396.019051,1936.824868
Cell R30,7250,3094,166101049.7,2057,8838,6781,7419.181965,970.5685634
Cell R31,7250,3097,166262104.3,3923,8938,5015,7804.124637,601.173661
Cell R35,7250,3096,166208419.4,-1875,9522,11397,5996.88469,2323.872561
Cell R36,7250,3090,165886310.1,-1875,9522,11397,5605.992233,2646.928361
Cell R37,7250,3103,166584213.7,-195,9388,9583,5878.049629,2495.954736
Cell R38,7250,3089,165832625.2,700,9231,8531,5493.252509,2401.115248
Cell R39,7250,3102,166530528.8,1128,9773,8645,6487.950677,1878.943355
Cell R40,7250,3098,166315789.2,1920,9211,7291,7169.52776,1072.197683
Cell R46,7250,3096,166208419.4,-779,9961,10740,5355.868863,2819.950325
Cell R47,7250,3092,165993679.9,-779,9971,10750,4851.838616,2869.763659
Cell R48,7250,3090,165886310.1,-195,9388,9583,5770.878317,2411.036316
Cell R49,7250,3101,166476843.9,428,9388,8960,5962.009997,2264.305457
Cell R5,7250,3102,166530528.8,-1970,9374,11344,5841.351064,2047.271166
Cell R50,7250,3092,165993679.9,700,9982,9282,4328.782018,2442.397298
Cell R51,7250,3098,166315789.2,1210,9358,8148,6438.694642,1799.545112
Cell R52,7250,3101,166476843.9,2443,8808,6365,7336.718478,774.2643876
Cell R53,7250,3101,166476843.9,2443,8651,6208,7471.770397,637.9967617
Cell R54,7250,3099,166369474.1,4359,8955,4596,8100.227493,552.9133292
Cell R58,7250,3101,166476843.9,-779,9976,10755,5239.703644,2804.194503
Cell R59,7250,3100,166423159,-471,9971,10442,6235.542581,2256.700221
Cell R6,7250,3099,166369474.1,-2000,9230,11230,6210.923524,2143.759998
Cell R60,7250,3098,166315789.2,-1894,9971,11865,6334.037766,2112.333593
Cell R61,7250,3109,166906323,850,9982,9132,4648.352203,2666.679173
Cell R62,7250,3098,166315789.2,716,9410,8694,4703.375403,2511.689938
Cell R63,7250,3099,166369474.1,716,9358,8642,6100.428203,2049.108473
Cell R64,7250,3095,166154734.5,3349,9288,5939,7623.859451,575.4395681
Cell R65,7250,3103,166584213.7,3349,8777,5428,7928.83661,500.2057933
Cell R66,7250,3094,166101049.7,5718,8955,3237,8269.223012,321.4187864
Cell R69,7250,3096,166208419.4,-1021,9981,11002,5377.847222,2731.499891
Cell R7,7250,3098,166315789.2,-2000,9096,11096,6373.712072,1784.85143
Cell R70,7250,3090,165886310.1,-1894,9942,11836,5356.20712,2698.409166
Cell R71,7250,3096,166208419.4,-1894,9509,11403,5783.906654,2481.553074
Cell R72,7250,3097,166262104.3,-10,9982,9992,5611.966742,2597.144606
Cell R73,7250,3097,166262104.3,-10,9982,9992,4734.883758,2751.11267
Cell R74,7250,3102,166530528.8,716,9341,8625,6075.744681,2301.219184
Cell R75,7250,3104,166637898.6,3349,9341,5992,7628.488402,514.56008
Cell R76,7250,3097,166262104.3,6008,8798,2790,8083.815305,341.7743981
Cell R77,7250,3099,166369474.1,6613,9040,2427,8200.745079,321.1857733
Cell R8,7250,3094,166101049.7,-384,8957,9341,7015.683581,1239.015453
Cell R80,7250,3107,166798953.2,-1894,9828,11722,4816.526875,2726.888366
Cell R81,7250,3100,166423159,-1813,9615,11428,6058.20129,2372.760203
Cell R82,7250,3096,166208419.4,-10,9874,9884,5738.517442,2532.665415
Cell R83,7250,3097,166262104.3,-10,9874,9884,5956.357766,2433.840776
Cell R84,7250,3102,166530528.8,834,9341,8507,5260.979046,2434.032586
Cell R85,7250,3092,165993679.9,1126,9341,8215,5750.424644,2316.968915
Cell R86,7250,3102,166530528.8,1627,9284,7657,7426.234043,975.063546
Cell R87,7250,3102,166530528.8,5782,8935,3153,7788.676338,454.2507151
Cell R9,7250,3105,166691583.4,-384,8813,9197,7191.652818,1126.992405
Cell R90,7250,3102,166530528.8,422,9694,9272,6625.636041,2040.212887
Cell R91,7250,3098,166315789.2,784,9336,8552,6381.842802,2222.377284
Cell R92,7250,3100,166423159,1032,9683,8651,5143.98871,2455.124846
Cell R93,7250,3110,166960007.9,1249,9284,8035,6602.346302,1914.564314
Cell R97,7250,3097,166262104.3,1034,9694,8660,6991.216984,1794.313423
Cell R98,7250,3095,166154734.5,1273,9383,8110,6830.606139,2024.768536
Cell R99,7250,3102,166530528.8,1274,9383,8109,6979.640232,1791.044248
Cell S102,7250,3102,166530528.8,5785,8935,3150,8009.059639,416.6887788
Cell S108,7250,3098,166315789.2,6068,8870,2802,7972.602647,484.9103655
Cell S13,7250,3098,166315789.2,5628,9125,3497,8169.429955,451.960877
Cell S14,7250,3092,165993679.9,5313,9137,3824,8129.284929,570.3712137
Cell S2,7250,3100,166423159,5526,9007,3481,8089.801613,448.5516898
Cell S23,7250,3096,166208419.4,5543,9125,3582,8133.689922,502.097889
Cell S32,7250,3098,166315789.2,5348,8938,3590,7951.6898,464.2561447
Cell S33,7250,3097,166262104.3,5348,8876,3528,8092.123668,452.7522521
Cell S34,7250,3105,166691583.4,5452,8852,3400,8080.792271,388.6712303
Cell S41,7250,3099,166369474.1,3863,8751,4888,7677.635689,447.5253241
Cell S42,7250,3109,166906323,4549,8938,4389,8024.999035,549.0245963
Cell S44,7250,3100,166423159,6498,8939,2441,8157.947097,351.2166188
Cell S56,7250,3100,166423159,5634,8939,3305,8035.926452,455.1372587
Cell S67,7250,3094,166101049.7,5634,9004,3370,8228.81254,398.8806783
Cell S78,7250,3102,166530528.8,6375,9040,2665,8275.995809,338.628533
Cell S88,7250,3095,166154734.5,6077,8986,2909,8073.862036,407.1813511
Cell S94,7250,3096,166208419.4,5988,8935,2947,8004.847868,374.1915676
Cell S95,7250,3093,166047364.8,5785,8935,3150,7976.433236,416.6583976
W287,7250,3095,166154734.5,807,9258,8451,4145.574152,2065.956014
W295,7250,3100,166423159,1437,8825,7388,6944.142581,1696.581429
W338,7250,3105,166691583.4,692,9923,9231,3749.22963,2399.673897
W342,7250,3105,166691583.4,1013,8392,7379,5258.659581,2307.915236
W345,7250,3089,165832625.2,1581,8605,7024,7323.96698,949.9616534
W387,7250,3098,166315789.2,1182,9937,8755,5333.032279,2465.838346
W393,7250,3099,166369474.1,853,9522,8669,5717.343659,2336.015356
W440,7250,3093,166047364.8,1125,9047,7922,5733.920142,2349.430266
W441,7250,3091,165939995,1392,8634,7242,6592.042058,1575.595874
W445,7250,3105,166691583.4,1848,8692,6844,6770.931079,1083.277652
W500,7250,3095,166154734.5,1427,8823,7396,6335.599354,1705.564985
1,7500,3315,177965410.4,-2000,9230,11230,6159.439819,2156.68418
2,7500,3317,178072780.1,352,9275,8923,6216.890564,1917.119921
3,7500,3317,178072780.1,1373,9455,8082,6908.488695,1456.491384
4,7500,3312,177804355.7,1422,8848,7426,7137.686896,1181.997202
5,7500,3312,177804355.7,-1875,9522,11397,5949.35628,2342.130731
6,7500,3318,178126465,1142,9386,8244,6123.156118,2187.135901
7,7500,3317,178072780.1,1326,9773,8447,6042.797709,2141.242909
8,7500,3318,178126465,1422,8838,7416,7105.299578,1305.511403
9,7500,3315,177965410.4,4888,8938,4050,7889.664555,463.7040557
10,7500,3317,178072780.1,-779,9915,10694,5261.861923,2800.210212
11,7500,3307,177535931.2,-195,9388,9583,5824.757787,2406.577989
12,7500,3304,177374876.6,700,9982,9282,4312.215799,2450.332444
13,7500,3316,178019095.2,1210,9358,8148,6403.568154,1843.550868
14,7500,3319,178180149.9,4359,8925,4566,8005.14191,560.5609633
16,7500,3309,177643301,-1021,9981,11002,5308.441825,2724.500835
17,7500,3317,178072780.1,-1894,9971,11865,6289.833283,2146.085091
18,7500,3320,178233834.8,850,9982,9132,4726.448795,2611.122385
19,7500,3318,178126465,716,9829,9113,4774.845992,2510.835729
20,7500,3312,177804355.7,3349,9341,5992,7625.859903,517.6314896
21,7500,3323,178394889.5,6613,9040,2427,8189.367138,327.6010746
22,7500,3317,178072780.1,-1894,9795,11689,4801.567079,2713.011426
23,7500,3314,177911725.5,-10,9874,9884,5807.262824,2502.318808
24,7500,3316,178019095.2,784,9336,8552,6354.474065,2229.708328
25,7500,3319,178180149.9,1249,9383,8134,6593.823139,1939.211422
26,7500,3322,178341204.6,5222,8935,3713,7788.307947,466.1524428
27,7500,3317,178072780.1,1032,9383,8351,6764.616822,2073.644609
28,7500,3319,178180149.9,1401,9157,7756,7043.000603,1671.444719
29,7500,3318,178126465,1387,8734,7347,7027.02833,1659.759371
31,7500,3322,178341204.6,1522,9931,8409,7154.75286,1540.341158
32,7500,3319,178180149.9,1694,8887,7193,7130.698403,1018.580972
33,7500,3318,178126465,1581,9931,8350,7207.598855,1180.357772
34,7500,3322,178341204.6,2277,8505,6228,6912.27363,944.441788
10A,7500,3311,177750670.8,-779,9971,10750,4883.777711,2869.973066
10NE,7500,3312,177804355.7,-779,9915,10694,5070.288949,2809.907641
10NW,7500,3316,178019095.2,-1875,9522,11397,5585.420386,2648.644826
10SW,7500,3301,177213821.9,-779,9915,10694,5494.79279,2762.753847
11NE,7500,3317,178072780.1,-195,9784,9979,5832.481459,2502.828196
11NW,7500,3319,178180149.9,-195,9784,9979,5699.619765,2519.114622
11SE,7500,3321,178287519.7,348,9388,9040,5997.503463,2262.751246
17NW,7500,3319,178180149.9,-471,9971,10442,6174.265441,2296.784862
17SE,7500,3316,178019095.2,-1894,9509,11403,5800.089264,2488.847871
17SW,7500,3307,177535931.2,-1894,9942,11836,5379.569398,2706.890214
22S,7500,3319,178180149.9,-1894,9795,11689,4669.964748,2697.521689
23S,7500,3304,177374876.6,981,9773,8792,4542.057203,2363.228422
24S,7500,3320,178233834.8,784,9336,8552,6350.281325,2229.387237
27A,7500,3314,177911725.5,784,9694,8910,6825.634882,1928.102749
2A,7500,3318,178126465,-384,9110,9494,6450.698915,1748.783395
5NE,7500,3316,178019095.2,-1875,9827,11702,4703.23854,2528.570258
5NW,7500,3316,178019095.2,-1875,9827,11702,5112.283776,2522.762309
5SE,7500,3310,177696985.9,-1842,9827,11669,4969.088218,2702.950393
6NE,7500,3317,178072780.1,1421,9386,7965,6397.021706,1934.595244
6NW,7500,3316,178019095.2,383,9386,9003,5957.167672,2461.264762
6SW,7500,3319,178180149.9,-195,9784,9979,5902.335945,2549.590651
Cell 1 2011/12,7500,3315,177965410.4,-2000,9230,11230,6159.439819,2156.68418
Cell 1 SW 2013,7500,3313,177858040.6,-1970,9468,11438,5631.956535,2260.375062
Cell 10 2011/12,7500,3317,178072780.1,-779,9915,10694,5261.861923,2800.210212
Cell 10 NE 2011/12,7500,3312,177804355.7,-779,9915,10694,5070.288949,2809.907641
Cell 10 NW 2011/12,7500,3316,178019095.2,-1875,9522,11397,5585.420386,2648.644826
Cell 10 SE 2013,7500,3316,178019095.2,383,9386,9003,5957.167672,2461.264762
Cell 10 SW 2011/12,7500,3301,177213821.9,-779,9915,10694,5494.79279,2762.753847
Cell 10-A 2011/12,7500,3311,177750670.8,-779,9971,10750,4883.777711,2869.973066
Cell 11 NE 2011/12,7500,3317,178072780.1,-195,9784,9979,5832.481459,2502.828196
Cell 11 NW 2013,7500,3315,177965410.4,-384,9275,9659,6383.538763,1800.875187
Cell 11 SW 2013,7500,3313,177858040.6,1056,9386,8330,6375.728645,2044.914195
Cell 12 2013,7500,3319,178180149.9,1326,9773,8447,6041.864116,2141.038303
Cell 13 2013,7500,3311,177750670.8,1422,8838,7416,7079.63576,1309.102689
Cell 14 2013,7500,3319,178180149.9,2430,8838,6408,7890.139199,716.9584882
Cell 15 2013,7500,3318,178126465,5348,8938,3590,8055.853225,507.7842824
Cell 15-A 2013,7500,3316,178019095.2,5348,8876,3528,8096.278347,451.1620046
Cell 16 2013,7500,3322,178341204.6,5452,8876,3424,8100.590909,403.1731824
Cell 17 NW 2011/12,7500,3319,178180149.9,-471,9971,10442,6174.265441,2296.784862
Cell 17 NW 2013,7500,3317,178072780.1,-1875,9827,11702,5509.511607,2479.889202
Cell 17 SE 2013,7500,3316,178019095.2,-1875,9522,11397,5585.420386,2648.644826
Cell 17 SW 2013,7500,3311,177750670.8,-1875,9522,11397,5945.520387,2347.419447
Cell 18 2011/12,7500,3320,178233834.8,850,9982,9132,4726.448795,2611.122385
Cell 18 NE 2013,7500,3319,178180149.9,-195,9784,9979,6026.085568,2474.857956
Cell 18 NW 2013,7500,3319,178180149.9,-1842,9827,11669,4945.272371,2695.973726
Cell 18 SE 2013,7500,3317,178072780.1,-195,9784,9979,5832.481459,2502.828196
Cell 18 SSE 2013,7500,3314,177911725.5,-195,9388,9583,5732.688292,2492.469523
Cell 19 NW 2013,7500,3316,178019095.2,1142,9386,8244,6202.381484,2139.845837
Cell 2 2011/12,7500,3317,178072780.1,352,9275,8923,6216.890564,1917.119921
Cell 2 NE 2013,7500,3320,178233834.8,-2000,9096,11096,6478.042169,1785.661488
Cell 2 SW 2013,7500,3316,178019095.2,-2000,9230,11230,6159.623945,2156.980976
Cell 20 2013,7500,3317,178072780.1,1090,9773,8683,6334.307808,1974.75626
Cell 21 2013,7500,3314,177911725.5,1790,9211,7421,7138.379602,1118.958467
Cell 22 2013,7500,3320,178233834.8,4359,8938,4579,7848.012952,530.1615912
Cell 23 2013,7500,3318,178126465,4359,8938,4579,8014.51748,559.3417724
Cell 24 2013,7500,3321,178287519.7,5452,8857,3405,8084.666968,389.111648
Cell 25 NE 2013,7500,3317,178072780.1,-779,9915,10694,5261.861923,2800.210212
Cell 25 SE 2013,7500,3301,177213821.9,-779,9915,10694,5494.79279,2762.753847
Cell 26 NE 2013,7500,3306,177482246.3,-195,9388,9583,5824.100423,2406.645056
Cell 26 NNW 2013,7500,3311,177750670.8,-779,9915,10694,5071.236484,2809.802842
Cell 26 NW 2013,7500,3312,177804355.7,-779,9971,10750,4884.628925,2869.957752
Cell 27 NW 2013,7500,3320,178233834.8,348,9388,9040,5996.998193,2262.904669
Cell 28 2013,7500,3304,177374876.6,700,9982,9282,4312.215799,2450.332444
Cell 29 2013,7500,3316,178019095.2,1210,9358,8148,6403.072979,1844.06981
Cell 3 NE 2013,7500,3316,178019095.2,-384,8957,9341,7039.30579,1243.962526
Cell 3 NW 2013,7500,3315,177965410.4,-2000,9096,11096,6366.821116,1792.705249
Cell 30 2013,7500,3322,178341204.6,3349,8798,5449,7912.047863,523.0158773
Cell 31 2013,7500,3313,177858040.6,4359,8955,4596,8097.44431,548.879807
Cell 32 2013,7500,3323,178394889.5,5634,9017,3383,8230.224797,397.7472953
Cell 33 NE 2013,7500,3319,178180149.9,-471,9971,10442,6174.265441,2296.784862
Cell 33 SE 2013,7500,3305,177428561.5,-1894,9942,11836,5375.746747,2706.83266
Cell 33 SW 2013,7500,3313,177858040.6,-1724,9981,11705,5358.737096,2723.94118
Cell 34 N 2013,7500,3313,177858040.6,-471,9942,10413,6151.332025,2233.115674
Cell 34 NW 2013,7500,3318,178126465,-1894,9971,11865,6289.571127,2145.814785
Cell 34 SE 2013,7500,3315,177965410.4,-1894,9509,11403,5800.305279,2488.477577
Cell 35 2013,7500,3314,177911725.5,850,9982,9132,4665.338865,2662.725744
Cell 37 2013,7500,3321,178287519.7,3349,9341,5992,7626.945799,517.7156953
Cell 38 2013,7500,3314,177911725.5,6613,9040,2427,8195.054013,325.1773683
Cell 39 2013,7500,3316,178019095.2,6375,9040,2665,8268.565139,340.1876845
Cell 4 2013,7500,3318,178126465,2251,9275,7024,7484.132007,674.3984693
Cell 40 NE 2013,7500,3315,177965410.4,-1894,9828,11722,4845.196983,2728.418687
Cell 41 N 2013,7500,3310,177696985.9,-1894,9795,11689,5952.023867,2408.251996
Cell 41 NW 2013,7500,3315,177965410.4,-1894,9795,11689,5583.333937,2555.522556
Cell 42 NW 2013,7500,3312,177804355.7,-10,9874,9884,5805.838768,2509.282074
Cell 43 2013,7500,3303,177321191.7,1113,9341,8228,5729.633364,2334.655721
Cell 44 2013,7500,3314,177911725.5,1376,9341,7965,7132.651177,1394.980539
Cell 45 2013,7500,3322,178341204.6,5222,8935,3713,7789.096328,465.7295983
Cell 47 2013,7500,3314,177911725.5,422,9694,9272,6641.460169,2035.136952
Cell 48 2013,7500,3319,178180149.9,784,9336,8552,6348.591443,2230.231661
Cell 49 2013,7500,3319,178180149.9,1249,9383,8134,6593.823139,1939.211422
Cell 5 2011/12 Summer,7500,3313,177858040.6,-1875,9522,11397,5944.764866,2346.975504
Cell 5 2013,7500,3319,178180149.9,4285,8869,4584,7876.16511,642.5477431
Cell 50 2013,7500,3318,178126465,1387,8734,7347,7027.02833,1659.759371
Cell 51 2013,7500,3308,177589616.1,5785,8935,3150,7981.676844,414.6627414
Cell 52 2013,7500,3313,177858040.6,1274,9383,8109,6944.74434,1826.42685
Cell 53 2013,7500,3319,178180149.9,1401,9157,7756,7043.000603,1671.444719
Cell 54 2013,7500,3321,178287519.7,3061,8961,5900,7903.10539,626.6313227
Cell 55 2013,7500,3319,178180149.9,6068,8870,2802,7963.315758,485.8705146
Cell 56 2013,7500,3314,177911725.5,1581,9931,8350,7204.344297,1185.000552
Cell 57 2013,7500,3321,178287519.7,1694,8887,7193,7129.254441,1019.116069
Cell 58 2013,7500,3320,178233834.8,2166,8961,6795,7872.232229,752.6522329
Cell 59 2013,7500,3324,178448574.4,1505,9931,8426,7084.620638,1280.566495
Cell 6 2011/12,7500,3318,178126465,1142,9386,8244,6123.156118,2187.135901
Cell 6 2013,7500,3321,178287519.7,5526,9007,3481,8091.75941,448.4433643
Cell 6 NE 2011/12,7500,3317,178072780.1,1421,9386,7965,6397.021706,1934.595244
Cell 6 NW 2011/12,7500,3316,178019095.2,383,9386,9003,5957.167672,2461.264762
Cell 6 SW 2011/12,7500,3319,178180149.9,-195,9784,9979,5902.335945,2549.590651
Cell 60 2013,7500,3317,178072780.1,2277,8505,6228,6903.709074,945.7975676
Cell 61 2013,7500,3324,178448574.4,2116,8887,6771,7454.384477,899.5555853
Cell 7 2013,7500,3306,177482246.3,5313,9137,3824,8125.61706,576.3556216
Cell 9 NW 2013,7500,3321,178287519.7,-1842,9827,11669,5020.421259,2457.335066
Cell 9 SE 2013,7500,3317,178072780.1,-1875,9827,11702,4704.032258,2528.602192
Cell 9 SW 2013,7500,3317,178072780.1,-1875,9827,11702,5110.969249,2522.589756
Cell R1,7500,3313,177858040.6,1192,8687,7495,5745.405976,1898.625931
Cell R10,7500,3318,178126465,2251,9275,7024,7484.087101,674.3769352
Cell R100,7500,3317,178072780.1,1387,8734,7347,7026.902924,1659.993825
Cell R101,7500,3320,178233834.8,3400,8935,5535,7814.222289,562.6153188
Cell R104,7500,3321,178287519.7,1358,9157,7799,6906.079795,1922.95099
Cell R105,7500,3319,178180149.9,1401,9157,7756,7043.000603,1671.444719
Cell R106,7500,3324,178448574.4,1401,9014,7613,7214.944043,1344.333285
Cell R107,7500,3321,178287519.7,3061,8961,5900,7903.10539,626.6313227
Cell R11,7500,3320,178233834.8,4285,8869,4584,7875.951807,642.5684808
Cell R111,7500,3322,178341204.6,1351,9931,8580,6660.636063,2070.924549
Cell R112,7500,3318,178126465,2166,9014,6848,7438.886076,739.3789366
Cell R113,7500,3320,178233834.8,1694,8887,7193,7129.185542,1019.261805
Cell R114,7500,3320,178233834.8,2166,8961,6795,7872.367169,752.712596
Cell R117,7500,3321,178287519.7,1476,9931,8455,6636.603734,1879.14287
Cell R118,7500,3313,177858040.6,1581,9931,8350,7202.991247,1187.310109
Cell R119,7500,3322,178341204.6,1694,8887,7193,6978.706201,1084.930726
Cell R120,7500,3315,177965410.4,2116,8887,6771,7344.151433,1028.260533
Cell R121,7500,3320,178233834.8,5473,8831,3358,8016.335843,442.3877969
Cell R123,7500,3318,178126465,1505,9347,7842,6916.85443,1502.973518
Cell R124,7500,3319,178180149.9,2277,8767,6490,6923.194336,953.6803928
Cell R125,7500,3313,177858040.6,2277,8767,6490,6828.437066,990.2044597
Cell R126,7500,3319,178180149.9,2116,8887,6771,7253.123832,1046.514195
Cell R15,7500,3312,177804355.7,-1970,9468,11438,5631.701389,2260.668576
Cell R16,7500,3315,177965410.3,-1842,9827,11669,5018.295928,2458.183675
Cell R17,7500,3315,177965410.4,383,9386,9003,6101.866365,2363.532702
Cell R18,7500,3300,177160137,-384,9110,9494,6388.014545,1794.638537
Cell R19,7500,3321,178287519.7,1373,9768,8395,6567.261367,1707.957887
Cell R20,7500,3317,178072780.1,1422,8848,7426,7195.338257,1199.153312
Cell R21,7500,3317,178072780.1,1422,8838,7416,7359.935182,1339.004184
Cell R22,7500,3319,178180149.9,2430,8838,6408,7890.139199,716.9584882
Cell R24,7500,3317,178072780.1,-1875,9827,11702,5509.511607,2479.889202
Cell R25,7500,3318,178126465,-1842,9827,11669,4944.846293,2696.268227
Cell R26,7500,3321,178287519.7,383,9386,9003,5949.220416,2460.653511
Cell R27,7500,3314,177911725.5,1142,9386,8244,6202.400121,2140.436147
Cell R28,7500,3318,178126465,1090,9773,8683,5781.804702,2245.782606
Cell R29,7500,3317,178072780.1,1090,9773,8683,6334.307808,1974.75626
Cell R30,7500,3319,178180149.9,1533,8838,7305,7411.995481,1002.722619
Cell R31,7500,3315,177965410.4,2657,8938,6281,7791.571041,633.4485681
Cell R35,7500,3312,177804355.7,-1875,9522,11397,5945.354469,2347.084456
Cell R36,7500,3316,178019095.2,-1875,9522,11397,5585.420386,2648.644826
Cell R37,7500,3317,178072780.1,-195,9784,9979,5832.481459,2502.828196
Cell R38,7500,3304,177374876.6,700,9231,8531,5493.130448,2405.322165
Cell R39,7500,3317,178072780.1,1128,9773,8645,6442.987036,1914.609209
Cell R40,7500,3313,177858040.6,1790,9211,7421,7138.240869,1119.098831
Cell R46,7500,3309,177643301,-779,9961,10740,5388.110305,2822.248556
Cell R47,7500,3311,177750670.8,-779,9971,10750,4881.76714,2870.262571
Cell R48,7500,3304,177374876.6,-195,9388,9583,5822.979722,2406.939408
Cell R49,7500,3321,178287519.7,348,9388,9040,5997.252936,2262.611558
Cell R5,7500,3315,177965410.3,-1970,9374,11344,5842.486878,2050.528925
Cell R50,7500,3302,177267506.8,700,9982,9282,4313.786796,2450.241539
Cell R51,7500,3317,178072780.1,1210,9358,8148,6418.239674,1832.23635
Cell R52,7500,3316,178019095.2,2443,8808,6365,7343.198432,761.9785083
Cell R53,7500,3319,178180149.9,2443,8651,6208,7456.871347,671.4317391
Cell R54,7500,3314,177911725.5,4359,8955,4596,8097.140917,548.9014302
Cell R58,7500,3317,178072780.1,-779,9976,10755,5268.968345,2791.360902
Cell R59,7500,3319,178180149.9,-471,9971,10442,6174.265441,2296.784862
Cell R6,7500,3316,178019095.2,-2000,9230,11230,6159.623945,2156.980976
Cell R60,7500,3317,178072780.1,-1894,9971,11865,6289.048236,2145.926853
Cell R61,7500,3316,178019095.2,850,9982,9132,4667.072678,2662.86184
Cell R62,7500,3317,178072780.1,716,9829,9113,4752.549894,2519.236442
Cell R63,7500,3317,178072780.1,716,9358,8642,6064.586675,2072.60324
Cell R64,7500,3318,178126465,3349,9288,5939,7632.534961,576.363375
Cell R65,7500,3322,178341204.6,3349,8798,5449,7912.047863,523.0158773
Cell R66,7500,3311,177750670.8,5718,8955,3237,8258.608879,325.8712998
Cell R69,7500,3313,177858040.6,-1724,9981,11705,5358.737096,2723.94118
Cell R7,7500,3314,177911725.5,-2000,9096,11096,6366.395293,1792.80807
Cell R70,7500,3305,177428561.5,-1894,9942,11836,5375.746747,2706.83266
Cell R71,7500,3314,177911725.5,-1894,9509,11403,5799.584792,2488.507267
Cell R72,7500,3318,178126465,-10,9982,9992,5595.820976,2610.196788
Cell R73,7500,3315,177965410.4,-10,9982,9992,4713.733032,2737.2253
Cell R74,7500,3318,178126465,716,9341,8625,6057.035262,2311.169791
Cell R75,7500,3321,178287519.7,3349,9341,5992,7627.130684,517.7567483
Cell R76,7500,3310,177696985.9,6008,8798,2790,8079.778248,344.9715454
Cell R77,7500,3315,177965410.4,6613,9040,2427,8195.05279,325.1283259
Cell R8,7500,3313,177858040.6,-384,8957,9341,7002.894054,1254.572841
Cell R80,7500,3315,177965410.4,-1894,9828,11722,4843.579789,2728.208789
Cell R81,7500,3319,178180149.9,-1813,9844,11657,5975.767099,2425.896413
Cell R82,7500,3313,177858040.6,-10,9874,9884,5806.383942,2509.099512
Cell R83,7500,3313,177858040.6,-10,9874,9884,6002.563839,2418.952736
Cell R84,7500,3318,178126465,834,9341,8507,5295.936106,2443.965819
Cell R85,7500,3305,177428561.5,1113,9341,8228,5729.043873,2334.353215
Cell R86,7500,3318,178126465,1626,9284,7658,7419.133514,1014.843952
Cell R87,7500,3322,178341204.6,5222,8935,3713,7789.096328,465.7295983
Cell R9,7500,3318,178126465,-384,8813,9197,7157.293249,1176.206769
Cell R90,7500,3314,177911725.5,422,9694,9272,6641.460169,2035.136952
Cell R91,7500,3318,178126465,784,9336,8552,6349.748945,2229.5707
Cell R92,7500,3314,177911725.5,1032,9683,8651,5218.634279,2447.331236
Cell R93,7500,3318,178126465,1249,9383,8134,6593.575648,1939.451216
Cell R97,7500,3313,177858040.6,784,9694,8910,6986.415937,1800.90749
Cell R98,7500,3317,178072780.1,1032,9383,8351,6764.616822,2073.644609
Cell R99,7500,3313,177858040.6,1274,9383,8109,6944.74434,1826.42685
Cell S102,7500,3316,178019095.2,5785,8935,3150,8006.823583,416.449076
Cell S108,7500,3319,178180149.9,6068,8870,2802,7963.315758,485.8705146
Cell S13,7500,3320,178233834.8,5628,9125,3497,8170.981024,452.6797572
Cell S14,7500,3306,177482246.3,5313,9137,3824,8125.61706,576.3556216
Cell S2,7500,3322,178341204.6,5526,9007,3481,8091.885611,448.434842
Cell S23,7500,3315,177965410.4,5348,9125,3777,8129.992459,507.3901652
Cell S32,7500,3315,177965410.4,5348,8938,3590,7952.1819,460.8284347
Cell S33,7500,3315,177965410.4,5348,8876,3528,8096.107089,451.1222671
Cell S34,7500,3320,178233834.8,5452,8857,3405,8084.660241,389.1700517
Cell S41,7500,3316,178019095.2,3863,8751,4888,7675.012364,456.02162
Cell S42,7500,3318,178126465,4359,8938,4579,8014.538276,559.345861
Cell S44,7500,3316,178019095.2,5878,8939,3061,8149.404403,363.9219554
Cell S56,7500,3316,178019095.2,5634,8939,3305,8041.016888,456.5958965
Cell S67,7500,3323,178394889.5,5634,9017,3383,8230.224797,397.7472953
Cell S78,7500,3317,178072780.1,6375,9040,2665,8268.539644,340.1395695
Cell S88,7500,3320,178233834.8,6077,8986,2909,8070.337952,412.0933201
Cell S94,7500,3319,178180149.9,5222,8935,3713,7995.371196,388.7415349
Cell S95,7500,3307,177535931.2,5785,8935,3150,7981.54551,414.6566345
W287,7500,3310,177696985.9,807,9622,8815,4185.990332,2078.29586
W295,7500,3317,178072780.1,1437,8825,7388,6923.890564,1716.020459
W338,7500,3314,177911725.5,692,9923,9231,3720.854255,2378.407938
W342,7500,3316,178019095.2,1013,8572,7559,5295.34801,2296.634596
W345,7500,3314,177911725.5,1581,8605,7024,7293.287568,999.9375848
W387,7500,3316,178019095.2,701,9937,9236,5287.044934,2466.479342
W393,7500,3314,177911725.5,853,9522,8669,5629.274291,2382.445302
W440,7500,3307,177535931.2,1125,9937,8812,5759.724826,2343.430568
W441,7500,3314,177911725.5,1392,8634,7242,6523.452022,1637.033076
W445,7500,3315,177965410.3,1848,8692,6844,6778.574359,1070.466939
W500,7500,3316,178019095.2,1427,8823,7396,6359.72889,1690.021121
1,7750,3540,190044510.6,-2000,9230,11230,6117.020339,2171.492185
2,7750,3541,190098195.5,-384,9275,9659,6232.667043,1932.960302
3,7750,3539,189990825.7,1373,9768,8395,6892.464821,1467.454257
4,7750,3538,189937140.8,1422,8848,7426,7153.317976,1176.192321
5,7750,3538,189937140.8,-1875,9552,11427,5885.136235,2369.146385
6,7750,3541,190098195.5,1142,9386,8244,6085.6854,2198.604864
7,7750,3543,190205565.3,1326,9773,8447,6013.179227,2148.868387
8,7750,3539,189990825.7,1422,8838,7416,7120.852218,1283.557697
9,7750,3541,190098195.5,4888,8938,4050,7887.634567,474.824167
10,7750,3541,190098195.5,-779,9915,10694,5234.951991,2822.628057
11,7750,3538,189937140.8,-195,9388,9583,5873.052855,2400.130589
12,7750,3549,190527674.6,700,9982,9282,4317.110454,2453.21152
13,7750,3539,189990825.7,1210,9358,8148,6368.070359,1883.73753
14,7750,3538,189937140.8,4359,8955,4596,8007.88892,554.7632844
16,7750,3539,189990825.7,-1724,9981,11705,5298.100311,2706.456668
17,7750,3537,189883455.9,-1894,9971,11865,6250.845632,2176.72094
18,7750,3542,190151880.4,850,9982,9132,4742.477132,2606.200756
19,7750,3539,189990825.7,716,9829,9113,4807.6256,2517.687717
20,7750,3543,190205565.3,3349,9341,5992,7623.591307,518.8818588
21,7750,3545,190312935,6613,9040,2427,8185.30409,335.1474148
22,7750,3542,190151880.4,-1894,9795,11689,4812.393845,2719.7076
23,7750,3545,190312935,-10,9874,9884,5874.797743,2477.210788
24,7750,3541,190098195.5,784,9336,8552,6313.12087,2238.111492
25,7750,3549,190527674.6,1249,9383,8134,6596.896027,1941.235845
26,7750,3545,190312935,5222,8935,3713,7791.998025,470.7312623
27,7750,3542,190151880.4,1032,9683,8651,6696.343309,2120.193455
28,7750,3541,190098195.5,1401,9157,7756,7026.826038,1705.848117
29,7750,3540,190044510.6,1387,8754,7367,7023.188983,1671.77036
31,7750,3543,190205565.3,1475,9931,8456,7134.482924,1554.81367
32,7750,3544,190259250.2,1694,8887,7193,7140.467551,1011.78926
33,7750,3542,190151880.4,1581,9931,8350,7142.499435,1285.749651
34,7750,3545,190312935,2277,8526,6249,6923.4378,940.5902835
10A,7750,3539,189990825.7,-779,9971,10750,4911.11783,2870.243775
10NE,7750,3539,189990825.7,-779,9915,10694,5079.677593,2812.930144
10NW,7750,3535,189776086.1,-1875,9784,11659,5574.914286,2641.182344
10SW,7750,3539,189990825.7,-779,9915,10694,5455.399265,2780.042672
11NE,7750,3547,190420304.8,-195,9784,9979,5804.586693,2500.593756
11NW,7750,3537,189883455.9,-195,9784,9979,5758.027707,2510.358195
11SE,7750,3544,190259250.2,279,9971,9692,6022.407167,2263.688136
17NW,7750,3540,190044510.6,-471,9971,10442,6113.610452,2327.505041
17SE,7750,3540,190044510.6,-1894,9615,11509,5824.588983,2494.691577
17SW,7750,3539,189990825.7,-1894,9942,11836,5392.423566,2706.355481
22S,7750,3535,189776086.1,-1894,9795,11689,4684.573126,2702.946183
23S,7750,3548,190473989.7,981,9773,8792,4613.764374,2370.285476
24S,7750,3537,189883455.9,784,9336,8552,6308.900198,2236.876957
27A,7750,3541,190098195.5,784,9694,8910,6826.613104,1930.117641
2A,7750,3537,189883455.9,-384,9110,9494,6470.489681,1755.864872
5NE,7750,3539,189990825.7,-1875,9827,11702,4739.425261,2522.208387
5NW,7750,3541,190098195.5,-1875,9827,11702,5109.349901,2528.668436
5SE,7750,3538,189937140.8,-1842,9827,11669,5056.860373,2704.421556
6NE,7750,3546,190366619.9,1142,9386,8244,6307.987592,1993.189985
6NW,7750,3544,190259250.2,383,9784,9401,5959.277935,2449.785846
6SW,7750,3536,189829771,-195,9784,9979,5831.489536,2578.472071
Cell 1 2011/12,7750,3540,190044510.6,-2000,9230,11230,6117.020339,2171.492185
Cell 1 SW 2013,7750,3535,189776086.1,-1970,9468,11438,5651.73041,2258.984086
Cell 10 2011/12,7750,3541,190098195.5,-779,9915,10694,5234.951991,2822.628057
Cell 10 NE 2011/12,7750,3539,189990825.7,-779,9915,10694,5079.677593,2812.930144
Cell 10 NW 2011/12,7750,3535,189776086.1,-1875,9784,11659,5574.914286,2641.182344
Cell 10 SE 2013,7750,3544,190259250.2,383,9784,9401,5959.277935,2449.785846
Cell 10 SW 2011/12,7750,3539,189990825.7,-779,9915,10694,5455.399265,2780.042672
Cell 10-A 2011/12,7750,3539,189990825.7,-779,9971,10750,4911.11783,2870.243775
Cell 11 NE 2011/12,7750,3547,190420304.8,-195,9784,9979,5804.586693,2500.593756
Cell 11 NW 2013,7750,3536,189829771,-384,9275,9659,6390.230204,1821.03442
Cell 11 SW 2013,7750,3539,189990825.7,851,9386,8535,6320.761515,2060.94005
Cell 12 2013,7750,3545,190312935,1326,9773,8447,6012.293653,2148.582506
Cell 13 2013,7750,3541,190098195.5,1422,8875,7453,7094.613951,1285.632069
Cell 14 2013,7750,3542,190151880.4,2057,8842,6785,7864.907679,801.599256
Cell 15 2013,7750,3543,190205565.3,5348,8938,3590,8069.472763,507.4094136
Cell 15-A 2013,7750,3543,190205565.3,5348,8876,3528,8103.362969,449.173645
Cell 16 2013,7750,3544,190259250.2,5452,8941,3489,8102.478555,402.1379414
Cell 17 NW 2011/12,7750,3540,190044510.6,-471,9971,10442,6113.610452,2327.505041
Cell 17 NW 2013,7750,3545,190312935,-1875,9827,11702,5493.047955,2483.548677
Cell 17 SE 2013,7750,3534,189722401.3,-1875,9784,11659,5574.308715,2641.310614
Cell 17 SW 2013,7750,3536,189829771,-1875,9522,11397,5888.64112,2370.34891
Cell 18 2011/12,7750,3542,190151880.4,850,9982,9132,4742.477132,2606.200756
Cell 18 NE 2013,7750,3537,189883455.9,-195,9784,9979,5945.340401,2516.505274
Cell 18 NW 2013,7750,3543,190205565.3,-1842,9827,11669,5030.935366,2702.13758
Cell 18 SE 2013,7750,3547,190420304.8,-195,9784,9979,5804.586693,2500.593756
Cell 18 SSE 2013,7750,3542,190151880.4,-195,9405,9600,5792.340768,2486.25917
Cell 19 NW 2013,7750,3541,190098195.5,1142,9386,8244,6176.105337,2148.487412
Cell 2 2011/12,7750,3541,190098195.5,-384,9275,9659,6232.667043,1932.960302
Cell 2 NE 2013,7750,3535,189776086.1,-2000,9096,11096,6484.444696,1782.239838
Cell 2 SW 2013,7750,3540,190044510.6,-2000,9230,11230,6114.809605,2173.002985
Cell 20 2013,7750,3539,189990825.7,1090,9773,8683,6286.082792,2007.164681
Cell 21 2013,7750,3540,190044510.6,1506,9211,7705,7100.99435,1177.512171
Cell 22 2013,7750,3538,189937140.8,4359,8938,4579,7849.968344,536.1645052
Cell 23 2013,7750,3544,190259250.2,4359,8938,4579,8006.904063,561.8037862
Cell 24 2013,7750,3546,190366619.9,5452,8857,3405,8090.007614,388.4197332
Cell 25 NE 2013,7750,3541,190098195.5,-779,9915,10694,5234.951991,2822.628057
Cell 25 SE 2013,7750,3539,189990825.7,-779,9915,10694,5455.399265,2780.042672
Cell 26 NE 2013,7750,3538,189937140.8,-195,9388,9583,5873.052855,2400.130589
Cell 26 NNW 2013,7750,3539,189990825.7,-779,9915,10694,5079.677593,2812.930144
Cell 26 NW 2013,7750,3539,189990825.7,-779,9971,10750,4913.296694,2869.780896
Cell 27 NW 2013,7750,3543,190205565.3,279,9971,9692,6023.455264,2263.147627
Cell 28 2013,7750,3549,190527674.6,700,9982,9282,4317.950409,2452.675268
Cell 29 2013,7750,3540,190044510.6,1210,9358,8148,6369.382203,1881.891983
Cell 3 NE 2013,7750,3538,189937140.8,-384,8957,9341,7035.37818,1244.60566
Cell 3 NW 2013,7750,3537,189883455.9,-2000,9096,11096,6361.160305,1791.323095
Cell 30 2013,7750,3542,190151880.4,3349,8798,5449,7901.959627,530.0059323
Cell 31 2013,7750,3542,190151880.4,4359,8955,4596,8095.592321,546.2561277
Cell 32 2013,7750,3539,189990825.7,5634,9040,3406,8228.448714,400.6076288
Cell 33 NE 2013,7750,3541,190098195.5,-471,9971,10442,6113.719006,2327.18533
Cell 33 SE 2013,7750,3538,189937140.8,-1894,9942,11836,5393.502826,2705.976339
Cell 33 SW 2013,7750,3536,189829771,-1724,9981,11705,5330.03026,2717.307204
Cell 34 N 2013,7750,3538,189937140.8,-782,9942,10724,6096.977954,2263.808903
Cell 34 NW 2013,7750,3537,189883455.9,-1894,9971,11865,6250.845632,2176.72094
Cell 34 SE 2013,7750,3537,189883455.9,-1894,9615,11509,5824.206955,2494.335918
Cell 35 2013,7750,3543,190205565.3,850,9982,9132,4696.786057,2647.544985
Cell 37 2013,7750,3545,190312935,3349,9341,5992,7626.106347,519.6890594
Cell 38 2013,7750,3543,190205565.3,6613,9040,2427,8192.14818,331.9369753
Cell 39 2013,7750,3542,190151880.4,6375,9040,2665,8261.115471,344.1030484
Cell 4 2013,7750,3538,189937140.8,1504,9275,7771,7457.044658,753.560012
Cell 40 NE 2013,7750,3546,190366619.9,-1894,9828,11722,4866.55612,2725.492514
Cell 41 N 2013,7750,3541,190098195.5,-1894,9795,11689,5913.709969,2420.948157
Cell 41 NW 2013,7750,3540,190044510.6,-1894,9795,11689,5581.338418,2559.733297
Cell 42 NW 2013,7750,3540,190044510.6,-10,9874,9884,5872.658192,2480.706431
Cell 43 2013,7750,3546,190366619.9,1113,9341,8228,5716.109983,2349.758597
Cell 44 2013,7750,3543,190205565.3,1376,9341,7965,7076.290996,1473.63282
Cell 45 2013,7750,3542,190151880.4,5222,8935,3713,7792.138058,470.7699028
Cell 47 2013,7750,3541,190098195.5,422,9694,9272,6662.678622,2021.723973
Cell 48 2013,7750,3542,190151880.4,784,9336,8552,6305.568041,2237.057488
Cell 49 2013,7750,3549,190527674.6,1249,9383,8134,6596.896027,1941.235845
Cell 5 2011/12 Summer,7750,3537,189883455.9,-1875,9522,11397,5889.168787,2370.221505
Cell 5 2013,7750,3538,189937140.8,4285,8869,4584,7879.185981,636.2923322
Cell 50 2013,7750,3540,190044510.6,1387,8754,7367,7023.188983,1671.77036
Cell 51 2013,7750,3551,190635044.4,5785,8935,3150,7985.329485,410.4635566
Cell 52 2013,7750,3541,190098195.5,1274,9383,8109,6903.681164,1862.400999
Cell 53 2013,7750,3541,190098195.5,1401,9157,7756,7026.826038,1705.848117
Cell 54 2013,7750,3544,190259250.2,3061,8961,5900,7893.936795,639.7966959
Cell 55 2013,7750,3547,190420304.8,5785,8952,3167,7950.570341,487.0580918
Cell 56 2013,7750,3542,190151880.4,1581,9931,8350,7141.367589,1288.398044
Cell 57 2013,7750,3547,190420304.8,1694,8887,7193,7138.417818,1014.004897
Cell 58 2013,7750,3539,189990825.7,1997,8961,6964,7834.417067,839.6798143
Cell 59 2013,7750,3543,190205565.3,1505,9931,8426,7045.1256,1341.002528
Cell 6 2011/12,7750,3541,190098195.5,1142,9386,8244,6085.6854,2198.604864
Cell 6 2013,7750,3541,190098195.5,5526,9007,3481,8093.408359,445.9545776
Cell 6 NE 2011/12,7750,3546,190366619.9,1142,9386,8244,6307.987592,1993.189985
Cell 6 NW 2011/12,7750,3544,190259250.2,383,9784,9401,5959.277935,2449.785846
Cell 6 SW 2011/12,7750,3536,189829771,-195,9784,9979,5831.489536,2578.472071
Cell 60 2013,7750,3542,190151880.4,2277,8767,6490,6914.665443,947.152112
Cell 61 2013,7750,3544,190259250.2,2116,8887,6771,7437.157731,935.1091707
Cell 7 2013,7750,3548,190473989.7,5313,9137,3824,8124.932356,575.6667748
Cell 9 NW 2013,7750,3542,190151880.4,-1842,9827,11669,5070.519198,2462.415251
Cell 9 SE 2013,7750,3537,189883455.9,-1875,9827,11702,4738.711337,2522.37869
Cell 9 SW 2013,7750,3542,190151880.4,-1875,9827,11702,5110.128176,2528.735582
Cell R1,7750,3541,190098195.5,1109,8687,7578,5731.873482,1901.299125
Cell R10,7750,3538,189937140.8,1504,9275,7771,7457.044658,753.560012
Cell R100,7750,3540,190044510.6,1387,8754,7367,7021.782486,1673.139459
Cell R101,7750,3544,190259250.2,2124,8935,6811,7791.152652,632.8719372
Cell R104,7750,3536,189829771,1358,9157,7799,6927.133484,1897.644855
Cell R105,7750,3540,190044510.6,1401,9157,7756,7028.30452,1703.819094
Cell R106,7750,3544,190259250.2,1401,9014,7613,7231.764673,1317.654831
Cell R107,7750,3544,190259250.2,3061,8961,5900,7893.936795,639.7966959
Cell R11,7750,3537,189883455.9,4285,8869,4584,7879.163981,636.3809285
Cell R111,7750,3536,189829771,1351,9931,8580,6662.677036,2057.056219
Cell R112,7750,3540,190044510.6,1694,9474,7780,7433.691525,758.4781457
Cell R113,7750,3546,190366619.9,1694,8887,7193,7138.171461,1014.041725
Cell R114,7750,3539,189990825.7,1997,8961,6964,7834.417067,839.6798143
Cell R117,7750,3544,190259250.2,1476,9931,8455,6617.613713,1892.976248
Cell R118,7750,3541,190098195.5,1581,9931,8350,7141.265179,1288.565543
Cell R119,7750,3540,190044510.6,1694,8887,7193,7002.541243,1067.478715
Cell R120,7750,3549,190527674.6,1941,8887,6946,7339.220062,1053.762901
Cell R121,7750,3541,190098195.5,5201,8831,3630,8009.448743,457.3462479
Cell R123,7750,3542,190151880.4,1505,9347,7842,6908.404856,1500.538014
Cell R124,7750,3542,190151880.4,2277,8767,6490,6928.021457,948.1756563
Cell R125,7750,3542,190151880.4,2277,8767,6490,6835.458216,977.9957451
Cell R126,7750,3542,190151880.4,2116,8887,6771,7240.580745,1065.96316
Cell R15,7750,3538,189937140.8,-1970,9468,11438,5653.557377,2258.937068
Cell R16,7750,3542,190151880.4,-1842,9827,11669,5070.499153,2462.361426
Cell R17,7750,3535,189776086.1,383,9386,9003,6076.45686,2355.809887
Cell R18,7750,3544,190259250.2,-384,9275,9659,6398.403499,1813.465478
Cell R19,7750,3542,190151880.4,1326,9768,8442,6547.050819,1723.255281
Cell R20,7750,3540,190044510.6,1422,8848,7426,7206.565254,1200.396936
Cell R21,7750,3541,190098195.5,1422,8838,7416,7360.87207,1337.6249
Cell R22,7750,3541,190098195.5,2057,8842,6785,7864.658006,801.5747215
Cell R24,7750,3545,190312935,-1875,9827,11702,5493.047955,2483.548677
Cell R25,7750,3543,190205565.3,-1842,9827,11669,5030.935366,2702.13758
Cell R26,7750,3535,189776086.1,383,9386,9003,5957.871853,2449.25085
Cell R27,7750,3543,190205565.3,1142,9386,8244,6176.997742,2148.253939
Cell R28,7750,3540,190044510.6,1090,9773,8683,5740.990395,2264.902509
Cell R29,7750,3539,189990825.7,1090,9773,8683,6286.082792,2007.164681
Cell R30,7750,3537,189883455.9,1533,8838,7305,7412.791914,1013.412863
Cell R31,7750,3541,190098195.5,2057,8938,6881,7777.530076,675.0497763
Cell R35,7750,3536,189829771,-1875,9522,11397,5890.108314,2369.898019
Cell R36,7750,3535,189776086.1,-1875,9784,11659,5574.914286,2641.182344
Cell R37,7750,3547,190420304.8,-195,9784,9979,5804.586693,2500.593756
Cell R38,7750,3541,190098195.5,700,9231,8531,5497.034736,2415.945584
Cell R39,7750,3544,190259250.2,1128,9773,8645,6397.479684,1953.288854
Cell R40,7750,3540,190044510.6,1506,9211,7705,7100.893503,1177.483774
Cell R46,7750,3540,190044510.6,-779,9961,10740,5417.355367,2823.908197
Cell R47,7750,3539,189990825.7,-779,9971,10750,4911.11783,2870.243775
Cell R48,7750,3538,189937140.8,-195,9388,9583,5873.052855,2400.130589
Cell R49,7750,3544,190259250.2,279,9971,9692,6024.10807,2263.161911
Cell R5,7750,3545,190312935,-1970,9374,11344,5842.462059,2046.34355
Cell R50,7750,3547,190420304.8,700,9982,9282,4318.532281,2453.13917
Cell R51,7750,3540,190044510.6,1210,9358,8148,6388.733333,1869.489678
Cell R52,7750,3540,190044510.6,2443,8808,6365,7352.880508,749.4240573
Cell R53,7750,3538,189937140.8,2443,8651,6208,7455.538722,680.91829
Cell R54,7750,3542,190151880.4,4359,8955,4596,8095.592321,546.2561277
Cell R58,7750,3536,189829771,-779,9976,10755,5277.414027,2780.335377
Cell R59,7750,3539,189990825.7,-471,9971,10442,6114.335123,2327.434517
Cell R6,7750,3540,190044510.6,-2000,9230,11230,6114.809605,2173.002985
Cell R60,7750,3537,189883455.9,-1894,9971,11865,6250.845632,2176.72094
Cell R61,7750,3543,190205565.3,850,9982,9132,4696.786057,2647.544985
Cell R62,7750,3537,189883455.9,716,9829,9113,4782.014702,2522.891901
Cell R63,7750,3539,189990825.7,716,9358,8642,6028.833004,2094.576455
Cell R64,7750,3543,190205565.3,3349,9288,5939,7641.974598,573.4610408
Cell R65,7750,3543,190205565.3,3349,8798,5449,7901.655095,530.2409728
Cell R66,7750,3543,190205565.3,5718,8955,3237,8247.917019,329.7258295
Cell R69,7750,3536,189829771,-1724,9981,11705,5329.786199,2717.629217
Cell R7,7750,3537,189883455.9,-2000,9096,11096,6361.160305,1791.323095
Cell R70,7750,3538,189937140.8,-1894,9942,11836,5393.502826,2705.976339
Cell R71,7750,3538,189937140.8,-1894,9615,11509,5824.793103,2494.227002
Cell R72,7750,3538,189937140.8,-10,9982,9992,5587.146128,2614.400217
Cell R73,7750,3540,190044510.6,-10,9982,9992,4689.317514,2716.765873
Cell R74,7750,3542,190151880.4,716,9341,8625,6059.54489,2314.312783
Cell R75,7750,3546,190366619.9,3349,9341,5992,7626.109983,519.6158211
Cell R76,7750,3543,190205565.3,6008,8802,2794,8075.71352,348.4111812
Cell R77,7750,3543,190205565.3,6613,9040,2427,8191.940728,331.8798132
Cell R8,7750,3541,190098195.5,-384,8957,9341,6991.282124,1274.813715
Cell R80,7750,3545,190312935,-1894,9828,11722,4865.68914,2725.387956
Cell R81,7750,3543,190205565.3,-1894,9844,11738,5902.87694,2464.326351
Cell R82,7750,3540,190044510.6,-10,9874,9884,5872.658192,2480.706431
Cell R83,7750,3542,190151880.4,-10,9874,9884,6042.824675,2401.158885
Cell R84,7750,3543,190205565.3,834,9341,8507,5324.326559,2455.363874
Cell R85,7750,3546,190366619.9,1113,9341,8228,5716.201354,2349.838188
Cell R86,7750,3542,190151880.4,1535,9284,7749,7421.526821,1038.263467
Cell R87,7750,3544,190259250.2,5222,8935,3713,7792.140801,470.7209166
Cell R9,7750,3539,189990825.7,-384,8813,9197,7129.218988,1208.732292
Cell R90,7750,3542,190151880.4,422,9694,9272,6662.765104,2021.445111
Cell R91,7750,3542,190151880.4,784,9336,8552,6305.568041,2237.057488
Cell R92,7750,3543,190205565.3,1032,9683,8651,5293.977985,2430.745356
Cell R93,7750,3549,190527674.6,1249,9383,8134,6596.896027,1941.235845
Cell R97,7750,3542,190151880.4,784,9694,8910,6983.134952,1811.02815
Cell R98,7750,3541,190098195.5,1032,9683,8651,6696.135837,2120.456861
Cell R99,7750,3541,190098195.5,1274,9383,8109,6903.681164,1862.400999
Cell S102,7750,3545,190312935,5785,8935,3150,8002.722426,414.9100512
Cell S108,7750,3546,190366619.9,5785,8952,3167,7950.641286,487.1084393
Cell S13,7750,3541,190098195.5,5628,9125,3497,8174.183282,452.0870833
Cell S14,7750,3547,190420304.8,5313,9137,3824,8125.032986,575.7167154
Cell S2,7750,3542,190151880.4,5526,9007,3481,8093.347826,445.9061703
Cell S23,7750,3542,190151880.4,5348,9125,3777,8130.180689,501.8656499
Cell S32,7750,3538,189937140.8,5348,8938,3590,7952.280667,455.2822525
Cell S33,7750,3543,190205565.3,5348,8876,3528,8103.362969,449.173645
Cell S34,7750,3546,190366619.9,5452,8857,3405,8090.007614,388.4197332
Cell S41,7750,3543,190205565.3,3863,8751,4888,7673.882868,464.4925214
Cell S42,7750,3544,190259250.2,4359,8938,4579,8006.904063,561.8037862
Cell S44,7750,3545,190312935,5878,8939,3061,8140.739633,371.2101776
Cell S56,7750,3541,190098195.5,5634,8955,3321,8044.278452,458.9730317
Cell S67,7750,3539,189990825.7,5634,9040,3406,8228.448714,400.6076288
Cell S78,7750,3543,190205565.3,6375,9040,2665,8261.164268,344.0667401
Cell S88,7750,3542,190151880.4,6077,8986,2909,8068.848673,417.3827154
Cell S94,7750,3542,190151880.4,5222,8935,3713,7985.173348,395.28784
Cell S95,7750,3551,190635044.4,5785,8935,3150,7985.329485,410.4635566
W287,7750,3536,189829771,-1851,9740,11591,4237.646776,2093.827539
W295,7750,3538,189937140.8,1344,8991,7647,6908.833522,1737.470272
W338,7750,3544,190259250.2,692,9923,9231,3712.379515,2366.574895
W342,7750,3539,189990825.7,1013,8572,7559,5313.124894,2291.079405
W345,7750,3538,189937140.8,1581,8605,7024,7257.214811,1053.517704
W387,7750,3538,189937140.8,201,9937,9736,5241.78095,2467.485016
W393,7750,3542,190151880.4,853,9522,8669,5546.575099,2415.362942
W440,7750,3536,189829771,1125,9937,8812,5790.140271,2336.693309
W441,7750,3532,189615031.5,1220,8634,7414,6471.280011,1681.1596
W445,7750,3545,190312935,1848,8692,6844,6788.711707,1054.078952
W500,7750,3534,189722401.3,1427,8823,7396,6384.002264,1670.040459
1,8000,3767,202230980.6,-2000,9230,11230,6079.622246,2180.769649
2,8000,3766,202177295.7,-384,9275,9659,6251.744291,1941.83945
3,8000,3779,202875199.3,382,9768,9386,6867.625562,1490.6428
4,8000,3776,202714144.6,1422,8848,7426,7171.416843,1166.270206
5,8000,3776,202714144.6,-1875,9827,11702,5831.281515,2384.796503
6,8000,3771,202445720.2,1142,9386,8244,6054.173429,2204.390868
7,8000,3771,202445720.2,1326,9773,8447,6001.782021,2146.474507
8,8000,3778,202821514.4,1422,8875,7453,7140.14558,1262.062815
9,8000,3782,203036254,4425,8938,4513,7882.140666,491.2053671
10,8000,3769,202338350.4,-779,9915,10694,5212.040594,2834.965481
11,8000,3769,202338350.4,-195,9388,9583,5913.767843,2392.270768
12,8000,3772,202499405.1,700,9982,9282,4337.966331,2457.437578
13,8000,3773,202553090,1210,9358,8148,6336.539359,1916.930133
14,8000,3779,202875199.3,4359,8955,4596,8009.605451,551.2268793
16,8000,3768,202284665.5,-1724,9981,11705,5276.598461,2699.553694
17,8000,3771,202445720.2,-1894,9971,11865,6229.029435,2193.000449
18,8000,3772,202499405.1,850,9982,9132,4764.020414,2602.517324
19,8000,3780,202928884.2,716,9829,9113,4851.441534,2517.085675
20,8000,3777,202767829.5,3349,9341,5992,7620.490071,526.4978567
21,8000,3773,202553090,6613,9040,2427,8182.313279,339.7982773
22,8000,3770,202392035.3,-1894,9795,11689,4837.043501,2727.393994
23,8000,3772,202499405.1,-10,9874,9884,5943.562831,2452.678308
24,8000,3776,202714144.6,784,9694,8910,6268.424788,2253.183104
25,8000,3775,202660459.8,1249,9383,8134,6591.658808,1945.334632
26,8000,3774,202606774.9,5222,8935,3713,7799.670111,472.8268534
27,8000,3779,202875199.3,1032,9683,8651,6631.971421,2156.209854
28,8000,3778,202821514.4,1387,9157,7770,6997.13208,1742.527097
29,8000,3774,202606774.9,1387,8800,7413,7019.100689,1681.409641
31,8000,3773,202553090,1475,9931,8456,7104.694673,1572.917677
32,8000,3771,202445720.2,1694,8887,7193,7150.2559,1010.162939
33,8000,3775,202660459.7,1581,9931,8350,7099.276821,1341.305355
34,8000,3775,202660459.8,2277,8596,6319,6939.435497,945.2173109
10A,8000,3770,202392035.3,-779,9971,10750,4939.483289,2861.915036
10NE,8000,3774,202606774.9,-779,9915,10694,5106.876524,2813.209096
10NW,8000,3773,202553090,-1875,9784,11659,5593.016698,2620.551846
10SW,8000,3770,202392035.3,-779,9915,10694,5422.829708,2794.554934
11NE,8000,3773,202553090,-195,9784,9979,5780.088524,2498.934255
11NW,8000,3773,202553090,-195,9784,9979,5806.384045,2499.580671
11SE,8000,3772,202499405.1,-65,9971,10036,6029.918346,2271.062819
17NW,8000,3768,202284665.5,-471,9971,10442,6062.899682,2352.557926
17SE,8000,3770,202392035.3,-1894,9982,11876,5850.017241,2493.86832
17SW,8000,3768,202284665.5,-1894,9942,11836,5409.421975,2702.559007
22S,8000,3774,202606774.9,-1894,9795,11689,4706.851086,2712.639454
23S,8000,3770,202392035.3,981,9773,8792,4681.661273,2384.015658
24S,8000,3776,202714144.6,784,9694,8910,6263.421345,2252.822559
27A,8000,3776,202714144.6,784,9694,8910,6823.334216,1933.747291
2A,8000,3772,202499405.1,-384,9275,9659,6489.788706,1759.180432
5NE,8000,3770,202392035.3,-1875,9827,11702,4785.181432,2517.356155
5NW,8000,3764,202069926,-1875,9827,11702,5121.05526,2532.717082
5SE,8000,3773,202553090,-1842,9827,11669,5127.585741,2707.736578
6NE,8000,3771,202445720.2,1142,9386,8244,6217.914081,2047.708945
6NW,8000,3772,202499405.1,383,9784,9401,5970.333245,2437.474398
6SW,8000,3775,202660459.8,-195,9784,9979,5762.264901,2600.695414
Cell 1 2011/12,8000,3767,202230980.6,-2000,9230,11230,6079.622246,2180.769649
Cell 1 SW 2013,8000,3768,202284665.5,-1970,9468,11438,5678.576699,2251.105683
Cell 10 2011/12,8000,3769,202338350.4,-779,9915,10694,5212.040594,2834.965481
Cell 10 NE 2011/12,8000,3774,202606774.9,-779,9915,10694,5106.876524,2813.209096
Cell 10 NW 2011/12,8000,3773,202553090,-1875,9784,11659,5593.016698,2620.551846
Cell 10 SE 2013,8000,3772,202499405.1,383,9784,9401,5969.903499,2437.655216
Cell 10 SW 2011/12,8000,3770,202392035.3,-779,9915,10694,5422.829708,2794.554934
Cell 10-A 2011/12,8000,3770,202392035.3,-779,9971,10750,4939.483289,2861.915036
Cell 11 NE 2011/12,8000,3773,202553090,-195,9784,9979,5780.088524,2498.934255
Cell 11 NW 2013,8000,3779,202875199.3,-384,9275,9659,6399.168034,1838.973378
Cell 11 SW 2013,8000,3776,202714144.6,851,9386,8535,6250.870498,2088.222969
Cell 12 2013,8000,3772,202499405.1,1326,9773,8447,6001.281813,2147.320278
Cell 13 2013,8000,3780,202928884.2,1422,9554,8132,7120.075132,1260.487763
Cell 14 2013,8000,3776,202714144.6,1984,8842,6858,7835.78178,875.9447276
Cell 15 2013,8000,3770,202392035.3,5348,8938,3590,8077.475597,508.6908673
Cell 15-A 2013,8000,3780,202928884.2,5348,8880,3532,8108.383598,451.8459756
Cell 16 2013,8000,3775,202660459.8,5452,8942,3490,8103.220132,401.6739068
Cell 17 NW 2011/12,8000,3768,202284665.5,-471,9971,10442,6062.899682,2352.557926
Cell 17 NW 2013,8000,3772,202499405.1,-1875,9827,11702,5470.95281,2482.729281
Cell 17 SE 2013,8000,3774,202606774.9,-1875,9784,11659,5591.993906,2620.957706
Cell 17 SW 2013,8000,3770,202392035.3,-1875,9827,11702,5830.854642,2388.910949
Cell 18 2011/12,8000,3772,202499405.1,850,9982,9132,4764.020414,2602.517324
Cell 18 NE 2013,8000,3770,202392035.3,-195,9784,9979,5873.649602,2545.461091
Cell 18 NW 2013,8000,3767,202230980.6,-1875,9827,11702,5096.932307,2705.208033
Cell 18 SE 2013,8000,3773,202553090,-195,9784,9979,5780.088524,2498.934255
Cell 18 SSE 2013,8000,3771,202445720.2,-195,9405,9600,5849.210554,2471.299722
Cell 19 NW 2013,8000,3769,202338350.4,1079,9386,8307,6160.246484,2156.002121
Cell 2 2011/12,8000,3766,202177295.7,-384,9275,9659,6251.744291,1941.83945
Cell 2 NE 2013,8000,3774,202606774.9,-2000,9096,11096,6493.911765,1783.253031
Cell 2 SW 2013,8000,3768,202284665.5,-2000,9230,11230,6078.660032,2181.926312
Cell 20 2013,8000,3777,202767829.5,1090,9773,8683,6231.043156,2035.542168
Cell 21 2013,8000,3777,202767829.5,1506,9211,7705,7055.453799,1247.652525
Cell 22 2013,8000,3777,202767829.5,4359,8938,4579,7853.393699,535.6445459
Cell 23 2013,8000,3773,202553090,4359,8938,4579,7996.96846,559.6995259
Cell 24 2013,8000,3772,202499405.1,5452,8857,3405,8092.29878,386.7230905
Cell 25 NE 2013,8000,3769,202338350.4,-779,9915,10694,5212.040594,2834.965481
Cell 25 SE 2013,8000,3771,202445720.2,-779,9915,10694,5423.392204,2794.397818
Cell 26 NE 2013,8000,3769,202338350.4,-195,9388,9583,5914.003184,2392.466293
Cell 26 NNW 2013,8000,3774,202606774.9,-779,9915,10694,5106.876524,2813.209096
Cell 26 NW 2013,8000,3771,202445720.2,-779,9971,10750,4940.234686,2861.907444
Cell 27 NW 2013,8000,3772,202499405.1,-65,9971,10036,6029.918346,2271.062819
Cell 28 2013,8000,3770,202392035.3,700,9982,9282,4337.861804,2456.988858
Cell 29 2013,8000,3776,202714144.6,1210,9358,8148,6337.305614,1916.420361
Cell 3 NE 2013,8000,3776,202714144.6,-384,8957,9341,7015.409163,1269.009823
Cell 3 NW 2013,8000,3769,202338350.4,-2000,9096,11096,6368.324224,1781.656837
Cell 30 2013,8000,3772,202499405.1,3349,8798,5449,7895.463945,532.2889472
Cell 31 2013,8000,3775,202660459.7,4359,8955,4596,8094.066225,539.3364521
Cell 32 2013,8000,3781,202982569.1,5634,9040,3406,8226.189897,406.9210546
Cell 33 NE 2013,8000,3768,202284665.5,-471,9971,10442,6062.899682,2352.557926
Cell 33 SE 2013,8000,3770,202392035.3,-1894,9942,11836,5408.85809,2702.869408
Cell 33 SW 2013,8000,3775,202660459.7,-1724,9981,11705,5288.378543,2710.08521
Cell 34 N 2013,8000,3775,202660459.7,-782,9942,10724,6060.609801,2292.569051
Cell 34 NW 2013,8000,3770,202392035.3,-1894,9971,11865,6228.728912,2193.213638
Cell 34 SE 2013,8000,3772,202499405.1,-1894,9982,11876,5850.630435,2493.30135
Cell 35 2013,8000,3773,202553090,396,9982,9586,4720.641134,2636.642454
Cell 37 2013,8000,3771,202445720.2,3349,9341,5992,7623.39459,526.1681867
Cell 38 2013,8000,3772,202499405.1,6613,9040,2427,8187.573966,337.370889
Cell 39 2013,8000,3780,202928884.2,6375,9040,2665,8255.27328,346.327723
Cell 4 2013,8000,3773,202553090,1457,9275,7818,7430.057249,832.6953072
Cell 40 NE 2013,8000,3773,202553090,-1894,9828,11722,4896.867745,2720.590474
Cell 41 N 2013,8000,3768,202284665.5,-1894,9795,11689,5879.720807,2430.626568
Cell 41 NW 2013,8000,3769,202338350.4,-1894,9844,11738,5556.713982,2582.116202
Cell 42 NW 2013,8000,3770,202392035.3,-10,9874,9884,5939.405836,2456.331141
Cell 43 2013,8000,3774,202606774.9,1032,9341,8309,5708.077371,2367.485116
Cell 44 2013,8000,3771,202445720.2,1376,9341,7965,7033.632193,1524.541738
Cell 45 2013,8000,3775,202660459.8,5222,8935,3713,7800.04106,472.8967194
Cell 47 2013,8000,3778,202821514.4,422,9694,9272,6670.856538,2016.018979
Cell 48 2013,8000,3773,202553090,784,9694,8910,6261.496687,2254.047887
Cell 49 2013,8000,3775,202660459.8,1249,9383,8134,6591.658808,1945.334632
Cell 5 2011/12 Summer,8000,3770,202392035.3,-1875,9827,11702,5830.391512,2388.694899
Cell 5 2013,8000,3775,202660459.7,4285,8869,4584,7885.075762,627.303533
Cell 50 2013,8000,3774,202606774.9,1387,8800,7413,7019.100689,1681.409641
Cell 51 2013,8000,3777,202767829.5,5785,8935,3150,7989.426264,406.3445561
Cell 52 2013,8000,3778,202821514.4,1274,9383,8109,6858.026469,1907.375703
Cell 53 2013,8000,3778,202821514.4,1387,9157,7770,6997.13208,1742.527097
Cell 54 2013,8000,3771,202445720.2,3061,8961,5900,7885.215327,650.6052342
Cell 55 2013,8000,3781,202982569.1,5785,8961,3176,7938.529754,487.7052355
Cell 56 2013,8000,3772,202499405.1,1581,9931,8350,7099.575822,1341.869648
Cell 57 2013,8000,3770,202392035.3,1694,8887,7193,7149.940053,1010.119291
Cell 58 2013,8000,3779,202875199.3,1694,8961,7267,7797.215401,909.7787879
Cell 59 2013,8000,3777,202767829.5,1505,9931,8426,7009.742123,1396.443409
Cell 6 2011/12,8000,3771,202445720.2,1142,9386,8244,6054.173429,2204.390868
Cell 6 2013,8000,3773,202553090,5526,9007,3481,8090.136231,447.5824361
Cell 6 NE 2011/12,8000,3771,202445720.2,1142,9386,8244,6217.914081,2047.708945
Cell 6 NW 2011/12,8000,3772,202499405.1,383,9784,9401,5970.333245,2437.474398
Cell 6 SW 2011/12,8000,3775,202660459.8,-195,9784,9979,5762.264901,2600.695414
Cell 60 2013,8000,3771,202445720.2,2277,8767,6490,6931.725537,942.7629633
Cell 61 2013,8000,3776,202714144.6,2116,8887,6771,7421.107256,961.3905566
Cell 7 2013,8000,3775,202660459.7,5313,9137,3824,8123.641854,578.3688151
Cell 9 NW 2013,8000,3771,202445720.2,-1842,9827,11669,5123.624503,2470.051603
Cell 9 SE 2013,8000,3770,202392035.3,-1875,9827,11702,4785.181432,2517.356155
Cell 9 SW 2013,8000,3766,202177295.7,-1875,9827,11702,5118.882103,2532.128126
Cell R1,8000,3765,202123610.8,1109,8722,7613,5718.784329,1903.898767
Cell R10,8000,3775,202660459.8,1457,9275,7818,7429.529801,832.9057007
Cell R100,8000,3775,202660459.7,1387,8800,7413,7017.775364,1683.157285
Cell R101,8000,3770,202392035.3,2006,8935,6929,7766.837401,704.6224012
Cell R104,8000,3777,202767829.5,1358,9157,7799,6953.159915,1861.452841
Cell R105,8000,3776,202714144.6,1387,9157,7770,6996.642744,1742.856143
Cell R106,8000,3771,202445720.2,1401,9014,7613,7245.294086,1295.679091
Cell R107,8000,3771,202445720.2,3061,8961,5900,7885.215327,650.6052342
Cell R11,8000,3775,202660459.7,4285,8869,4584,7885.075762,627.303533
Cell R111,8000,3779,202875199.3,1351,9931,8580,6667.953956,2042.89903
Cell R112,8000,3780,202928884.2,1694,9474,7780,7424.055291,782.1890588
Cell R113,8000,3768,202284665.5,1694,8887,7193,7149.845276,1010.30888
Cell R114,8000,3779,202875199.3,1694,8961,7267,7797.215401,909.7787879
Cell R117,8000,3774,202606774.9,1476,9931,8455,6608.943561,1898.4274
Cell R118,8000,3772,202499405.1,1581,9931,8350,7099.679215,1341.913904
Cell R119,8000,3777,202767829.5,1694,8887,7193,7026.397935,1049.022768
Cell R120,8000,3773,202553090,1941,8887,6946,7338.942486,1070.250701
Cell R121,8000,3778,202821514.4,4872,8831,3959,7998.604023,476.3345376
Cell R123,8000,3780,202928884.2,1505,9347,7842,6899.851852,1506.473614
Cell R124,8000,3776,202714144.6,2277,8767,6490,6935.657574,939.4071943
Cell R125,8000,3778,202821514.4,2277,8767,6490,6841.752779,965.4033341
Cell R126,8000,3777,202767829.5,2116,8887,6771,7231.106169,1084.964721
Cell R15,8000,3768,202284665.5,-1970,9468,11438,5678.576699,2251.105683
Cell R16,8000,3767,202230980.6,-1842,9827,11669,5125.409079,2470.938239
Cell R17,8000,3774,202606774.9,383,9386,9003,6064.837573,2345.537769
Cell R18,8000,3762,201962556.2,-384,9275,9659,6408.727804,1830.44249
Cell R19,8000,3772,202499405.1,1326,9768,8442,6525.065748,1736.549399
Cell R20,8000,3780,202928884.2,1422,8848,7426,7223.068783,1190.506549
Cell R21,8000,3781,202982569.1,1422,8838,7416,7371.832055,1327.255787
Cell R22,8000,3777,202767829.5,1984,8842,6858,7834.809637,877.8636399
Cell R24,8000,3773,202553090,-1875,9827,11702,5471.662073,2482.782412
Cell R25,8000,3768,202284665.5,-1875,9827,11702,5097.667197,2705.225081
Cell R26,8000,3776,202714144.6,383,9784,9401,5967.414989,2439.166684
Cell R27,8000,3769,202338350.4,1079,9386,8307,6160.246484,2156.002121
Cell R28,8000,3777,202767829.5,1090,9773,8683,5698.684406,2286.078961
Cell R29,8000,3780,202928884.2,1090,9773,8683,6231.594444,2034.895419
Cell R30,8000,3777,202767829.5,1423,8838,7415,7410.209161,1044.836358
Cell R31,8000,3772,202499405.1,2057,8938,6881,7767.002121,702.7834363
Cell R35,8000,3771,202445720.2,-1875,9827,11702,5830.918589,2388.597408
Cell R36,8000,3774,202606774.9,-1875,9784,11659,5591.993906,2620.957706
Cell R37,8000,3773,202553090,-195,9784,9979,5780.088524,2498.934255
Cell R38,8000,3770,202392035.3,700,9231,8531,5487.125464,2425.04481
Cell R39,8000,3770,202392035.3,1128,9773,8645,6348.461273,1996.386629
Cell R40,8000,3777,202767829.5,1506,9211,7705,7055.453799,1247.652525
Cell R46,8000,3772,202499405.1,-779,9961,10740,5444.182131,2814.156653
Cell R47,8000,3770,202392035.3,-779,9971,10750,4939.483289,2861.915036
Cell R48,8000,3769,202338350.4,-195,9388,9583,5914.027594,2392.485484
Cell R49,8000,3771,202445720.2,-65,9971,10036,6029.482631,2271.206278
Cell R5,8000,3770,202392035.3,-1970,9374,11344,5830.916976,2047.579632
Cell R50,8000,3769,202338350.4,700,9982,9282,4336.906607,2456.614782
Cell R51,8000,3772,202499405.1,1210,9358,8148,6350.494433,1907.185867
Cell R52,8000,3773,202553090,2443,8808,6365,7362.743705,740.3463092
Cell R53,8000,3777,202767829.5,2443,8651,6208,7458.450093,684.2891371
Cell R54,8000,3775,202660459.7,4359,8955,4596,8094.066225,539.3364521
Cell R58,8000,3770,202392035.3,-779,9976,10755,5286.963395,2781.850553
Cell R59,8000,3768,202284665.5,-471,9971,10442,6062.899682,2352.557926
Cell R6,8000,3767,202230980.6,-2000,9230,11230,6078.759225,2182.207409
Cell R60,8000,3771,202445720.2,-1894,9971,11865,6229.537788,2193.485155
Cell R61,8000,3773,202553090,396,9982,9586,4720.641134,2636.642454
Cell R62,8000,3774,202606774.9,716,9829,9113,4843.255167,2526.351349
Cell R63,8000,3776,202714144.6,716,9358,8642,5996.49285,2111.286298
Cell R64,8000,3779,202875199.3,3349,9288,5939,7649.076475,573.7213349
Cell R65,8000,3772,202499405.1,3349,8798,5449,7895.463945,532.2889472
Cell R66,8000,3775,202660459.7,5718,8955,3237,8238.817483,334.3570552
Cell R69,8000,3775,202660459.7,-1724,9981,11705,5288.378543,2710.08521
Cell R7,8000,3767,202230980.6,-2000,9096,11096,6367.42713,1781.689494
Cell R70,8000,3769,202338350.4,-1894,9942,11836,5408.324489,2703.029397
Cell R71,8000,3773,202553090,-1894,9982,11876,5848.193215,2494.002705
Cell R72,8000,3778,202821514.4,-10,9982,9992,5568.567761,2611.953701
Cell R73,8000,3771,202445720.2,-10,9982,9992,4672.0358,2702.590841
Cell R74,8000,3770,202392035.3,716,9341,8625,6061.014589,2317.465795
Cell R75,8000,3771,202445720.2,3349,9341,5992,7623.39459,526.1681867
Cell R76,8000,3777,202767829.5,6008,8802,2794,8073.145353,353.110915
Cell R77,8000,3773,202553090,6613,9040,2427,8187.619401,337.337719
Cell R8,8000,3778,202821514.4,-384,8957,9341,6965.053467,1314.895496
Cell R80,8000,3774,202606774.9,-1894,9828,11722,4897.54849,2720.551373
Cell R81,8000,3769,202338350.4,-1894,9977,11871,5842.605466,2497.154896
Cell R82,8000,3769,202338350.4,-10,9874,9884,5938.915627,2456.472587
Cell R83,8000,3776,202714144.6,-10,9874,9884,6073.475636,2383.751739
Cell R84,8000,3771,202445720.2,834,9341,8507,5355.368868,2461.518085
Cell R85,8000,3775,202660459.7,1032,9341,8309,5705.926623,2368.296045
Cell R86,8000,3772,202499405.1,1535,9284,7749,7421.401909,1063.107355
Cell R87,8000,3775,202660459.8,5222,8935,3713,7800.04106,472.8967194
Cell R9,8000,3772,202499405.1,-384,9189,9573,7114.005567,1234.662335
Cell R90,8000,3778,202821514.4,422,9694,9272,6670.856538,2016.018979
Cell R91,8000,3772,202499405.1,784,9694,8910,6262.092789,2254.049278
Cell R92,8000,3777,202767829.5,1032,9683,8651,5369.333598,2415.472349
Cell R93,8000,3775,202660459.8,1249,9383,8134,6591.658808,1945.334632
Cell R97,8000,3772,202499405.1,784,9694,8910,6973.382291,1820.774433
Cell R98,8000,3777,202767829.5,1032,9683,8651,6632.793222,2155.623104
Cell R99,8000,3779,202875199.3,1274,9383,8109,6858.374173,1907.243067
Cell S102,8000,3778,202821514.4,5785,8935,3150,8002.136316,411.0035365
Cell S108,8000,3781,202982569.1,5785,8961,3176,7938.744777,487.8189103
Cell S13,8000,3781,202982569.1,5628,9125,3497,8176.809045,453.2218018
Cell S14,8000,3776,202714144.6,5313,9137,3824,8123.951006,578.4024824
Cell S2,8000,3773,202553090,5526,9007,3481,8090.136231,447.5824361
Cell S23,8000,3778,202821514.4,5348,9125,3777,8125.892006,498.2855036
Cell S32,8000,3780,202928884.2,5348,8938,3590,7952.36455,451.595947
Cell S33,8000,3780,202928884.2,5348,8880,3532,8108.383598,451.8459756
Cell S34,8000,3772,202499405.1,5452,8857,3405,8092.29878,386.7230905
Cell S41,8000,3779,202875199.3,3863,8808,4945,7668.973803,482.9655689
Cell S42,8000,3773,202553090,4359,8938,4579,7996.96846,559.6995259
Cell S44,8000,3777,202767829.5,5878,8939,3061,8130.449828,384.053332
Cell S56,8000,3773,202553090,5634,8955,3321,8050.379539,460.5646446
Cell S67,8000,3781,202982569.1,5634,9040,3406,8226.189897,406.9210546
Cell S78,8000,3781,202982569.1,6375,9040,2665,8255.210526,346.3034148
Cell S88,8000,3778,202821514.4,6077,8986,2909,8069.909476,418.3831931
Cell S94,8000,3780,202928884.2,5222,8935,3713,7971.062963,407.9626024
Cell S95,8000,3777,202767829.5,5785,8935,3150,7989.40879,406.3488313
W287,8000,3774,202606774.9,-1891,9740,11631,4280.875199,2111.714953
W295,8000,3770,202392035.3,1344,8991,7647,6879.616711,1776.056458
W338,8000,3770,202392035.3,692,9923,9231,3723.073475,2358.062498
W342,8000,3769,202338350.4,1013,8605,7592,5341.535951,2292.326008
W345,8000,3773,202553090,1565,8605,7040,7221.369732,1111.714905
W387,8000,3765,202123610.8,-54,9937,9991,5195.179017,2474.062338
W393,8000,3767,202230980.6,853,9522,8669,5488.832227,2430.862208
W440,8000,3767,202230980.6,1125,9937,8812,5799.61614,2327.782857
W441,8000,3773,202553090,1125,8634,7509,6403.959184,1740.397302
W445,8000,3770,202392035.3,1848,8692,6844,6800.927851,1039.305068
W500,8000,3769,202338350.4,1427,8823,7396,6413.041921,1649.579782
1,8250,4006,215061669.3,-2000,9230,11230,6048.454568,2188.084794
2,8250,4010,215276408.9,-384,9275,9659,6270.286035,1947.266738
3,8250,4008,215169039.1,382,9768,9386,6847.705339,1507.723681
4,8250,4009,215222724,1422,8848,7426,7189.896233,1156.713664
5,8250,4012,215383778.7,-1875,9827,11702,5782.55683,2403.557275
6,8250,4011,215330093.8,1142,9386,8244,6020.33458,2214.145002
7,8250,4007,215115354.2,1326,9773,8447,5993.833791,2138.106868
8,8250,4011,215330093.8,1422,9441,8019,7161.230865,1238.733611
9,8250,4017,215652203.1,4425,8938,4513,7881.204879,494.604375
10,8250,4009,215222724,-779,9915,10694,5201.900973,2839.435204
11,8250,4022,215920627.6,-195,9388,9583,5951.2546,2385.672578
12,8250,4021,215866942.7,700,9982,9282,4354.481472,2456.952506
13,8250,4014,215491148.5,1189,9358,8169,6303.944943,1951.897616
14,8250,4014,215491148.5,4359,8955,4596,8009.274788,548.0270611
16,8250,4019,215759572.9,-1724,9981,11705,5246.454093,2696.236385
17,8250,4007,215115354.2,-1894,9971,11865,6223.367607,2196.872593
18,8250,4010,215276408.9,850,9982,9132,4796.100748,2606.151282
19,8250,4012,215383778.7,716,9829,9113,4897.020937,2517.606501
20,8250,4012,215383778.7,3349,9341,5992,7613.758225,545.6843914
21,8250,4015,215544833.3,6259,9040,2781,8177.94122,347.0522953
22,8250,4012,215383778.7,-1894,9795,11689,4856.419242,2735.964803
23,8250,4007,215115354.2,-10,9874,9884,6002.217619,2432.076098
24,8250,4014,215491148.5,784,9694,8910,6226.061784,2269.021716
25,8250,4010,215276408.9,1249,9683,8434,6587.924439,1947.952664
26,8250,4014,215491148.5,5222,8935,3713,7807.81141,474.2722498
27,8250,4014,215491148.5,1032,9683,8651,6572.89711,2193.591465
28,8250,4016,215598518.2,1387,9157,7770,6965.099104,1776.33324
29,8250,4017,215652203.1,1387,9040,7653,7016.547423,1689.597833
31,8250,4014,215491148.5,1475,9931,8456,7082.470105,1585.303963
32,8250,4009,215222724,1694,8887,7193,7157.584934,1002.431969
33,8250,4017,215652203.1,1522,9931,8409,7062.988549,1391.028797
34,8250,4014,215491148.5,2277,8887,6610,6954.144993,952.7640779
10A,8250,4016,215598518.2,-779,9971,10750,4978.877241,2850.027741
10NE,8250,4010,215276408.9,-779,9915,10694,5141.437157,2811.149968
10NW,8250,4009,215222724,-1875,9784,11659,5618.237965,2602.767785
10SW,8250,4018,215705888,-779,9951,10730,5401.996516,2807.479592
11NE,8250,4012,215383778.7,-195,9784,9979,5757.074776,2491.738988
11NW,8250,4008,215169039.1,-195,9784,9979,5846.867265,2491.312122
11SE,8250,4010,215276408.9,-195,9971,10166,6035.122444,2284.814154
17NW,8250,4009,215222724,-471,9971,10442,6006.647792,2373.374369
17SE,8250,4011,215330093.8,-1894,9982,11876,5883.83994,2487.109232
17SW,8250,4023,215974312.5,-1894,9942,11836,5407.055431,2696.599245
22S,8250,4011,215330093.8,-1894,9828,11722,4729.470706,2727.258667
23S,8250,4022,215920627.6,981,9773,8792,4760.695425,2390.703025
24S,8250,4012,215383778.7,651,9694,9043,6217.669741,2268.935075
27A,8250,4009,215222724,784,9694,8910,6829.829134,1932.271669
2A,8250,4008,215169039.1,-384,9275,9659,6505.296657,1774.02466
5NE,8250,4010,215276408.9,-1875,9827,11702,4839.492519,2515.058044
5NW,8250,4008,215169039.1,-1875,9827,11702,5130.823104,2536.615893
5SE,8250,4014,215491148.5,-1875,9827,11702,5175.677877,2710.26322
6NE,8250,4013,215437463.6,1142,9386,8244,6131.815599,2094.831003
6NW,8250,4009,215222724,383,9784,9401,5971.539287,2430.297656
6SW,8250,4013,215437463.6,-195,9784,9979,5712.725642,2610.359876
Cell 1 2011/12,8250,4006,215061669.3,-2000,9230,11230,6048.454568,2188.084794
Cell 1 SW 2013,8250,4011,215330093.8,-1970,9468,11438,5699.267514,2240.389376
Cell 10 2011/12,8250,4009,215222724,-779,9915,10694,5201.900973,2839.435204
Cell 10 NE 2011/12,8250,4010,215276408.9,-779,9915,10694,5141.437157,2811.149968
Cell 10 NW 2011/12,8250,4009,215222724,-1875,9784,11659,5618.237965,2602.767785
Cell 10 SE 2013,8250,4008,215169039.1,383,9784,9401,5972.458583,2429.903765
Cell 10 SW 2011/12,8250,4018,215705888,-779,9951,10730,5401.996516,2807.479592
Cell 10-A 2011/12,8250,4016,215598518.2,-779,9971,10750,4978.877241,2850.027741
Cell 11 NE 2011/12,8250,4012,215383778.7,-195,9784,9979,5757.074776,2491.738988
Cell 11 NW 2013,8250,4009,215222724,-384,9275,9659,6412.943128,1849.258753
Cell 11 SW 2013,8250,4009,215222724,851,9386,8535,6188.282614,2117.072645
Cell 12 2013,8250,4010,215276408.9,1326,9773,8447,5992.797756,2137.931914
Cell 13 2013,8250,4014,215491148.5,1422,9715,8293,7145.896612,1240.082901
Cell 14 2013,8250,4011,215330093.8,1848,8842,6994,7813.985041,924.5825902
Cell 15 2013,8250,4008,215169039.1,5348,8938,3590,8083.575349,507.1832102
Cell 15-A 2013,8250,4016,215598518.2,5348,8880,3532,8110.639193,457.885147
Cell 16 2013,8250,4014,215491148.5,5452,8942,3490,8103.902342,401.9075591
Cell 17 NW 2011/12,8250,4009,215222724,-471,9971,10442,6006.647792,2373.374369
Cell 17 NW 2013,8250,4014,215491148.5,-1875,9827,11702,5454.387145,2485.831205
Cell 17 SE 2013,8250,4008,215169039.1,-1875,9784,11659,5617.728543,2602.892618
Cell 17 SW 2013,8250,4013,215437463.6,-1875,9827,11702,5780.336656,2405.072818
Cell 18 2011/12,8250,4010,215276408.9,850,9982,9132,4796.100748,2606.151282
Cell 18 NE 2013,8250,4010,215276408.9,-195,9784,9979,5804.499252,2567.334028
Cell 18 NW 2013,8250,4010,215276408.9,-1875,9827,11702,5159.222195,2703.634553
Cell 18 SE 2013,8250,4013,215437463.6,-195,9784,9979,5756.580613,2491.62512
Cell 18 SSE 2013,8250,4006,215061669.3,-195,9784,9979,5895.222416,2460.368896
Cell 19 NW 2013,8250,4010,215276408.9,851,9386,8535,6139.728429,2171.937737
Cell 2 2011/12,8250,4010,215276408.9,-384,9275,9659,6270.286035,1947.266738
Cell 2 NE 2013,8250,4011,215330093.8,-2000,9096,11096,6507.76739,1779.983773
Cell 2 SW 2013,8250,4005,215007984.5,-2000,9230,11230,6047.057678,2188.768695
Cell 20 2013,8250,4011,215330093.8,1090,9773,8683,6177.958364,2061.728058
Cell 21 2013,8250,4010,215276408.9,1466,9211,7745,7018.134165,1304.898668
Cell 22 2013,8250,4015,215544833.3,4359,8938,4579,7855.590535,532.263284
Cell 23 2013,8250,4010,215276408.9,4359,8938,4579,7987.968828,554.3286738
Cell 24 2013,8250,4015,215544833.3,5452,8933,3481,8095.878705,385.0519442
Cell 25 NE 2013,8250,4011,215330093.8,-779,9915,10694,5203.609574,2839.800677
Cell 25 SE 2013,8250,4018,215705888,-779,9951,10730,5401.996516,2807.479592
Cell 26 NE 2013,8250,4023,215974312.5,-195,9388,9583,5950.180711,2386.348098
Cell 26 NNW 2013,8250,4011,215330093.8,-779,9915,10694,5141.995263,2811.021694
Cell 26 NW 2013,8250,4017,215652203.1,-779,9971,10750,4978.016181,2850.195364
Cell 27 NW 2013,8250,4011,215330093.8,-195,9971,10166,6035.57467,2284.708796
Cell 28 2013,8250,4023,215974312.5,700,9982,9282,4354.295799,2456.662523
Cell 29 2013,8250,4009,215222724,1189,9358,8169,6304.02669,1951.1812
Cell 3 NE 2013,8250,4006,215061669.3,-384,8957,9341,6998.155766,1297.425531
Cell 3 NW 2013,8250,4008,215169039.1,-2000,9096,11096,6371.390968,1783.797262
Cell 30 2013,8250,4011,215330093.8,3349,8798,5449,7894.44378,528.7150264
Cell 31 2013,8250,4022,215920627.6,4359,8955,4596,8090.148185,533.7209995
Cell 32 2013,8250,4017,215652203.1,5634,9040,3406,8222.12945,407.1465851
Cell 33 NE 2013,8250,4009,215222724,-471,9971,10442,6005.555001,2374.357477
Cell 33 SE 2013,8250,4024,216027997.4,-1894,9942,11836,5406.9334,2696.583699
Cell 33 SW 2013,8250,4008,215169039.1,-1724,9981,11705,5262.743762,2704.213323
Cell 34 N 2013,8250,4009,215222724,-782,9982,10764,6031.251185,2313.203312
Cell 34 NW 2013,8250,4007,215115354.2,-1894,9971,11865,6223.367607,2196.872593
Cell 34 SE 2013,8250,4010,215276408.9,-1894,9982,11876,5880.492768,2488.779329
Cell 35 2013,8250,4005,215007984.4,355,9982,9627,4748.588764,2628.846243
Cell 37 2013,8250,4013,215437463.6,3349,9341,5992,7618.552205,544.4219865
Cell 38 2013,8250,4020,215813257.8,6259,9040,2781,8184.221144,343.6020616
Cell 39 2013,8250,4011,215330093.8,6375,9040,2665,8250.703067,346.5867997
Cell 4 2013,8250,4012,215383778.7,1373,9275,7902,7399.757228,914.1712963
Cell 40 NE 2013,8250,4007,215115354.2,-1894,9828,11722,4926.281507,2714.178972
Cell 41 N 2013,8250,4020,215813257.8,-1894,9795,11689,5835.946766,2441.128422
Cell 41 NW 2013,8250,4006,215061669.3,-1894,9844,11738,5524.419121,2608.111337
Cell 42 NW 2013,8250,4017,215652203.1,-10,9874,9884,5994.30346,2432.36816
Cell 43 2013,8250,4023,215974312.5,1032,9683,8651,5702.179717,2383.55109
Cell 44 2013,8250,4021,215866942.7,1376,9341,7965,6986.451132,1578.324524
Cell 45 2013,8250,4013,215437463.6,5222,8935,3713,7808.240219,474.2531008
Cell 47 2013,8250,4010,215276408.9,422,9694,9272,6655.713217,2024.871618
Cell 48 2013,8250,4011,215330093.8,651,9694,9043,6216.930441,2269.251428
Cell 49 2013,8250,4010,215276408.9,1249,9683,8434,6587.924439,1947.952664
Cell 5 2011/12 Summer,8250,4013,215437463.6,-1875,9827,11702,5780.336656,2405.072818
Cell 5 2013,8250,4012,215383778.7,4285,8869,4584,7887.31007,626.4774438
Cell 50 2013,8250,4017,215652203.1,1387,9040,7653,7016.547423,1689.597833
Cell 51 2013,8250,4028,216242736.9,5785,8935,3150,7991.289225,403.5155959
Cell 52 2013,8250,4012,215383778.7,1274,9383,8109,6806.229312,1947.233063
Cell 53 2013,8250,4016,215598518.2,1387,9157,7770,6965.099104,1776.33324
Cell 54 2013,8250,4011,215330093.8,2636,8961,6325,7874.422837,669.7725035
Cell 55 2013,8250,4015,215544833.3,5785,8961,3176,7929.81594,487.4075607
Cell 56 2013,8250,4023,215974312.5,1522,9931,8409,7058.03132,1396.206921
Cell 57 2013,8250,4013,215437463.6,1694,8887,7193,7156.106653,1004.003202
Cell 58 2013,8250,4018,215705888,1694,8961,7267,7770.659034,942.6898818
Cell 59 2013,8250,4009,215222724,1505,9931,8426,6979.95535,1441.443483
Cell 6 2011/12,8250,4011,215330093.8,1142,9386,8244,6020.33458,2214.145002
Cell 6 2013,8250,4013,215437463.6,5334,9007,3673,8085.503862,453.5660198
Cell 6 NE 2011/12,8250,4013,215437463.6,1142,9386,8244,6131.815599,2094.831003
Cell 6 NW 2011/12,8250,4009,215222724,383,9784,9401,5971.539287,2430.297656
Cell 6 SW 2011/12,8250,4013,215437463.6,-195,9784,9979,5712.725642,2610.359876
Cell 60 2013,8250,4022,215920627.6,2277,8767,6490,6949.269518,935.6483596
Cell 61 2013,8250,4017,215652203.1,2116,8887,6771,7408.960667,983.0815894
Cell 7 2013,8250,4027,216189052,5313,9137,3824,8123.532903,578.9468767
Cell 9 NW 2013,8250,4011,215330093.8,-1842,9827,11669,5161.797806,2476.665499
Cell 9 SE 2013,8250,4010,215276408.9,-1875,9827,11702,4839.492519,2515.058044
Cell 9 SW 2013,8250,4009,215222724,-1875,9827,11702,5130.900723,2536.304268
Cell R1,8250,4003,214900614.7,974,8951,7977,5715.561329,1905.018065
Cell R10,8250,4012,215383778.7,1373,9275,7902,7399.757228,914.1712963
Cell R100,8250,4015,215544833.4,1387,9040,7653,7016.144209,1689.921765
Cell R101,8250,4012,215383778.7,1810,8935,7125,7737.33998,769.6785827
Cell R104,8250,4016,215598518.2,1282,9157,7875,6967.24751,1836.219088
Cell R105,8250,4016,215598518.2,1387,9157,7770,6965.099104,1776.33324
Cell R106,8250,4010,215276408.9,1401,9014,7613,7256.926683,1277.929849
Cell R107,8250,4010,215276408.9,2636,8961,6325,7874.375561,669.8493195
Cell R11,8250,4014,215491148.5,4285,8869,4584,7887.420279,626.5582786
Cell R111,8250,4014,215491148.5,1351,9931,8580,6670.96014,2032.521813
Cell R112,8250,4013,215437463.6,1694,9474,7780,7416.243957,792.3499269
Cell R113,8250,4012,215383778.7,1694,8887,7193,7156.111914,1004.128263
Cell R114,8250,4017,215652203.1,1694,8961,7267,7770.629574,942.8053627
Cell R117,8250,4013,215437463.6,1437,9931,8494,6606.568901,1903.416992
Cell R118,8250,4024,216027997.4,1522,9931,8409,7057.877237,1396.067634
Cell R119,8250,4015,215544833.3,1694,8887,7193,7046.716812,1036.542885
Cell R120,8250,4010,215276408.9,1941,8887,6946,7335.894015,1087.885702
Cell R121,8250,4016,215598518.2,3613,8831,5218,7986.88247,496.5875129
Cell R123,8250,4016,215598518.2,1505,9347,7842,6884.826942,1519.015497
Cell R124,8250,4012,215383778.7,2277,8767,6490,6948.471336,930.0502757
Cell R125,8250,4026,216135367.1,2277,8767,6490,6848.595877,953.1703378
Cell R126,8250,4017,215652203.1,2116,8887,6771,7229.630072,1094.40008
Cell R15,8250,4012,215383778.7,-1970,9468,11438,5699.723081,2240.295945
Cell R16,8250,4011,215330093.8,-1842,9827,11669,5159.229619,2477.414824
Cell R17,8250,4009,215222724,383,9386,9003,6052.581442,2337.040082
Cell R18,8250,4020,215813257.8,-384,9275,9659,6420.991045,1841.90576
Cell R19,8250,4011,215330093.8,1326,9768,8442,6503.356769,1745.677096
Cell R20,8250,4009,215222724,1422,8848,7426,7240.700175,1181.081668
Cell R21,8250,4010,215276408.9,1422,8838,7416,7386.613217,1315.823736
Cell R22,8250,4009,215222724,1848,8842,6994,7813.75979,924.7102501
Cell R24,8250,4013,215437463.6,-1875,9827,11702,5453.847496,2485.905801
Cell R25,8250,4011,215330093.8,-1875,9827,11702,5159.914734,2703.653203
Cell R26,8250,4010,215276408.9,383,9784,9401,5972.314963,2429.724398
Cell R27,8250,4008,215169039.1,851,9386,8535,6141.021208,2171.253204
Cell R28,8250,4015,215544833.3,1090,9773,8683,5676.382565,2289.067878
Cell R29,8250,4010,215276408.9,1090,9773,8683,6178.858853,2061.196298
Cell R30,8250,4014,215491148.5,1423,8838,7415,7413.839063,1054.54803
Cell R31,8250,4017,215652203.1,2057,8938,6881,7749.54344,736.6007317
Cell R35,8250,4013,215437463.6,-1875,9827,11702,5780.336656,2405.072818
Cell R36,8250,4009,215222724,-1875,9784,11659,5618.237965,2602.767785
Cell R37,8250,4013,215437463.6,-195,9784,9979,5756.580613,2491.62512
Cell R38,8250,4023,215974312.5,700,9382,8682,5476.691275,2436.608842
Cell R39,8250,4008,215169039.1,1128,9773,8645,6322.795409,2014.697011
Cell R40,8250,4010,215276408.9,1466,9211,7745,7018.134165,1304.898668
Cell R46,8250,4011,215330093.8,-779,9961,10740,5461.953628,2802.211721
Cell R47,8250,4016,215598518.2,-779,9971,10750,4978.877241,2850.027741
Cell R48,8250,4024,216027997.4,-195,9388,9583,5950.66501,2386.249285
Cell R49,8250,4011,215330093.8,-195,9971,10166,6035.57467,2284.708796
Cell R5,8250,4007,215115354.2,-1970,9374,11344,5819.707512,2054.039942
Cell R50,8250,4022,215920627.6,700,9982,9282,4353.955743,2456.873234
Cell R51,8250,4012,215383778.7,1202,9358,8156,6314.658275,1945.309413
Cell R52,8250,4015,215544833.4,2443,8808,6365,7370.640598,732.0572575
Cell R53,8250,4014,215491148.5,2443,8680,6237,7463.587444,685.8058046
Cell R54,8250,4021,215866942.7,4359,8955,4596,8090.032828,533.7372255
Cell R58,8250,4009,215222724,-779,9976,10755,5287.221502,2786.387837
Cell R59,8250,4010,215276408.9,-471,9971,10442,6005.568828,2374.061566
Cell R6,8250,4008,215169039.1,-2000,9230,11230,6045.807884,2189.470637
Cell R60,8250,4008,215169039.1,-1894,9971,11865,6222.278942,2197.679252
Cell R61,8250,4005,215007984.4,355,9982,9627,4748.588764,2628.846243
Cell R62,8250,4012,215383778.7,716,9829,9113,4890.999003,2531.442933
Cell R63,8250,4011,215330093.8,716,9358,8642,5978.752431,2124.807918
Cell R64,8250,4013,215437463.6,3349,9288,5939,7656.715176,573.6941586
Cell R65,8250,4011,215330093.8,3349,8798,5449,7894.44378,528.7150264
Cell R66,8250,4022,215920627.6,5718,8955,3237,8226.293386,341.2862279
Cell R69,8250,4009,215222724,-1724,9981,11705,5261.805188,2704.528858
Cell R7,8250,4007,215115354.2,-2000,9096,11096,6370.860245,1783.703406
Cell R70,8250,4023,215974312.5,-1894,9942,11836,5406.391002,2696.699335
Cell R71,8250,4009,215222724,-1894,9982,11876,5880.222749,2489.030977
Cell R72,8250,4008,215169039.1,-10,9982,9992,5568.213074,2607.167679
Cell R73,8250,4016,215598518.2,-10,9982,9992,4664.677291,2689.447265
Cell R74,8250,4010,215276408.9,716,9341,8625,6065.155611,2311.133091
Cell R75,8250,4012,215383778.7,3349,9341,5992,7618.457129,544.4565187
Cell R76,8250,4021,215866942.7,6008,8802,2794,8071.594877,357.7894506
Cell R77,8250,4021,215866942.7,6259,9040,2781,8184.360856,343.6735116
Cell R8,8250,4013,215437463.6,-384,8957,9341,6943.744829,1343.849704
Cell R80,8250,4007,215115354.2,-1894,9828,11722,4926.281507,2714.178972
Cell R81,8250,4010,215276408.9,-1894,9977,11871,5780.853117,2531.323033
Cell R82,8250,4018,215705888,-10,9874,9884,5994.832504,2432.296588
Cell R83,8250,4009,215222724,-10,9874,9884,6100.388875,2366.546836
Cell R84,8250,4008,215169039.1,834,9683,8849,5388.966567,2463.394115
Cell R85,8250,4025,216081682.3,1032,9683,8651,5700.618634,2383.443527
Cell R86,8250,4013,215437463.6,1535,9284,7749,7412.838774,1099.190741
Cell R87,8250,4013,215437463.6,5222,8935,3713,7808.283828,474.2385021
Cell R9,8250,4005,215007984.4,-384,9275,9659,7108.612984,1248.615303
Cell R90,8250,4011,215330093.8,422,9694,9272,6655.983545,2024.691555
Cell R91,8250,4011,215330093.8,651,9694,9043,6216.930441,2269.251428
Cell R92,8250,4012,215383778.7,1032,9683,8651,5446.442672,2394.784231
Cell R93,8250,4009,215222724,1249,9683,8434,6587.666251,1948.126991
Cell R97,8250,4018,215705888,784,9694,8910,6967.276257,1831.987099
Cell R98,8250,4014,215491148.5,1032,9683,8651,6572.89711,2193.591465
Cell R99,8250,4012,215383778.7,1274,9383,8109,6806.139581,1947.170999
Cell S102,8250,4014,215491148.5,5785,8935,3150,8001.700548,410.5672598
Cell S108,8250,4013,215437463.6,5785,8961,3176,7929.884376,487.5140943
Cell S13,8250,4009,215222724,5628,9125,3497,8181.593165,450.3999031
Cell S14,8250,4028,216242736.9,5313,9137,3824,8123.563307,578.8782223
Cell S2,8250,4013,215437463.6,5334,9007,3673,8085.503862,453.5660198
Cell S23,8250,4015,215544833.4,5348,9125,3777,8121.11731,497.8698665
Cell S32,8250,4010,215276408.9,5348,8938,3590,7953.308229,447.7192407
Cell S33,8250,4016,215598518.2,5348,8880,3532,8110.639193,457.885147
Cell S34,8250,4014,215491148.5,5452,8933,3481,8095.991779,385.033248
Cell S41,8250,4010,215276408.9,2761,8808,6047,7653.9601,523.0064102
Cell S42,8250,4011,215330093.8,4359,8938,4579,7987.826976,554.3323538
Cell S44,8250,4018,215705888,5823,8939,3116,8122.844201,394.8195108
Cell S56,8250,4018,215705888,5634,8955,3321,8056.318318,459.222286
Cell S67,8250,4017,215652203.1,5634,9040,3406,8222.12945,407.1465851
Cell S78,8250,4010,215276408.9,6375,9040,2665,8250.643142,346.6092356
Cell S88,8250,4016,215598518.2,5766,8986,3220,8071.188496,423.077362
Cell S94,8250,4018,215705888,5222,8935,3713,7957.612743,421.0448644
Cell S95,8250,4025,216081682.3,5785,8935,3150,7991.709068,403.3081895
W287,8250,4010,215276408.9,-1891,9740,11631,4336.315711,2125.464414
W295,8250,4010,215276408.9,1344,8991,7647,6850.12818,1814.089503
W338,8250,4006,215061669.3,692,9923,9231,3743.771593,2357.256166
W342,8250,4005,215007984.4,817,8605,7788,5357.10412,2297.019766
W345,8250,4012,215383778.7,1565,8605,7040,7186.804088,1167.959554
W387,8250,4003,214900614.7,-54,9937,9991,5167.288284,2471.773973
W393,8250,4010,215276408.9,853,9850,8997,5446.865337,2443.030243
W440,8250,4012,215383778.7,1125,9937,8812,5784.909023,2330.760262
W441,8250,4009,215222724,1125,8637,7512,6351.256423,1776.599162
W445,8250,4008,215169039.1,1848,8692,6844,6809.162924,1025.385583
W500,8250,4005,215007984.5,1427,8823,7396,6439.382022,1630.602533
1,8500,4256,228482891.8,-2000,9230,11230,6006.756814,2197.984963
2,8500,4252,228268152.3,-384,9275,9659,6283.468015,1952.393344
3,8500,4261,228751316.3,382,9768,9386,6843.274818,1505.999812
4,8500,4266,229019740.7,1422,8848,7426,7202.342944,1154.046459
5,8500,4259,228643946.5,-1875,9827,11702,5734.149096,2425.531779
6,8500,4254,228375522.1,1142,9386,8244,5992.863423,2219.688637
7,8500,4256,228482891.8,1090,9773,8683,5997.479323,2119.467303
8,8500,4263,228858686.1,1422,9715,8293,7185.512315,1217.948809
9,8500,4266,229019740.7,4359,8938,4579,7877.256915,505.5555583
10,8500,4254,228375522.1,-779,9915,10694,5212.053126,2838.046439
11,8500,4261,228751316.3,-195,9971,10166,5978.257686,2380.313639
12,8500,4266,229019740.7,700,9982,9282,4367.802625,2452.506942
13,8500,4263,228858686.1,1189,9358,8169,6260.96411,1993.440563
14,8500,4263,228858686.1,3421,8955,5534,8007.979123,548.1274611
16,8500,4261,228751316.3,-1724,9981,11705,5215.565595,2698.996924
17,8500,4261,228751316.3,-1894,9971,11865,6213.573574,2217.605768
18,8500,4250,228160782.5,700,9982,9282,4816.848,2603.63682
19,8500,4260,228697631.4,716,9829,9113,4945.051408,2516.881926
20,8500,4272,229341850.1,1739,9341,7602,7603.979167,587.4360482
21,8500,4258,228590261.6,6199,9040,2841,8174.011743,353.3994647
22,8500,4254,228375522.1,-1894,9828,11722,4890.634697,2750.41136
23,8500,4255,228429206.9,-10,9874,9884,6043.251469,2410.300417
24,8500,4264,228912371,651,9694,9043,6178.108349,2283.526421
25,8500,4258,228590261.6,1249,9683,8434,6588.587835,1953.070128
26,8500,4261,228751316.3,2626,9040,6414,7809.643511,493.5359617
27,8500,4262,228805001.2,1032,9683,8651,6521.970671,2224.379624
28,8500,4260,228697631.4,1387,9157,7770,6934.700469,1810.074158
29,8500,4268,229127110.5,1369,9040,7671,7014.193533,1700.298826
31,8500,4257,228536576.7,1475,9931,8456,7057.664083,1610.379717
32,8500,4261,228751316.3,1694,8887,7193,7168.535086,995.2099169
33,8500,4263,228858686.1,1505,9931,8426,7031.100164,1432.720799
34,8500,4256,228482891.8,1941,8887,6946,6958.805921,974.838726
10A,8500,4261,228751316.3,-779,9971,10750,5032.44168,2845.594485
10NE,8500,4264,228912371,-779,9915,10694,5175.865619,2812.282629
10NW,8500,4257,228536576.7,-1875,9784,11659,5640.318064,2590.049809
10SW,8500,4258,228590261.6,-779,9951,10730,5375.533819,2816.279684
11NE,8500,4249,228107097.6,-195,9784,9979,5723.893387,2490.717297
11NW,8500,4263,228858686.1,-195,9784,9979,5882.103683,2479.566213
11SE,8500,4255,228429206.9,-195,9971,10166,6044.776968,2294.042428
17NW,8500,4255,228429206.9,-471,9971,10442,5958.515159,2389.214753
17SE,8500,4255,228429206.9,-1894,9982,11876,5889.142891,2488.718845
17SW,8500,4261,228751316.3,-1894,9942,11836,5399.016193,2690.53722
22S,8500,4259,228643946.5,-1894,9828,11722,4770.049307,2743.596457
23S,8500,4266,229019740.7,981,9773,8792,4833.358884,2390.466957
24S,8500,4259,228643946.5,651,9694,9043,6172.068561,2285.80443
27A,8500,4263,228858686.1,784,9694,8910,6831.54586,1931.421849
2A,8500,4262,228805001.2,-384,9275,9659,6511.64946,1789.608263
5NE,8500,4257,228536576.7,-1875,9827,11702,4889.841673,2512.665426
5NW,8500,4249,228107097.6,-1875,9827,11702,5138.871499,2540.230966
5SE,8500,4260,228697631.4,-1875,9827,11702,5222.793192,2713.857263
6NE,8500,4255,228429206.9,1079,9386,8307,6059.641598,2132.152426
6NW,8500,4253,228321837.2,383,9784,9401,5980.59558,2416.635122
6SW,8500,4258,228590261.6,-195,9784,9979,5668.752466,2609.936284
Cell 1 2011/12,8500,4256,228482891.8,-2000,9230,11230,6006.756814,2197.984963
Cell 1 SW 2013,8500,4260,228697631.4,-1970,9468,11438,5720.037559,2227.258089
Cell 10 2011/12,8500,4254,228375522.1,-779,9915,10694,5212.053126,2838.046439
Cell 10 NE 2011/12,8500,4264,228912371,-779,9915,10694,5175.865619,2812.282629
Cell 10 NW 2011/12,8500,4257,228536576.7,-1875,9784,11659,5640.318064,2590.049809
Cell 10 SE 2013,8500,4252,228268152.3,383,9784,9401,5980.63429,2416.917963
Cell 10 SW 2011/12,8500,4258,228590261.6,-779,9951,10730,5375.533819,2816.279684
Cell 10-A 2011/12,8500,4261,228751316.3,-779,9971,10750,5032.44168,2845.594485
Cell 11 NE 2011/12,8500,4249,228107097.6,-195,9784,9979,5723.893387,2490.717297
Cell 11 NW 2013,8500,4262,228805001.2,-384,9275,9659,6428.120131,1859.330741
Cell 11 SW 2013,8500,4266,229019740.7,851,9386,8535,6116.665729,2159.305653
Cell 12 2013,8500,4258,228590261.6,1090,9773,8683,5997.318694,2119.264218
Cell 13 2013,8500,4268,229127110.5,1422,9764,8342,7173.63941,1219.055604
Cell 14 2013,8500,4266,229019740.7,1676,8842,7166,7794.616737,958.7651246
Cell 15 2013,8500,4262,228805001.2,5348,8938,3590,8087.286016,504.6723801
Cell 15-A 2013,8500,4264,228912371,5348,8902,3554,8110.448874,464.4723142
Cell 16 2013,8500,4259,228643946.5,5452,8942,3490,8106.130547,402.2993409
Cell 17 NW 2011/12,8500,4255,228429206.9,-471,9971,10442,5958.515159,2389.214753
Cell 17 NW 2013,8500,4248,228053412.7,-1875,9827,11702,5431.611111,2489.867379
Cell 17 SE 2013,8500,4258,228590261.6,-1875,9784,11659,5639.274542,2590.640491
Cell 17 SW 2013,8500,4260,228697631.4,-1875,9827,11702,5738.585915,2424.265244
Cell 18 2011/12,8500,4250,228160782.5,700,9982,9282,4816.848,2603.63682
Cell 18 NE 2013,8500,4262,228805001.2,-195,9784,9979,5747.514313,2578.767695
Cell 18 NW 2013,8500,4247,227999727.8,-1875,9827,11702,5207.38851,2712.449774
Cell 18 SE 2013,8500,4249,228107097.6,-195,9784,9979,5723.893387,2490.717297
Cell 18 SSE 2013,8500,4254,228375522.1,-195,9784,9979,5929.962388,2447.676279
Cell 19 NW 2013,8500,4257,228536576.7,851,9386,8535,6122.558609,2182.940939
Cell 2 2011/12,8500,4252,228268152.3,-384,9275,9659,6283.468015,1952.393344
Cell 2 NE 2013,8500,4260,228697631.4,-2000,9096,11096,6513.410094,1780.9023
Cell 2 SW 2013,8500,4251,228214467.4,-2000,9230,11230,6008.590449,2197.327386
Cell 20 2013,8500,4265,228966055.8,1090,9773,8683,6129.634701,2083.866883
Cell 21 2013,8500,4267,229073425.6,1320,9211,7891,6983.028357,1355.357351
Cell 22 2013,8500,4264,228912371,4359,8938,4579,7856.539869,529.0240725
Cell 23 2013,8500,4257,228536576.7,4359,8938,4579,7983.097486,549.7049245
Cell 24 2013,8500,4256,228482891.8,5452,8939,3487,8098.849154,384.1115552
Cell 25 NE 2013,8500,4252,228268152.3,-779,9915,10694,5210.75,2838.075005
Cell 25 SE 2013,8500,4258,228590261.6,-779,9951,10730,5375.488023,2816.342728
Cell 26 NE 2013,8500,4261,228751316.3,-195,9971,10166,5978.257686,2380.313639
Cell 26 NNW 2013,8500,4263,228858686.1,-779,9915,10694,5177.222848,2811.673067
Cell 26 NW 2013,8500,4261,228751316.3,-779,9971,10750,5032.44168,2845.594485
Cell 27 NW 2013,8500,4254,228375522.1,-195,9971,10166,6045.710155,2293.504381
Cell 28 2013,8500,4266,229019740.7,700,9982,9282,4367.802625,2452.506942
Cell 29 2013,8500,4264,228912371,1189,9358,8169,6259.436914,1994.497495
Cell 3 NE 2013,8500,4261,228751316.3,-384,8957,9341,6978.997418,1333.8562
Cell 3 NW 2013,8500,4255,228429206.9,-2000,9096,11096,6377.034783,1788.372936
Cell 30 2013,8500,4256,228482891.8,3349,8798,5449,7891.902491,528.3871421
Cell 31 2013,8500,4265,228966055.8,4359,8955,4596,8088.21524,527.6536077
Cell 32 2013,8500,4265,228966055.8,5634,9040,3406,8221.112075,405.8420001
Cell 33 NE 2013,8500,4255,228429206.9,-471,9971,10442,5958.515159,2389.214753
Cell 33 SE 2013,8500,4260,228697631.4,-1894,9942,11836,5398.495305,2690.729318
Cell 33 SW 2013,8500,4265,228966055.8,-1724,9981,11705,5231.160141,2700.815958
Cell 34 N 2013,8500,4265,228966055.8,-782,9982,10764,6016.745135,2323.296192
Cell 34 NW 2013,8500,4260,228697631.4,-1894,9971,11865,6213.205399,2217.735817
Cell 34 SE 2013,8500,4260,228697631.4,-1894,9982,11876,5889.314789,2488.456318
Cell 35 2013,8500,4258,228590261.6,5,9982,9977,4760.423438,2620.446976
Cell 37 2013,8500,4257,228536576.7,1739,9341,7602,7607.610289,583.3960833
Cell 38 2013,8500,4263,228858686.1,6199,9040,2841,8179.242552,350.8874882
Cell 39 2013,8500,4270,229234480.3,6375,9040,2665,8247.192506,344.5340864
Cell 4 2013,8500,4258,228590261.6,1373,9275,7902,7373.513621,984.7379444
Cell 40 NE 2013,8500,4253,228321837.2,-1894,9828,11722,4965.501528,2712.42395
Cell 41 N 2013,8500,4262,228805001.2,-1894,9795,11689,5791.84702,2455.636211
Cell 41 NW 2013,8500,4258,228590261.6,-1894,9844,11738,5487.744246,2626.844406
Cell 42 NW 2013,8500,4260,228697631.4,-10,9874,9884,6032.266432,2410.451524
Cell 43 2013,8500,4264,228912371,1032,9683,8651,5689.678236,2395.857883
Cell 44 2013,8500,4264,228912371,1230,9341,8111,6940.628987,1630.406444
Cell 45 2013,8500,4257,228536576.7,2626,9040,6414,7810.242659,493.1083192
Cell 47 2013,8500,4266,229019740.7,422,9694,9272,6620.560713,2040.657116
Cell 48 2013,8500,4259,228643946.5,651,9694,9043,6171.690772,2285.658227
Cell 49 2013,8500,4258,228590261.6,1249,9683,8434,6588.587835,1953.070128
Cell 5 2011/12 Summer,8500,4260,228697631.4,-1875,9827,11702,5738.585915,2424.265244
Cell 5 2013,8500,4258,228590261.6,3037,8869,5832,7887.628229,635.6299103
Cell 50 2013,8500,4269,229180795.4,1369,9040,7671,7014.527524,1700.239684
Cell 51 2013,8500,4268,229127110.5,5785,8935,3150,7994.323336,401.5175068
Cell 52 2013,8500,4271,229288165.2,1274,9383,8109,6738.807305,1996.452937
Cell 53 2013,8500,4262,228805001.2,1387,9157,7770,6933.809948,1811.21187
Cell 54 2013,8500,4257,228536576.7,2166,8961,6795,7860.419544,692.7804829
Cell 55 2013,8500,4265,228966055.8,5785,8961,3176,7921.888628,487.2310308
Cell 56 2013,8500,4267,229073425.6,1505,9931,8426,7030.680337,1433.84175
Cell 57 2013,8500,4255,228429206.9,1694,8887,7193,7167.816686,995.389085
Cell 58 2013,8500,4263,228858686.1,1694,8961,7267,7753.637579,946.4677604
Cell 59 2013,8500,4252,228268152.3,1505,9931,8426,6951.345484,1472.210364
Cell 6 2011/12,8500,4254,228375522.1,1142,9386,8244,5992.863423,2219.688637
Cell 6 2013,8500,4255,228429206.9,5041,9007,3966,8081.26792,462.2191006
Cell 6 NE 2011/12,8500,4255,228429206.9,1079,9386,8307,6059.641598,2132.152426
Cell 6 NW 2011/12,8500,4253,228321837.2,383,9784,9401,5980.59558,2416.635122
Cell 6 SW 2011/12,8500,4258,228590261.6,-195,9784,9979,5668.752466,2609.936284
Cell 60 2013,8500,4263,228858686.1,2277,8834,6557,6968.634999,930.9273637
Cell 61 2013,8500,4258,228590261.6,2116,8887,6771,7398.243072,1007.514809
Cell 7 2013,8500,4264,228912371,5313,9137,3824,8124.163462,577.8820332
Cell 9 NW 2013,8500,4254,228375522.1,-1957,9827,11784,5190.306535,2480.109368
Cell 9 SE 2013,8500,4257,228536576.7,-1875,9827,11702,4888.73432,2512.637347
Cell 9 SW 2013,8500,4250,228160782.5,-1875,9827,11702,5137.096706,2540.348471
Cell R1,8500,4253,228321837.2,974,9222,8248,5720.367505,1903.309319
Cell R10,8500,4257,228536576.7,1373,9275,7902,7373.575288,984.845378
Cell R100,8500,4268,229127110.5,1369,9040,7671,7014.100281,1700.20971
Cell R101,8500,4260,228697631.4,1470,8935,7465,7701.564085,842.334525
Cell R104,8500,4261,228751316.3,1282,9157,7875,6978.415161,1814.456678
Cell R105,8500,4262,228805001.2,1387,9157,7770,6933.809948,1811.21187
Cell R106,8500,4256,228482891.8,1401,9014,7613,7263.928571,1267.891816
Cell R107,8500,4257,228536576.7,2166,8961,6795,7860.419544,692.7804829
Cell R11,8500,4260,228697631.4,3037,8869,5832,7887.490376,635.5398435
Cell R111,8500,4261,228751316.3,1351,9931,8580,6679.074396,2018.65803
Cell R112,8500,4264,228912371,1694,9474,7780,7404.983349,811.3190864
Cell R113,8500,4255,228429206.9,1694,8887,7193,7167.834078,995.3967582
Cell R114,8500,4264,228912371,1694,8961,7267,7753.756801,946.388784
Cell R117,8500,4254,228375522.1,1437,9931,8494,6603.035496,1904.696665
Cell R118,8500,4266,229019740.7,1505,9931,8426,7030.526957,1433.974793
Cell R119,8500,4259,228643946.5,1694,8887,7193,7061.40479,1028.694892
Cell R120,8500,4262,228805001.2,1941,8887,6946,7336.221258,1101.847799
Cell R121,8500,4264,228912371,3613,8831,5218,7976.207083,511.3934428
Cell R123,8500,4258,228590261.6,1505,9931,8426,6870.001174,1537.133061
Cell R124,8500,4267,229073425.6,2277,8767,6490,6963.126318,920.8172424
Cell R125,8500,4268,229127110.5,2116,8887,6771,6859.430412,947.8081451
Cell R126,8500,4271,229288165.2,2116,8887,6771,7236.141419,1090.483682
Cell R15,8500,4260,228697631.4,-1970,9468,11438,5720.037559,2227.258089
Cell R16,8500,4251,228214467.4,-1957,9827,11784,5191.892261,2480.674463
Cell R17,8500,4261,228751316.3,383,9386,9003,6046.870453,2330.64363
Cell R18,8500,4264,228912371,-384,9275,9659,6438.25985,1852.075944
Cell R19,8500,4253,228321837.2,1326,9768,8442,6494.416177,1748.510597
Cell R20,8500,4263,228858686.1,1422,8848,7426,7258.05794,1173.202046
Cell R21,8500,4267,229073425.6,1422,8838,7416,7409.748535,1295.244872
Cell R22,8500,4266,229019740.7,1676,8842,7166,7794.616737,958.7651246
Cell R24,8500,4248,228053412.7,-1875,9827,11702,5430.38371,2490.210454
Cell R25,8500,4247,227999727.8,-1875,9827,11702,5207.38851,2712.449774
Cell R26,8500,4261,228751316.3,383,9784,9401,5981.959869,2419.532387
Cell R27,8500,4257,228536576.7,851,9386,8535,6122.558609,2182.940939
Cell R28,8500,4258,228590261.6,1090,9773,8683,5662.131047,2287.530965
Cell R29,8500,4265,228966055.8,1090,9773,8683,6129.634701,2083.866883
Cell R30,8500,4264,228912371,1422,8838,7416,7406.485929,1080.49321
Cell R31,8500,4262,228805001.2,2057,8938,6881,7741.183247,755.3510348
Cell R35,8500,4261,228751316.3,-1875,9827,11702,5739.071579,2424.18801
Cell R36,8500,4257,228536576.7,-1875,9784,11659,5640.318064,2590.049809
Cell R37,8500,4248,228053412.7,-195,9784,9979,5723.872881,2491.010085
Cell R38,8500,4259,228643946.5,700,9382,8682,5467.158723,2441.425887
Cell R39,8500,4256,228482891.8,1090,9773,8683,6287.4711,2037.334519
Cell R40,8500,4268,229127110.5,1320,9211,7891,6982.293112,1356.049343
Cell R46,8500,4260,228697631.4,-779,9961,10740,5473.287793,2787.587726
Cell R47,8500,4261,228751316.3,-779,9971,10750,5032.44168,2845.594485
Cell R48,8500,4260,228697631.4,-195,9971,10166,5978.257981,2380.593002
Cell R49,8500,4254,228375522.1,-195,9971,10166,6045.710155,2293.504381
Cell R5,8500,4250,228160782.5,-1970,9672,11642,5801.399294,2059.694549
Cell R50,8500,4266,229019740.7,700,9982,9282,4367.802625,2452.506942
Cell R51,8500,4263,228858686.1,1189,9358,8169,6273.932207,1982.79602
Cell R52,8500,4268,229127110.5,2443,8808,6365,7377.663777,726.6448772
Cell R53,8500,4261,228751316.3,2443,8680,6237,7469.903544,692.4900221
Cell R54,8500,4266,229019740.7,4359,8955,4596,8088.140647,527.6142497
Cell R58,8500,4257,228536576.7,-779,9976,10755,5279.902044,2791.717285
Cell R59,8500,4255,228429206.9,-471,9971,10442,5958.515159,2389.214753
Cell R6,8500,4251,228214467.4,-2000,9230,11230,6008.590449,2197.327386
Cell R60,8500,4261,228751316.3,-1894,9971,11865,6214.407885,2217.62778
Cell R61,8500,4258,228590261.6,5,9982,9977,4760.423438,2620.446976
Cell R62,8500,4265,228966055.8,716,9829,9113,4942.803517,2529.464015
Cell R63,8500,4264,228912371,716,9358,8642,5952.701454,2148.707099
Cell R64,8500,4264,228912371,3349,9288,5939,7662.757036,573.3421815
Cell R65,8500,4256,228482891.8,3349,8798,5449,7891.902491,528.3871421
Cell R66,8500,4265,228966055.8,5718,8955,3237,8214.828605,348.4401132
Cell R69,8500,4264,228912371,-1724,9981,11705,5231.324812,2701.111231
Cell R7,8500,4255,228429206.9,-2000,9096,11096,6377.034783,1788.372936
Cell R70,8500,4260,228697631.4,-1894,9942,11836,5398.495305,2690.729318
Cell R71,8500,4260,228697631.4,-1894,9982,11876,5890.774413,2487.793393
Cell R72,8500,4261,228751316.3,-10,9982,9992,5565.447782,2605.000655
Cell R73,8500,4262,228805001.2,-10,9982,9992,4665.148522,2677.011904
Cell R74,8500,4258,228590261.6,716,9341,8625,6060.275716,2307.0826
Cell R75,8500,4257,228536576.7,1739,9341,7602,7607.610289,583.3960833
Cell R76,8500,4265,228966055.8,6008,8849,2841,8069.125909,363.5010969
Cell R77,8500,4264,228912371,6199,9040,2841,8179.240854,350.8716363
Cell R8,8500,4258,228590261.6,-384,8957,9341,6920.578675,1370.12421
Cell R80,8500,4254,228375522.1,-1894,9828,11722,4966.167842,2712.45321
Cell R81,8500,4257,228536576.7,-1894,9977,11871,5730.043223,2554.595965
Cell R82,8500,4260,228697631.4,-10,9874,9884,6032.266432,2410.451524
Cell R83,8500,4263,228858686.1,-10,9874,9884,6134.309172,2348.613716
Cell R84,8500,4257,228536576.7,834,9683,8849,5425.962885,2458.082993
Cell R85,8500,4264,228912371,1032,9683,8651,5689.678236,2395.857883
Cell R86,8500,4260,228697631.4,1535,9284,7749,7396.375117,1162.850166
Cell R87,8500,4257,228536576.7,2626,9040,6414,7810.242659,493.1083192
Cell R9,8500,4257,228536576.7,-384,9275,9659,7108.270848,1259.060836
Cell R90,8500,4267,229073425.6,422,9694,9272,6620.817436,2040.486877
Cell R91,8500,4259,228643946.5,651,9694,9043,6171.690772,2285.658227
Cell R92,8500,4266,229019740.7,1032,9683,8651,5518.431552,2372.667827
Cell R93,8500,4258,228590261.6,1249,9683,8434,6588.587835,1953.070128
Cell R97,8500,4265,228966055.8,784,9694,8910,6955.433529,1846.429384
Cell R98,8500,4262,228805001.2,1032,9683,8651,6522.18184,2224.423096
Cell R99,8500,4271,229288165.2,1274,9383,8109,6738.807305,1996.452937
Cell S102,8500,4264,228912371,5785,8935,3150,7997.510084,411.6465501
Cell S108,8500,4266,229019740.7,5785,8961,3176,7921.988279,487.2173871
Cell S13,8500,4268,229127110.5,5628,9125,3497,8185.68791,446.1721204
Cell S14,8500,4265,228966055.8,5313,9137,3824,8124.079484,577.8403026
Cell S2,8500,4255,228429206.9,5041,9007,3966,8081.26792,462.2191006
Cell S23,8500,4261,228751316.3,5348,9125,3777,8115.405539,500.0500048
Cell S32,8500,4268,229127110.5,5348,8938,3590,7953.776476,446.6644506
Cell S33,8500,4264,228912371,5348,8902,3554,8110.459193,464.4815017
Cell S34,8500,4256,228482891.8,5452,8939,3487,8098.849154,384.1115552
Cell S41,8500,4267,229073425.6,2443,8808,6365,7636.483712,569.7348957
Cell S42,8500,4257,228536576.7,4359,8938,4579,7983.097486,549.7049245
Cell S44,8500,4264,228912371,5514,8939,3425,8117.189728,404.1029696
Cell S56,8500,4272,229341850.1,5441,8955,3514,8058.917135,458.0170976
Cell S67,8500,4264,228912371,5634,9040,3406,8221.094043,405.8878784
Cell S78,8500,4269,229180795.4,6375,9040,2665,8247.161396,344.5684404
Cell S88,8500,4265,228966055.8,4473,8986,4513,8070.354982,427.6894093
Cell S94,8500,4263,228858686.1,5222,8935,3713,7945.105794,430.4556057
Cell S95,8500,4268,229127110.5,5785,8935,3150,7994.323336,401.5175068
W287,8500,4263,228858686.1,-1891,9904,11795,4398.99179,2130.784892
W295,8500,4257,228536576.7,1344,8991,7647,6811.348132,1859.779058
W338,8500,4252,228268152.3,692,9923,9231,3776.037865,2360.397855
W342,8500,4254,228375522.1,817,8605,7788,5378.515045,2301.492486
W345,8500,4256,228482891.8,1565,8605,7040,7155.816024,1208.84343
W387,8500,4253,228321837.2,-54,9937,9991,5154.358806,2471.101032
W393,8500,4251,228214467.4,853,9923,9070,5440.62103,2445.329295
W440,8500,4257,228536576.7,1125,9937,8812,5758.875969,2336.880589
W441,8500,4256,228482891.8,1125,8637,7512,6300.678102,1808.863755
W445,8500,4251,228214467.4,1848,8692,6844,6820.205834,1015.039816
W500,8500,4258,228590261.6,1427,8823,7396,6469.892438,1612.344798
1,8750,4514,242333593.5,-2000,9230,11230,5974.509969,2203.46132
2,8750,4514,242333593.5,-384,9275,9659,6292.723084,1951.096747
3,8750,4512,242226223.7,-384,9768,10152,6840.196587,1512.192276
4,8750,4514,242333593.5,1422,9275,7853,7209.159504,1160.144162
5,8750,4506,241904114.3,-1875,9827,11702,5699.076343,2440.324744
6,8750,4511,242172538.8,1142,9386,8244,5960.689204,2234.356631
7,8750,4514,242333593.5,1090,9773,8683,5994.519938,2113.947354
8,8750,4516,242440963.2,1422,9715,8293,7210.393268,1200.3255
9,8750,4511,242172538.8,4359,8938,4579,7873.387941,509.9895129
10,8750,4510,242118853.9,-779,9915,10694,5223.151441,2830.620914
11,8750,4519,242602017.9,-195,9971,10166,5994.606993,2381.380297
12,8750,4520,242655702.8,700,9982,9282,4392.015708,2446.649908
13,8750,4517,242494648.1,1093,9358,8265,6225.660173,2027.942672
14,8750,4518,242548333,3421,8955,5534,8006.756529,544.7966461
16,8750,4520,242655702.8,-1894,9981,11875,5203.492035,2709.679404
17,8750,4512,242226223.7,-1894,9971,11865,6197.103059,2235.9131
18,8750,4510,242118853.9,700,9982,9282,4848.997561,2597.82516
19,8750,4518,242548333,716,9829,9113,5001.476317,2509.61134
20,8750,4515,242387278.4,1465,9341,7876,7581.884385,668.9013716
21,8750,4517,242494648.1,6199,9040,2841,8170.825991,356.7780969
22,8750,4510,242118853.9,-1894,9828,11722,4926.800665,2760.578416
23,8750,4501,241635689.9,-10,9874,9884,6072.894024,2394.042021
24,8750,4517,242494648.1,422,9694,9272,6130.179544,2303.408295
25,8750,4503,241743059.7,1249,9683,8434,6579.309571,1967.921622
26,8750,4511,242172538.8,1682,9040,7358,7801.415429,559.728818
27,8750,4516,242440963.2,1032,9683,8651,6475.763286,2244.252656
28,8750,4516,242440963.2,1387,9157,7770,6910.138618,1839.972949
29,8750,4521,242709387.7,1369,9040,7671,7018.547003,1703.901439
31,8750,4513,242279908.6,1475,9931,8456,7033.452027,1635.42442
32,8750,4519,242602017.9,1694,8887,7193,7178.258686,989.0302378
33,8750,4519,242602017.9,1505,9931,8426,7002.568267,1475.148478
34,8750,4512,242226223.7,1694,9039,7345,6957.037899,1006.223618
10A,8750,4519,242602017.9,-779,9971,10750,5094.284576,2835.923083
10NE,8750,4511,242172538.8,-779,9915,10694,5217.017069,2811.333989
10NW,8750,4508,242011484.1,-1875,9784,11659,5657.73669,2584.544957
10SW,8750,4520,242655702.8,-779,9951,10730,5344.154425,2822.905064
11NE,8750,4507,241957799.2,-195,9784,9979,5701.738407,2491.980085
11NW,8750,4514,242333593.5,-195,9784,9979,5895.183208,2470.053197
11SE,8750,4508,242011484.1,-195,9971,10166,6045.505324,2305.86952
17NW,8750,4506,241904114.3,-471,9971,10442,5896.312916,2407.680263
17SE,8750,4515,242387278.4,-1894,9982,11876,5890.636988,2482.603301
17SW,8750,4519,242602017.9,-1894,9942,11836,5388.2921,2684.776425
22S,8750,4506,241904114.3,-1894,9828,11722,4817.569685,2756.895294
23S,8750,4521,242709387.7,981,9773,8792,4910.340411,2383.358084
24S,8750,4512,242226223.7,422,9694,9272,6122.652482,2308.145083
27A,8750,4516,242440963.2,784,9694,8910,6838.442427,1928.475804
2A,8750,4513,242279908.6,-384,9275,9659,6529.299801,1800.254831
5NE,8750,4510,242118853.9,-1875,9827,11702,4938.508869,2514.874506
5NW,8750,4513,242279908.6,-1875,9827,11702,5146.948371,2545.001296
5SE,8750,4517,242494648.1,-1875,9827,11702,5271.973212,2713.063598
6NE,8750,4503,241743059.7,1056,9386,8330,5999.619809,2163.001408
6NW,8750,4502,241689374.8,383,9784,9401,5980.938472,2409.041805
6SW,8750,4509,242065169,-195,9784,9979,5636.645376,2603.481657
Cell 1 2011/12,8750,4514,242333593.5,-2000,9230,11230,5974.509969,2203.46132
Cell 1 SW 2013,8750,4517,242494648.1,-1970,9672,11642,5741.663272,2213.124923
Cell 10 2011/12,8750,4510,242118853.9,-779,9915,10694,5223.151441,2830.620914
Cell 10 NE 2011/12,8750,4511,242172538.8,-779,9915,10694,5217.017069,2811.333989
Cell 10 NW 2011/12,8750,4508,242011484.1,-1875,9784,11659,5657.73669,2584.544957
Cell 10 SE 2013,8750,4504,241796744.6,383,9784,9401,5980.023757,2408.942359
Cell 10 SW 2011/12,8750,4520,242655702.8,-779,9951,10730,5344.154425,2822.905064
Cell 10-A 2011/12,8750,4519,242602017.9,-779,9971,10750,5094.284576,2835.923083
Cell 11 NE 2011/12,8750,4507,241957799.2,-195,9784,9979,5701.738407,2491.980085
Cell 11 NW 2013,8750,4512,242226223.7,-384,9275,9659,6442.827349,1868.31311
Cell 11 SW 2013,8750,4510,242118853.9,851,9386,8535,6059.84235,2191.097636
Cell 12 2013,8750,4510,242118853.9,1090,9773,8683,5994.330599,2115.333233
Cell 13 2013,8750,4512,242226223.7,1422,9773,8351,7198.921099,1202.765367
Cell 14 2013,8750,4515,242387278.4,1676,8938,7262,7779.581838,991.4771629
Cell 15 2013,8750,4519,242602017.9,5348,8938,3590,8092.749502,501.9576181
Cell 15-A 2013,8750,4517,242494648.1,5348,8938,3590,8109.997786,471.2581162
Cell 16 2013,8750,4514,242333593.5,5452,8942,3490,8109.312583,404.0202445
Cell 17 NW 2011/12,8750,4506,241904114.3,-471,9971,10442,5896.312916,2407.680263
Cell 17 NW 2013,8750,4504,241796744.6,-1875,9827,11702,5405.654529,2507.607616
Cell 17 SE 2013,8750,4508,242011484.1,-1875,9784,11659,5657.73669,2584.544957
Cell 17 SW 2013,8750,4514,242333593.5,-1875,9827,11702,5702.561143,2443.204748
Cell 18 2011/12,8750,4510,242118853.9,700,9982,9282,4848.997561,2597.82516
Cell 18 NE 2013,8750,4514,242333593.5,-195,9784,9979,5692.739477,2583.519133
Cell 18 NW 2013,8750,4505,241850429.5,-1875,9827,11702,5252.274806,2712.515349
Cell 18 SE 2013,8750,4507,241957799.2,-195,9784,9979,5701.738407,2491.980085
Cell 18 SSE 2013,8750,4514,242333593.5,-195,9784,9979,5948.772264,2435.492353
Cell 19 NW 2013,8750,4511,242172538.8,851,9386,8535,6109.035912,2191.261603
Cell 2 2011/12,8750,4514,242333593.5,-384,9275,9659,6292.723084,1951.096747
Cell 2 NE 2013,8750,4505,241850429.5,-2000,9096,11096,6515.701221,1781.713987
Cell 2 SW 2013,8750,4514,242333593.5,-2000,9230,11230,5973.882366,2203.801784
Cell 20 2013,8750,4515,242387278.4,1090,9773,8683,6081.440975,2104.545208
Cell 21 2013,8750,4514,242333593.5,1320,9366,8046,6946.689411,1402.184627
Cell 22 2013,8750,4514,242333593.5,4359,8938,4579,7856.271156,525.8608353
Cell 23 2013,8750,4505,241850429.5,4359,8938,4579,7978.922752,544.8823892
Cell 24 2013,8750,4516,242440963.2,5452,8939,3487,8100.203942,386.2529017
Cell 25 NE 2013,8750,4510,242118853.9,-779,9915,10694,5223.151441,2830.620914
Cell 25 SE 2013,8750,4520,242655702.8,-779,9951,10730,5344.154425,2822.905064
Cell 26 NE 2013,8750,4519,242602017.9,-195,9971,10166,5994.606993,2381.380297
Cell 26 NNW 2013,8750,4512,242226223.7,-779,9915,10694,5217.566933,2811.26502
Cell 26 NW 2013,8750,4518,242548333,-779,9971,10750,5093.792829,2836.044263
Cell 27 NW 2013,8750,4508,242011484.1,-195,9971,10166,6045.505324,2305.86952
Cell 28 2013,8750,4521,242709387.7,700,9982,9282,4393.11524,2447.260447
Cell 29 2013,8750,4516,242440963.2,1093,9358,8265,6224.071081,2028.983867
Cell 3 NE 2013,8750,4513,242279908.6,-384,9189,9573,6961.751606,1361.658803
Cell 3 NW 2013,8750,4515,242387278.4,-2000,9371,11371,6381.455371,1796.961945
Cell 30 2013,8750,4515,242387278.4,3349,8924,5575,7886.10454,536.3651631
Cell 31 2013,8750,4524,242870442.4,4359,8955,4596,8084.355438,521.004653
Cell 32 2013,8750,4517,242494648.1,5634,9040,3406,8220.828205,404.6804616
Cell 33 NE 2013,8750,4507,241957799.2,-471,9971,10442,5896.670734,2407.532963
Cell 33 SE 2013,8750,4520,242655702.8,-1894,9942,11836,5388.823673,2684.717245
Cell 33 SW 2013,8750,4509,242065169,-1894,9981,11875,5213.297405,2704.465785
Cell 34 N 2013,8750,4511,242172538.8,-782,9982,10764,5991.736865,2338.303721
Cell 34 NW 2013,8750,4512,242226223.7,-1894,9971,11865,6197.103059,2235.9131
Cell 34 SE 2013,8750,4514,242333593.5,-1894,9982,11876,5891.571998,2482.046967
Cell 35 2013,8750,4501,241635689.9,-10,9982,9992,4778.189513,2616.088073
Cell 37 2013,8750,4512,242226223.7,1465,9341,7876,7587.72695,661.0335425
Cell 38 2013,8750,4521,242709387.7,6199,9040,2841,8175.534616,354.8144827
Cell 39 2013,8750,4515,242387278.4,6375,9040,2665,8242.474862,344.5625059
Cell 4 2013,8750,4512,242226223.7,1373,9275,7902,7340.057846,1064.870343
Cell 40 NE 2013,8750,4502,241689374.8,-1894,9942,11836,5009.243447,2710.078204
Cell 41 N 2013,8750,4519,242602017.9,-1894,9795,11689,5744.711441,2478.148377
Cell 41 NW 2013,8750,4516,242440963.2,-1894,9844,11738,5455.893268,2647.860497
Cell 42 NW 2013,8750,4517,242494648.1,-10,9874,9884,6055.59752,2397.880119
Cell 43 2013,8750,4522,242763072.6,861,9683,8822,5683.756966,2401.587524
Cell 44 2013,8750,4521,242709387.7,1211,9341,8130,6881.177837,1697.625146
Cell 45 2013,8750,4514,242333593.5,1682,9040,7358,7801.681879,559.6447998
Cell 47 2013,8750,4511,242172538.8,422,9694,9272,6580.595655,2065.163412
Cell 48 2013,8750,4512,242226223.7,422,9694,9272,6122.132314,2307.875877
Cell 49 2013,8750,4503,241743059.7,1249,9683,8434,6579.309571,1967.921622
Cell 5 2011/12 Summer,8750,4515,242387278.4,-1875,9827,11702,5703.10144,2443.203855
Cell 5 2013,8750,4516,242440963.2,2932,8869,5937,7883.866696,653.6168758
Cell 50 2013,8750,4520,242655702.8,1369,9040,7671,7018.423673,1704.069736
Cell 51 2013,8750,4524,242870442.4,5785,8935,3150,7995.119363,399.6729276
Cell 52 2013,8750,4515,242387278.4,1274,9383,8109,6677.916279,2044.305968
Cell 53 2013,8750,4514,242333593.5,1387,9157,7770,6909.637794,1840.224463
Cell 54 2013,8750,4520,242655702.8,2166,8961,6795,7846.403761,711.2451045
Cell 55 2013,8750,4519,242602017.9,5785,8961,3176,7917.932728,485.6794415
Cell 56 2013,8750,4524,242870442.4,1505,9931,8426,7001.849912,1474.742254
Cell 57 2013,8750,4519,242602017.9,1694,8887,7193,7177.273069,989.7138369
Cell 58 2013,8750,4519,242602017.9,1694,8961,7267,7743.106218,941.0966941
Cell 59 2013,8750,4513,242279908.6,1505,9931,8426,6930.056282,1490.181419
Cell 6 2011/12,8750,4511,242172538.8,1142,9386,8244,5960.689204,2234.356631
Cell 6 2013,8750,4513,242279908.6,5041,9017,3976,8077.132728,468.4300513
Cell 6 NE 2011/12,8750,4503,241743059.7,1056,9386,8330,5999.619809,2163.001408
Cell 6 NW 2011/12,8750,4502,241689374.8,383,9784,9401,5980.938472,2409.041805
Cell 6 SW 2011/12,8750,4509,242065169,-195,9784,9979,5636.645376,2603.481657
Cell 60 2013,8750,4522,242763072.6,2277,9039,6762,6984.911765,932.527181
Cell 61 2013,8750,4515,242387278.4,2116,8887,6771,7388.853821,1035.183702
Cell 7 2013,8750,4524,242870442.4,5313,9137,3824,8126.21618,574.1944576
Cell 9 NW 2013,8750,4508,242011484.1,-1957,9827,11784,5220.970719,2480.741668
Cell 9 SE 2013,8750,4511,242172538.8,-1875,9827,11702,4939.102416,2514.91165
Cell 9 SW 2013,8750,4514,242333593.5,-1875,9827,11702,5147.664599,2545.174219
Cell R1,8750,4501,241635689.9,974,9222,8248,5730.276827,1896.558062
Cell R10,8750,4511,242172538.8,1373,9275,7902,7339.794059,1064.840956
Cell R100,8750,4520,242655702.8,1369,9040,7671,7018.423673,1704.069736
Cell R101,8750,4516,242440963.2,1454,8935,7481,7665.30093,920.2038607
Cell R104,8750,4508,242011484.1,1282,9157,7875,6979.751109,1805.110894
Cell R105,8750,4514,242333593.5,1387,9157,7770,6909.637794,1840.224463
Cell R106,8750,4517,242494648.1,1401,9014,7613,7268.309276,1264.421821
Cell R107,8750,4520,242655702.8,2166,8961,6795,7846.403761,711.2451045
Cell R11,8750,4516,242440963.2,2932,8869,5937,7883.866696,653.6168758
Cell R111,8750,4511,242172538.8,1351,9931,8580,6692.084904,2003.300456
Cell R112,8750,4517,242494648.1,1694,9474,7780,7397.354439,832.7329686
Cell R113,8750,4519,242602017.9,1694,8887,7193,7177.273069,989.7138369
Cell R114,8750,4518,242548333,1694,8961,7267,7743.02324,941.1843086
Cell R117,8750,4511,242172538.8,1437,9931,8494,6599.195965,1904.948901
Cell R118,8750,4525,242924127.3,1505,9931,8426,7002.057901,1474.645649
Cell R119,8750,4512,242226223.7,1694,8887,7193,7079.495124,1019.860444
Cell R120,8750,4504,241796744.6,1941,8887,6946,7336.612123,1116.955512
Cell R121,8750,4522,242763072.6,3613,8831,5218,7960.677134,541.2195188
Cell R123,8750,4518,242548333,1505,9931,8426,6857.381806,1554.839324
Cell R124,8750,4518,242548333,2277,8834,6557,6977.07127,915.5053031
Cell R125,8750,4526,242977812.1,2116,8887,6771,6872.669244,939.8592621
Cell R126,8750,4524,242870442.4,2116,8887,6771,7252.607427,1084.304485
Cell R15,8750,4517,242494648.1,-1970,9672,11642,5741.663272,2213.124923
Cell R16,8750,4513,242279908.6,-1957,9827,11784,5224.245735,2480.343686
Cell R17,8750,4511,242172538.8,383,9386,9003,6045.816892,2320.756024
Cell R18,8750,4519,242602017.9,-384,9275,9659,6446.945121,1866.237742
Cell R19,8750,4514,242333593.5,1326,9768,8442,6490.896323,1754.521683
Cell R20,8750,4515,242387278.4,1422,8848,7426,7274.562348,1165.886866
Cell R21,8750,4513,242279908.6,1422,8838,7416,7425.891425,1274.751907
Cell R22,8750,4515,242387278.4,1676,8938,7262,7779.581838,991.4771629
Cell R24,8750,4504,241796744.6,-1875,9827,11702,5406.914742,2507.684363
Cell R25,8750,4506,241904114.3,-1875,9827,11702,5252.799379,2712.442868
Cell R26,8750,4508,242011484.1,383,9784,9401,5985.643744,2408.291842
Cell R27,8750,4510,242118853.9,851,9386,8535,6109.204435,2191.475294
Cell R28,8750,4513,242279908.6,1090,9773,8683,5655.381564,2279.912198
Cell R29,8750,4515,242387278.4,1090,9773,8683,6081.440975,2104.545208
Cell R30,8750,4513,242279908.6,1422,8838,7416,7410.559052,1081.427261
Cell R31,8750,4520,242655702.8,2057,8938,6881,7732.255973,783.3890955
Cell R35,8750,4514,242333593.5,-1875,9827,11702,5702.561143,2443.204748
Cell R36,8750,4508,242011484.1,-1875,9784,11659,5657.73669,2584.544957
Cell R37,8750,4507,241957799.2,-195,9784,9979,5701.738407,2491.980085
Cell R38,8750,4521,242709387.7,700,9388,8688,5442.747843,2444.30094
Cell R39,8750,4514,242333593.5,1090,9773,8683,6268.086841,2049.905677
Cell R40,8750,4513,242279908.6,1320,9366,8046,6946.536229,1402.302202
Cell R46,8750,4516,242440963.2,-779,9961,10740,5473.196856,2778.424917
Cell R47,8750,4517,242494648.1,-779,9971,10750,5093.46801,2836.274144
Cell R48,8750,4520,242655702.8,-195,9971,10166,5995.306858,2381.581605
Cell R49,8750,4508,242011484.1,-195,9971,10166,6045.505324,2305.86952
Cell R5,8750,4504,241796744.6,-1970,9672,11642,5783.242229,2068.819335
Cell R50,8750,4521,242709387.7,700,9982,9282,4393.11524,2447.260447
Cell R51,8750,4518,242548333,1093,9358,8265,6231.136565,2026.104106
Cell R52,8750,4521,242709387.7,2443,8808,6365,7386.656713,718.836963
Cell R53,8750,4515,242387278.4,2443,8680,6237,7474.841196,692.8578327
Cell R54,8750,4523,242816757.5,4359,8955,4596,8084.390449,521.0569236
Cell R58,8750,4513,242279908.6,-779,9976,10755,5279.715045,2786.249163
Cell R59,8750,4506,241904114.3,-471,9971,10442,5896.312916,2407.680263
Cell R6,8750,4515,242387278.4,-2000,9230,11230,5974.110963,2203.611241
Cell R60,8750,4512,242226223.7,-1894,9971,11865,6197.854167,2234.858041
Cell R61,8750,4501,241635689.9,-10,9982,9992,4778.189513,2616.088073
Cell R62,8750,4516,242440963.2,716,9829,9113,4996.30093,2518.104374
Cell R63,8750,4515,242387278.4,716,9358,8642,5933.136877,2167.285033
Cell R64,8750,4517,242494648.1,3349,9288,5939,7668.549923,574.4344434
Cell R65,8750,4515,242387278.4,3349,8924,5575,7886.10454,536.3651631
Cell R66,8750,4525,242924127.3,5718,8982,3264,8202.216575,356.9595621
Cell R69,8750,4510,242118853.9,-1894,9981,11875,5213.73082,2704.322546
Cell R7,8750,4515,242387278.4,-2000,9371,11371,6381.455371,1796.961945
Cell R70,8750,4520,242655702.8,-1894,9942,11836,5388.823673,2684.717245
Cell R71,8750,4513,242279908.6,-1894,9982,11876,5891.28296,2482.24598
Cell R72,8750,4515,242387278.4,-10,9982,9992,5566.750166,2600.146576
Cell R73,8750,4519,242602017.9,-10,9982,9992,4672.200044,2671.828139
Cell R74,8750,4515,242387278.4,716,9341,8625,6045.924031,2308.22793
Cell R75,8750,4513,242279908.6,1465,9341,7876,7587.811655,660.9847909
Cell R76,8750,4523,242816757.5,6008,9040,3032,8066.894097,369.4274835
Cell R77,8750,4521,242709387.7,6199,9040,2841,8175.534616,354.8144827
Cell R8,8750,4510,242118853.9,-384,8994,9378,6904.041907,1393.312309
Cell R80,8750,4501,241635689.9,-1894,9942,11836,5008.729171,2710.159578
Cell R81,8750,4508,242011484.1,-1894,9977,11871,5682.540373,2575.759464
Cell R82,8750,4519,242602017.9,-10,9874,9884,6056.404293,2397.656057
Cell R83,8750,4515,242387278.4,-10,9874,9884,6155.965449,2337.985764
Cell R84,8750,4517,242494648.1,834,9683,8849,5454.389639,2452.265856
Cell R85,8750,4522,242763072.6,861,9683,8822,5683.756966,2401.587524
Cell R86,8750,4520,242655702.8,1394,9284,7890,7372.440708,1240.181496
Cell R87,8750,4514,242333593.5,1682,9040,7358,7801.681879,559.6447998
Cell R9,8750,4498,241474635.2,-384,9275,9659,7102.981992,1267.736398
Cell R90,8750,4512,242226223.7,422,9694,9272,6579.687722,2065.834769
Cell R91,8750,4510,242118853.9,422,9694,9272,6121.797118,2308.18684
Cell R92,8750,4517,242494648.1,1032,9683,8651,5595.270091,2347.900054
Cell R93,8750,4501,241635689.9,1249,9683,8434,6578.778049,1968.178186
Cell R97,8750,4517,242494648.1,784,9694,8910,6946.957273,1853.726461
Cell R98,8750,4514,242333593.5,1032,9683,8651,6475.559592,2244.724326
Cell R99,8750,4515,242387278.4,1274,9383,8109,6677.966777,2044.190608
Cell S102,8750,4520,242655702.8,5785,8935,3150,7993.938274,412.5898169
Cell S108,8750,4517,242494648.1,5785,8961,3176,7917.737215,485.6878589
Cell S13,8750,4515,242387278.4,5628,9125,3497,8188.114064,441.6670028
Cell S14,8750,4524,242870442.4,5313,9137,3824,8126.21618,574.1944576
Cell S2,8750,4512,242226223.7,5041,9017,3976,8077.117686,468.480868
Cell S23,8750,4513,242279908.6,5348,9125,3777,8114.456681,501.1671796
Cell S32,8750,4514,242333593.5,5348,8938,3590,7953.772264,445.894263
Cell S33,8750,4517,242494648.1,5348,8938,3590,8109.70135,471.3885273
Cell S34,8750,4516,242440963.2,5452,8939,3487,8100.203942,386.2529017
Cell S41,8750,4513,242279908.6,2443,8808,6365,7614.363395,618.0515838
Cell S42,8750,4506,241904114.3,4359,8938,4579,7978.916556,544.8220827
Cell S44,8750,4520,242655702.8,5514,8939,3425,8109.972124,413.4586085
Cell S56,8750,4521,242709387.7,5441,8955,3514,8058.928998,461.3528317
Cell S67,8750,4516,242440963.2,5634,9040,3406,8220.839017,404.7246119
Cell S78,8750,4515,242387278.4,6375,9040,2665,8242.474862,344.5625059
Cell S88,8750,4518,242548333,4473,8986,4513,8067.682824,429.4278451
Cell S94,8750,4519,242602017.9,5222,8935,3713,7935.747289,437.5335342
Cell S95,8750,4525,242924127.3,5785,8935,3150,7995.173481,399.6453391
W287,8750,4511,242172538.8,-1891,9904,11795,4465.011749,2147.341221
W295,8750,4514,242333593.5,1134,8991,7857,6777.99712,1902.04888
W338,8750,4499,241528320.1,692,9923,9231,3801.704601,2358.128835
W342,8750,4501,241635689.9,807,8605,7798,5397.33948,2305.272701
W345,8750,4513,242279908.6,1565,8605,7040,7128.977177,1241.967996
W387,8750,4503,241743059.7,-54,9937,9991,5163.152343,2464.188953
W393,8750,4508,242011484.1,853,9923,9070,5437.382653,2439.954564
W440,8750,4514,242333593.5,1125,9937,8812,5716.165928,2349.357347
W441,8750,4506,241904114.3,1125,8644,7519,6257.338438,1836.341279
W445,8750,4503,241743059.7,1848,8692,6844,6833.364424,1008.299991
W500,8750,4510,242118853.9,1427,8823,7396,6496.871175,1594.942493
1,9000,4775,256345349.7,-2000,9230,11230,5950.993508,2201.270991
2,9000,4773,256237980,-384,9275,9659,6294.607584,1966.419425
3,9000,4776,256399034.6,-384,9768,10152,6834.727387,1517.263358
4,9000,4781,256667459.1,1422,9768,8346,7203.333821,1186.401601
5,9000,4774,256291664.9,-1875,9827,11702,5655.95287,2466.185917
6,9000,4768,255969555.5,1079,9386,8307,5928.318582,2250.814252
7,9000,4775,256345349.7,1090,9773,8683,5992.737382,2110.05913
8,9000,4777,256452719.5,1422,9764,8342,7236.081641,1184.471158
9,9000,4779,256560089.3,4359,8938,4579,7864.229127,519.4644654
10,9000,4763,255701131.1,-779,9915,10694,5235.188117,2823.576464
11,9000,4776,256399034.6,-195,9971,10166,6000.955821,2377.781287
12,9000,4784,256828513.8,700,9982,9282,4436.992475,2450.73954
13,9000,4778,256506404.4,1093,9366,8273,6190.584763,2059.24892
14,9000,4777,256452719.5,3421,8955,5534,8004.074942,541.7368507
16,9000,4776,256399034.6,-1894,9981,11875,5195.23639,2719.542597
17,9000,4777,256452719.5,-1894,9971,11865,6138.260624,2278.570917
18,9000,4774,256291664.9,396,9982,9586,4868.597403,2590.712005
19,9000,4772,256184295.1,716,9829,9113,5063.158215,2501.008598
20,9000,4779,256560089.3,1465,9341,7876,7560.938272,749.5472039
21,9000,4771,256130610.2,6199,9040,2841,8168.642004,360.1604374
22,9000,4771,256130610.2,-1894,9844,11738,4969.425068,2765.155608
23,9000,4773,256237980,-10,9874,9884,6081.645506,2385.757551
24,9000,4780,256613774.2,422,9694,9272,6089.293515,2317.081739
25,9000,4772,256184295.1,1249,9683,8434,6568.950335,1983.246564
26,9000,4778,256506404.4,1682,9040,7358,7788.377564,634.3547142
27,9000,4776,256399034.6,1032,9683,8651,6434.695352,2256.735296
28,9000,4775,256345349.7,1387,9157,7770,6896.549529,1854.777959
29,9000,4781,256667459.1,1369,9040,7671,7018.978247,1707.992739
31,9000,4770,256076925.3,1475,9931,8456,7008.620335,1653.208165
32,9000,4779,256560089.3,1694,8887,7193,7193.030341,980.0925855
33,9000,4784,256828513.8,1505,9931,8426,6981.985368,1498.823543
34,9000,4771,256130610.2,1694,9136,7442,6959.368476,1018.935245
10A,9000,4775,256345349.7,-779,9971,10750,5153.66534,2821.252245
10NE,9000,4777,256452719.5,-779,9971,10750,5255.055265,2810.345677
10NW,9000,4769,256023240.4,-1875,9784,11659,5670.898931,2575.321875
10SW,9000,4775,256345349.7,-779,9961,10740,5308.90178,2824.71634
11NE,9000,4764,255754816,-195,9784,9979,5679.233627,2491.38642
11NW,9000,4776,256399034.6,-195,9784,9979,5893.917714,2467.250342
11SE,9000,4771,256130610.2,-195,9971,10166,6047.922867,2316.168219
17NW,9000,4773,256237980,-1250,9971,11221,5833.163838,2425.510734
17SE,9000,4779,256560089.3,-1894,9982,11876,5895.017577,2477.84494
17SW,9000,4776,256399034.6,-1894,9942,11836,5392.184673,2675.115732
22S,9000,4769,256023240.4,-1894,9828,11722,4877.371566,2770.152044
23S,9000,4784,256828513.8,981,9773,8792,4994.532818,2378.188652
24S,9000,4775,256345349.7,422,9694,9272,6087.753717,2317.112821
27A,9000,4780,256613774.2,784,9694,8910,6841.366318,1927.798095
2A,9000,4777,256452719.5,-384,9275,9659,6542.10739,1812.882695
5NE,9000,4773,256237980,-1875,9827,11702,5002.769327,2520.624497
5NW,9000,4772,256184295.1,-1875,9827,11702,5163.330679,2541.776623
5SE,9000,4775,256345349.7,-1875,9827,11702,5316.380314,2710.853718
6NE,9000,4765,255808500.8,1025,9386,8361,5947.132424,2190.961953
6NW,9000,4766,255862185.7,383,9784,9401,5988.276542,2393.85435
6SW,9000,4771,256130610.2,-195,9784,9979,5606.915112,2593.823049
Cell 1 2011/12,9000,4775,256345349.7,-2000,9230,11230,5950.993508,2201.270991
Cell 1 SW 2013,9000,4776,256399034.6,-1970,9672,11642,5759.175879,2200.059578
Cell 10 2011/12,9000,4763,255701131.1,-779,9915,10694,5235.188117,2823.576464
Cell 10 NE 2011/12,9000,4777,256452719.5,-779,9971,10750,5255.055265,2810.345677
Cell 10 NW 2011/12,9000,4769,256023240.4,-1875,9784,11659,5670.898931,2575.321875
Cell 10 SE 2013,9000,4766,255862185.7,383,9784,9401,5988.276542,2393.85435
Cell 10 SW 2011/12,9000,4775,256345349.7,-779,9961,10740,5308.90178,2824.71634
Cell 10-A 2011/12,9000,4775,256345349.7,-779,9971,10750,5153.66534,2821.252245
Cell 11 NE 2011/12,9000,4764,255754816,-195,9784,9979,5679.233627,2491.38642
Cell 11 NW 2013,9000,4777,256452719.5,-384,9275,9659,6436.833787,1889.482079
Cell 11 SW 2013,9000,4777,256452719.5,771,9386,8615,6011.99686,2224.559411
Cell 12 2013,9000,4774,256291664.9,1090,9773,8683,5991.816506,2111.266185
Cell 13 2013,9000,4778,256506404.4,1422,9773,8351,7225.056509,1187.28832
Cell 14 2013,9000,4781,256667459.1,1423,8938,7515,7763.192428,1021.597833
Cell 15 2013,9000,4778,256506404.4,5348,8938,3590,8098.820008,498.9089211
Cell 15-A 2013,9000,4778,256506404.4,5348,8938,3590,8111.356635,472.1194994
Cell 16 2013,9000,4778,256506404.4,5452,8942,3490,8112.954584,405.1936106
Cell 17 NW 2011/12,9000,4773,256237980,-1250,9971,11221,5833.163838,2425.510734
Cell 17 NW 2013,9000,4763,255701131.1,-1875,9937,11812,5379.873819,2525.123508
Cell 17 SE 2013,9000,4769,256023240.4,-1875,9784,11659,5670.898931,2575.321875
Cell 17 SW 2013,9000,4776,256399034.6,-1875,9827,11702,5663.374581,2464.856117
Cell 18 2011/12,9000,4774,256291664.9,396,9982,9586,4868.597403,2590.712005
Cell 18 NE 2013,9000,4776,256399034.6,-195,9784,9979,5634.295436,2585.139429
Cell 18 NW 2013,9000,4769,256023240.4,-1875,9827,11702,5301.647935,2706.136063
Cell 18 SE 2013,9000,4764,255754816,-195,9784,9979,5679.233627,2491.38642
Cell 18 SSE 2013,9000,4776,256399034.6,-195,9784,9979,5947.91206,2428.24392
Cell 19 NW 2013,9000,4776,256399034.6,851,9784,8933,6096.704355,2201.520453
Cell 2 2011/12,9000,4773,256237980,-384,9275,9659,6294.607584,1966.419425
Cell 2 NE 2013,9000,4770,256076925.3,-2000,9096,11096,6513.480294,1786.908591
Cell 2 SW 2013,9000,4776,256399034.6,-2000,9230,11230,5951.37165,2201.080493
Cell 20 2013,9000,4780,256613774.2,1090,9773,8683,6045.063598,2117.221326
Cell 21 2013,9000,4783,256774828.9,1320,9401,8081,6906.525193,1453.301308
Cell 22 2013,9000,4774,256291664.9,4359,8938,4579,7857.361961,522.3428744
Cell 23 2013,9000,4775,256345349.7,4359,8938,4579,7976.708272,539.3664534
Cell 24 2013,9000,4775,256345349.7,5452,8939,3487,8102.28377,387.4580418
Cell 25 NE 2013,9000,4760,255540076.4,-779,9915,10694,5235.390756,2823.961046
Cell 25 SE 2013,9000,4775,256345349.7,-779,9961,10740,5308.90178,2824.71634
Cell 26 NE 2013,9000,4777,256452719.5,-195,9971,10166,6000.205568,2378.097686
Cell 26 NNW 2013,9000,4777,256452719.5,-779,9971,10750,5255.055265,2810.345677
Cell 26 NW 2013,9000,4773,256237980,-779,9971,10750,5152.65682,2821.407239
Cell 27 NW 2013,9000,4771,256130610.2,-195,9971,10166,6047.922867,2316.168219
Cell 28 2013,9000,4785,256882198.6,700,9982,9282,4437.798955,2451.118247
Cell 29 2013,9000,4780,256613774.2,1093,9366,8273,6189.522385,2060.505616
Cell 3 NE 2013,9000,4777,256452719.5,-384,9275,9659,6945.420138,1386.824896
Cell 3 NW 2013,9000,4779,256560089.3,-2000,9371,11371,6379.305712,1810.107063
Cell 30 2013,9000,4774,256291664.9,3349,8925,5576,7881.504399,541.7311982
Cell 31 2013,9000,4781,256667459.1,4359,8955,4596,8081.45639,514.9910692
Cell 32 2013,9000,4776,256399034.6,5634,9040,3406,8220.519891,403.0914244
Cell 33 NE 2013,9000,4773,256237980,-1250,9971,11221,5833.163838,2425.510734
Cell 33 SE 2013,9000,4775,256345349.7,-1894,9942,11836,5391.821571,2675.796118
Cell 33 SW 2013,9000,4777,256452719.5,-1894,9981,11875,5189.304794,2708.62929
Cell 34 N 2013,9000,4780,256613774.2,-1894,9982,11876,5958.266946,2357.144061
Cell 34 NW 2013,9000,4778,256506404.4,-1894,9971,11865,6137.350984,2279.199751
Cell 34 SE 2013,9000,4777,256452719.5,-1894,9982,11876,5895.492778,2476.646792
Cell 35 2013,9000,4773,256237980,-10,9982,9992,4800.308192,2612.61101
Cell 37 2013,9000,4772,256184295.1,1465,9341,7876,7562.829003,745.1662594
Cell 38 2013,9000,4784,256828513.8,6199,9040,2841,8173.019231,358.9878266
Cell 39 2013,9000,4785,256882198.6,6375,9040,2665,8236.817764,346.7043468
Cell 4 2013,9000,4774,256291664.9,382,9275,8893,7310.427315,1127.93493
Cell 40 NE 2013,9000,4767,255915870.6,-1894,9942,11836,5057.348857,2705.133388
Cell 41 N 2013,9000,4777,256452719.5,-1894,9844,11738,5700.98116,2494.419217
Cell 41 NW 2013,9000,4775,256345349.7,-1894,9977,11871,5424.588482,2675.877204
Cell 42 NW 2013,9000,4781,256667459.1,-10,9874,9884,6062.477097,2392.654059
Cell 43 2013,9000,4785,256882198.6,834,9683,8849,5685.892372,2404.522953
Cell 44 2013,9000,4780,256613774.2,1211,9341,8130,6821.529498,1761.240007
Cell 45 2013,9000,4778,256506404.4,1682,9040,7358,7789.560486,630.892054
Cell 47 2013,9000,4782,256721144,422,9874,9452,6526.217482,2103.273789
Cell 48 2013,9000,4776,256399034.6,422,9694,9272,6089.328727,2316.360382
Cell 49 2013,9000,4773,256237980,1249,9683,8434,6568.3392,1983.488127
Cell 5 2011/12 Summer,9000,4776,256399034.6,-1875,9827,11702,5663.340243,2464.827828
Cell 5 2013,9000,4778,256506404.4,2251,8869,6618,7877.970699,679.1581217
Cell 50 2013,9000,4781,256667459.1,1369,9040,7671,7018.736248,1707.995907
Cell 51 2013,9000,4788,257043253.3,5785,8935,3150,7995.814119,398.5546581
Cell 52 2013,9000,4778,256506404.4,1274,9383,8109,6621.672457,2080.718796
Cell 53 2013,9000,4775,256345349.7,1387,9157,7770,6896.549529,1854.777959
Cell 54 2013,9000,4780,256613774.2,2166,8961,6795,7830.845188,727.6073188
Cell 55 2013,9000,4777,256452719.5,5785,8961,3176,7912.731421,487.372051
Cell 56 2013,9000,4781,256667459.1,1505,9931,8426,6981.794394,1499.266692
Cell 57 2013,9000,4779,256560089.3,1694,8887,7193,7193.338983,980.2025668
Cell 58 2013,9000,4779,256560089.3,1694,8961,7267,7733.123457,932.0593885
Cell 59 2013,9000,4777,256452719.5,1505,9931,8426,6917.732259,1497.023539
Cell 6 2011/12,9000,4768,255969555.5,1079,9386,8307,5928.318582,2250.814252
Cell 6 2013,9000,4769,256023240.4,5041,9045,4004,8071.416859,471.7893043
Cell 6 NE 2011/12,9000,4765,255808500.8,1025,9386,8361,5947.132424,2190.961953
Cell 6 NW 2011/12,9000,4766,255862185.7,383,9784,9401,5988.276542,2393.85435
Cell 6 SW 2011/12,9000,4771,256130610.2,-195,9784,9979,5606.915112,2593.823049
Cell 60 2013,9000,4783,256774828.9,2116,9136,7020,6999.465398,935.0687947
Cell 61 2013,9000,4774,256291664.9,2116,8887,6771,7380.300168,1062.826094
Cell 7 2013,9000,4786,256935883.5,5313,9137,3824,8129.234434,569.1970975
Cell 9 NW 2013,9000,4768,255969555.5,-1970,9827,11797,5239.558096,2485.552447
Cell 9 SE 2013,9000,4773,256237980,-1875,9827,11702,5002.769327,2520.624497
Cell 9 SW 2013,9000,4773,256237980,-1875,9827,11702,5161.315106,2542.137345
Cell R1,9000,4765,255808500.8,974,9222,8248,5742.229381,1892.167488
Cell R10,9000,4774,256291664.9,382,9275,8893,7310.427315,1127.93493
Cell R100,9000,4780,256613774.2,1369,9040,7671,7018.719456,1708.160331
Cell R101,9000,4779,256560089.3,1454,8935,7481,7626.895585,1004.692614
Cell R104,9000,4773,256237980,1282,9157,7875,6973.548502,1805.848299
Cell R105,9000,4774,256291664.9,1387,9157,7770,6897.601592,1853.54707
Cell R106,9000,4779,256560089.3,1401,9014,7613,7272.107972,1267.609582
Cell R107,9000,4779,256560089.3,2166,8961,6795,7830.819837,727.6813294
Cell R11,9000,4777,256452719.5,2251,8869,6618,7877.906427,679.2146746
Cell R111,9000,4772,256184295.1,1351,9931,8580,6710.919111,1986.07743
Cell R112,9000,4779,256560089.3,1694,9852,8158,7384.232894,868.0004821
Cell R113,9000,4779,256560089.3,1694,8887,7193,7193.338983,980.2025668
Cell R114,9000,4779,256560089.3,1694,8961,7267,7733.123457,932.0593885
Cell R117,9000,4771,256130610.2,1437,9931,8494,6583.681618,1916.003419
Cell R118,9000,4782,256721144,1505,9931,8426,6982.163739,1499.327436
Cell R119,9000,4776,256399034.6,1694,8887,7193,7091.809045,1012.622335
Cell R120,9000,4779,256560089.3,1694,8887,7193,7343.60452,1125.199492
Cell R121,9000,4778,256506404.4,3613,8831,5218,7946.329008,569.6930593
Cell R123,9000,4778,256506404.4,1505,9931,8426,6844.695479,1573.20489
Cell R124,9000,4784,256828513.8,2277,9039,6762,6994.225753,904.9897797
Cell R125,9000,4781,256667459.1,2116,8887,6771,6887.781008,929.0574463
Cell R126,9000,4783,256774828.9,2116,8887,6771,7267.075057,1082.826043
Cell R15,9000,4777,256452719.5,-1970,9672,11642,5759.52669,2199.962881
Cell R16,9000,4763,255701131.1,-1970,9827,11797,5240.82574,2485.744301
Cell R17,9000,4774,256291664.9,383,9386,9003,6057.10243,2303.86537
Cell R18,9000,4784,256828513.8,-384,9275,9659,6448.016095,1881.849695
Cell R19,9000,4771,256130610.2,1326,9768,8442,6490.586041,1759.766842
Cell R20,9000,4780,256613774.2,1422,8848,7426,7292.329916,1157.629907
Cell R21,9000,4779,256560089.3,1422,8838,7416,7446.811467,1251.800074
Cell R22,9000,4781,256667459.1,1423,8938,7515,7763.192428,1021.597833
Cell R24,9000,4762,255647446.2,-1875,9937,11812,5379.162117,2524.910921
Cell R25,9000,4768,255969555.5,-1875,9827,11702,5301.786703,2706.652868
Cell R26,9000,4768,255969555.5,383,9784,9401,5990.213926,2394.028013
Cell R27,9000,4774,256291664.9,851,9784,8933,6096.084416,2201.76881
Cell R28,9000,4774,256291664.9,1090,9773,8683,5641.717218,2277.097311
Cell R29,9000,4779,256560089.3,1090,9773,8683,6044.846621,2117.389687
Cell R30,9000,4773,256237980,1422,8838,7416,7410.625183,1083.717146
Cell R31,9000,4778,256506404.4,2057,8938,6881,7726.253453,811.4361231
Cell R35,9000,4776,256399034.6,-1875,9827,11702,5663.374581,2464.856117
Cell R36,9000,4769,256023240.4,-1875,9784,11659,5670.898931,2575.321875
Cell R37,9000,4764,255754816,-195,9784,9979,5679.233627,2491.38642
Cell R38,9000,4779,256560089.3,628,9388,8760,5420.482946,2452.042474
Cell R39,9000,4773,256237980,1090,9773,8683,6231.44186,2073.964194
Cell R40,9000,4783,256774828.9,1320,9401,8081,6906.525193,1453.301308
Cell R46,9000,4774,256291664.9,-779,9961,10740,5474.715752,2765.832927
Cell R47,9000,4775,256345349.7,-779,9971,10750,5153.66534,2821.252245
Cell R48,9000,4777,256452719.5,-195,9971,10166,6000.205568,2378.097686
Cell R49,9000,4770,256076925.3,-195,9971,10166,6048.817191,2315.587175
Cell R5,9000,4762,255647446.2,-1970,9672,11642,5760.470181,2079.082149
Cell R50,9000,4785,256882198.6,700,9982,9282,4437.798955,2451.118247
Cell R51,9000,4780,256613774.2,1093,9366,8273,6198.838075,2054.908561
Cell R52,9000,4778,256506404.4,2443,8811,6368,7389.566764,717.1778287
Cell R53,9000,4778,256506404.4,2443,8808,6365,7476.501465,694.2629662
Cell R54,9000,4782,256721144,4359,8955,4596,8081.325387,515.0168838
Cell R58,9000,4777,256452719.5,-779,9976,10755,5288.527318,2780.938622
Cell R59,9000,4773,256237980,-1250,9971,11221,5833.163838,2425.510734
Cell R6,9000,4776,256399034.6,-2000,9230,11230,5951.37165,2201.080493
Cell R60,9000,4778,256506404.4,-1894,9971,11865,6137.350984,2279.199751
Cell R61,9000,4774,256291664.9,-10,9982,9992,4800.813155,2612.5703
Cell R62,9000,4778,256506404.4,716,9879,9163,5062.45563,2507.264934
Cell R63,9000,4778,256506404.4,716,9358,8642,5907.845123,2193.099156
Cell R64,9000,4778,256506404.4,3349,9288,5939,7675.91712,575.3529325
Cell R65,9000,4774,256291664.9,3349,8925,5576,7881.504399,541.7311982
Cell R66,9000,4780,256613774.2,5718,9017,3299,8192.330962,360.7000726
Cell R69,9000,4778,256506404.4,-1894,9981,11875,5191.100251,2708.310811
Cell R7,9000,4779,256560089.3,-2000,9371,11371,6379.305712,1810.107063
Cell R70,9000,4776,256399034.6,-1894,9942,11836,5391.606156,2675.557382
Cell R71,9000,4777,256452719.5,-1894,9982,11876,5895.492778,2476.646792
Cell R72,9000,4779,256560089.3,-129,9982,10111,5560.783009,2598.578468
Cell R73,9000,4778,256506404.4,-10,9982,9992,4681.95563,2666.186739
Cell R74,9000,4779,256560089.3,716,9341,8625,6040.048964,2302.398899
Cell R75,9000,4771,256130610.2,1465,9341,7876,7562.867743,745.2395435
Cell R76,9000,4777,256452719.5,6008,9040,3032,8063.950387,374.6803987
Cell R77,9000,4783,256774828.9,6199,9040,2841,8172.952958,358.9960891
Cell R8,9000,4775,256345349.7,-384,9096,9480,6879.600628,1422.714785
Cell R80,9000,4766,255862185.7,-1894,9942,11836,5056.007554,2704.715676
Cell R81,9000,4774,256291664.9,-1894,9977,11871,5634.702974,2594.879809
Cell R82,9000,4779,256560089.3,-10,9874,9884,6063.083072,2392.651737
Cell R83,9000,4779,256560089.3,-10,9874,9884,6170.717305,2325.243118
Cell R84,9000,4780,256613774.2,834,9683,8849,5471.299163,2452.295742
Cell R85,9000,4785,256882198.6,834,9683,8849,5685.892372,2404.522953
Cell R86,9000,4780,256613774.2,1249,9284,8035,7350.789958,1313.432082
Cell R87,9000,4778,256506404.4,1682,9040,7358,7789.560486,630.892054
Cell R9,9000,4773,256237980,-384,9275,9659,7093.654515,1281.273141
Cell R90,9000,4780,256613774.2,422,9874,9452,6526.969665,2102.53672
Cell R91,9000,4777,256452719.5,422,9694,9272,6088.822901,2316.381706
Cell R92,9000,4782,256721144,1032,9683,8651,5668.170431,2324.655807
Cell R93,9000,4773,256237980,1249,9683,8434,6567.305259,1984.285162
Cell R97,9000,4782,256721144,784,9694,8910,6939.105395,1858.703985
Cell R98,9000,4776,256399034.6,1032,9683,8651,6434.695352,2256.735296
Cell R99,9000,4777,256452719.5,1274,9383,8109,6622.276743,2080.517308
Cell S102,9000,4778,256506404.4,5785,8935,3150,7990.659481,415.0860388
Cell S108,9000,4778,256506404.4,5785,8961,3176,7912.578275,487.4359863
Cell S13,9000,4783,256774828.9,5628,9125,3497,8191.2166,439.3725749
Cell S14,9000,4787,256989568.4,5313,9137,3824,8129.251097,569.1388094
Cell S2,9000,4770,256076925.3,5041,9045,4004,8071.40021,471.7412491
Cell S23,9000,4777,256452719.5,5313,9125,3812,8111.792548,506.4690208
Cell S32,9000,4783,256774828.9,5348,8938,3590,7952.783609,455.2784356
Cell S33,9000,4777,256452719.5,5348,8938,3590,8111.454469,472.1204813
Cell S34,9000,4774,256291664.9,5452,8939,3487,8102.162547,387.4080693
Cell S41,9000,4781,256667459.1,2443,8808,6365,7598.439866,641.8599473
Cell S42,9000,4775,256345349.7,4359,8938,4579,7976.708272,539.3664534
Cell S44,9000,4780,256613774.2,5514,8939,3425,8102.95251,424.8785739
Cell S56,9000,4782,256721144,5441,8955,3514,8057.968423,460.2590746
Cell S67,9000,4776,256399034.6,5634,9040,3406,8220.519891,403.0914244
Cell S78,9000,4785,256882198.6,6375,9040,2665,8236.817764,346.7043468
Cell S88,9000,4776,256399034.6,4473,8986,4513,8062.740578,427.3280306
Cell S94,9000,4779,256560089.3,5222,8935,3713,7926.772756,444.2400116
Cell S95,9000,4789,257096938.2,5785,8935,3150,7995.897056,398.5543641
W287,9000,4775,256345349.7,-1891,9904,11795,4525.138639,2164.25366
W295,9000,4777,256452719.5,1134,8991,7857,6748.286791,1937.737857
W338,9000,4765,255808500.8,692,9923,9231,3844.203358,2355.503163
W342,9000,4771,256130610.2,807,8605,7798,5405.542444,2311.42177
W345,9000,4773,256237980,1565,8605,7040,7097.299183,1277.083072
W387,9000,4771,256130610.2,-54,9937,9991,5178.165374,2455.667974
W393,9000,4760,255540076.4,853,9923,9070,5439.433193,2434.042447
W440,9000,4772,256184295.1,1125,9937,8812,5678.655281,2362.230505
W441,9000,4768,255969555.5,1125,8644,7519,6221.6487,1850.343059
W445,9000,4763,255701131.1,1848,8692,6844,6844.495696,1007.534545
W500,9000,4774,256291664.9,1427,8823,7396,6522.860075,1573.001138
1,9250,5043,270732900.3,-2000,9230,11230,5941.865755,2204.260965
2,9250,5044,270786585.2,-384,9386,9770,6301.07157,1975.581275
3,9250,5042,270679215.4,-384,9768,10152,6831.530147,1530.050742
4,9250,5044,270786585.2,1422,9768,8346,7195.566812,1214.695515
5,9250,5045,270840270.1,-1875,9827,11702,5634.778989,2482.784071
6,9250,5041,270625530.5,851,9784,8933,5893.302718,2275.633341
7,9250,5045,270840270.1,1090,9773,8683,5989.754609,2108.867437
8,9250,5046,270893954.9,1422,9773,8351,7260.540824,1170.77618
9,9250,5044,270786585.2,4359,8938,4579,7859.115979,522.5994798
10,9250,5038,270464475.8,-779,9915,10694,5239.38944,2822.223899
11,9250,5041,270625530.5,-195,9971,10166,5996.969451,2380.852438
12,9250,5045,270840270.1,700,9982,9282,4494.236075,2464.476107
13,9250,5046,270893954.9,1093,9366,8273,6168.323226,2081.574326
14,9250,5045,270840270.1,3421,8955,5534,8000.444797,541.4161199
16,9250,5045,270840270.1,-1894,9981,11875,5181.336373,2728.026492
17,9250,5042,270679215.4,-1894,9971,11865,6087.906783,2306.938798
18,9250,5042,270679215.4,396,9982,9586,4891.074177,2585.827063
19,9250,5052,271216064.3,716,9879,9163,5136.703682,2486.852281
20,9250,5042,270679215.4,1366,9341,7975,7528.251488,848.9371388
21,9250,5047,270947639.8,6199,9040,2841,8165.959184,364.1457373
22,9250,5040,270571845.6,-1894,9844,11738,5007.49504,2764.751415
23,9250,5039,270518160.7,-10,9874,9884,6087.01151,2382.36374
24,9250,5045,270840270.1,422,9694,9272,6066.4222,2326.92603
25,9250,5045,270840270.1,1249,9683,8434,6548.002577,2005.86151
26,9250,5047,270947639.8,1648,9040,7392,7776.617198,692.8800343
27,9250,5048,271001324.7,1032,9683,8651,6390.597464,2266.973007
28,9250,5051,271162379.4,1387,9157,7770,6889.049693,1858.56312
29,9250,5046,270893954.9,1353,9040,7687,7023.301427,1712.717297
31,9250,5048,271001324.7,1351,9931,8580,6979.9063,1675.639192
32,9250,5048,271001324.7,1694,8887,7193,7210.642235,967.9124341
33,9250,5050,271108694.5,1505,9931,8426,6964.652871,1516.753391
34,9250,5043,270732900.3,1694,9136,7442,6963.534206,1019.293723
10A,9250,5047,270947639.8,-779,9971,10750,5229.274817,2803.658553
10NE,9250,5042,270679215.4,-779,9971,10750,5293.565054,2802.568073
10NW,9250,5043,270732900.3,-1875,9915,11790,5665.572873,2576.089203
10SW,9250,5042,270679215.4,-779,9961,10740,5283.263189,2828.469419
11NE,9250,5038,270464475.8,-195,9784,9979,5666.05915,2494.644609
11NW,9250,5047,270947639.8,-195,9784,9979,5886.409154,2465.831287
11SE,9250,5042,270679215.4,-195,9971,10166,6026.073185,2327.469146
17NW,9250,5042,270679215.4,-1894,9971,11865,5773.497818,2445.293946
17SE,9250,5044,270786585.2,-1894,9982,11876,5907.008525,2465.529816
17SW,9250,5041,270625530.5,-1894,9971,11865,5397.752827,2666.162217
22S,9250,5048,271001324.7,-1894,9844,11738,4939.85103,2776.710464
23S,9250,5045,270840270.1,981,9773,8792,5070.037661,2371.564618
24S,9250,5044,270786585.2,422,9694,9272,6065.727002,2324.831057
27A,9250,5046,270893954.9,784,9694,8910,6850.926278,1921.043584
2A,9250,5042,270679215.4,-384,9275,9659,6547.329036,1824.331294
5NE,9250,5040,270571845.6,-1875,9827,11702,5056.803373,2526.309948
5NW,9250,5038,270464475.8,-1875,9827,11702,5170.88031,2540.235058
5SE,9250,5046,270893954.9,-1875,9827,11702,5365.932818,2706.068102
6NE,9250,5039,270518160.7,851,9386,8535,5886.642588,2227.266609
6NW,9250,5037,270410790.9,383,9784,9401,5997.716299,2379.513659
6SW,9250,5040,270571845.6,-195,9784,9979,5573.16131,2587.71545
Cell 1 2011/12,9250,5043,270732900.3,-2000,9230,11230,5941.865755,2204.260965
Cell 1 SW 2013,9250,5043,270732900.3,-1970,9672,11642,5771.191354,2187.12787
Cell 10 2011/12,9250,5038,270464475.8,-779,9915,10694,5239.38944,2822.223899
Cell 10 NE 2011/12,9250,5042,270679215.4,-779,9971,10750,5293.565054,2802.568073
Cell 10 NW 2011/12,9250,5043,270732900.3,-1875,9915,11790,5665.572873,2576.089203
Cell 10 SE 2013,9250,5037,270410790.9,383,9784,9401,5997.716299,2379.513659
Cell 10 SW 2011/12,9250,5042,270679215.4,-779,9961,10740,5283.263189,2828.469419
Cell 10-A 2011/12,9250,5047,270947639.8,-779,9971,10750,5229.274817,2803.658553
Cell 11 NE 2011/12,9250,5038,270464475.8,-195,9784,9979,5666.05915,2494.644609
Cell 11 NW 2013,9250,5045,270840270.1,-384,9275,9659,6434.91774,1900.068602
Cell 11 SW 2013,9250,5040,270571845.6,771,9386,8615,5976.444048,2241.517428
Cell 12 2013,9250,5042,270679215.4,1090,9773,8683,5989.853035,2109.559761
Cell 13 2013,9250,5039,270518160.7,1422,9773,8351,7249.708672,1172.670978
Cell 14 2013,9250,5049,271055009.6,1422,8938,7516,7745.696574,1046.724872
Cell 15 2013,9250,5049,271055009.6,5348,8938,3590,8100.925332,498.8556917
Cell 15-A 2013,9250,5047,270947639.8,5348,8941,3593,8111.26174,478.1324986
Cell 16 2013,9250,5046,270893954.9,5452,8942,3490,8117.428656,405.9121225
Cell 17 NW 2011/12,9250,5042,270679215.4,-1894,9971,11865,5773.497818,2445.293946
Cell 17 NW 2013,9250,5038,270464475.8,-1875,9937,11812,5366.710996,2530.32855
Cell 17 SE 2013,9250,5042,270679215.4,-1875,9915,11790,5665.352241,2576.29701
Cell 17 SW 2013,9250,5043,270732900.3,-1875,9827,11702,5642.500892,2478.380087
Cell 18 2011/12,9250,5042,270679215.4,396,9982,9586,4891.074177,2585.827063
Cell 18 NE 2013,9250,5043,270732900.3,-195,9784,9979,5588.212175,2582.972151
Cell 18 NW 2013,9250,5038,270464475.8,-1875,9827,11702,5352.947201,2699.818927
Cell 18 SE 2013,9250,5038,270464475.8,-195,9784,9979,5666.05915,2494.644609
Cell 18 SSE 2013,9250,5041,270625530.5,-195,9784,9979,5939.100774,2425.336476
Cell 19 NW 2013,9250,5043,270732900.3,851,9784,8933,6076.868729,2208.959068
Cell 2 2011/12,9250,5044,270786585.2,-384,9386,9770,6301.07157,1975.581275
Cell 2 NE 2013,9250,5040,270571845.6,-2000,9096,11096,6511.185119,1789.631402
Cell 2 SW 2013,9250,5043,270732900.3,-2000,9230,11230,5941.547095,2204.678893
Cell 20 2013,9250,5047,270947639.8,1090,9773,8683,6015.802853,2129.200127
Cell 21 2013,9250,5044,270786585.2,1320,9401,8081,6876.303132,1495.186077
Cell 22 2013,9250,5045,270840270.1,4359,8938,4579,7857.400793,519.482693
Cell 23 2013,9250,5042,270679215.4,4359,8939,4580,7975.440698,534.8927982
Cell 24 2013,9250,5049,271055009.6,5452,8939,3487,8102.223411,392.8420142
Cell 25 NE 2013,9250,5038,270464475.8,-779,9915,10694,5239.38944,2822.223899
Cell 25 SE 2013,9250,5042,270679215.4,-779,9961,10740,5283.263189,2828.469419
Cell 26 NE 2013,9250,5041,270625530.5,-195,9971,10166,5996.969451,2380.852438
Cell 26 NNW 2013,9250,5042,270679215.4,-779,9971,10750,5293.565054,2802.568073
Cell 26 NW 2013,9250,5048,271001324.7,-779,9971,10750,5229.100436,2803.408212
Cell 27 NW 2013,9250,5040,270571845.6,-195,9971,10166,6026.247421,2327.799573
Cell 28 2013,9250,5045,270840270.1,700,9982,9282,4494.236075,2464.476107
Cell 29 2013,9250,5046,270893954.9,1093,9366,8273,6169.239992,2081.407072
Cell 3 NE 2013,9250,5041,270625530.5,-384,9275,9659,6930.113866,1406.391951
Cell 3 NW 2013,9250,5044,270786585.2,-2000,9371,11371,6377.363799,1824.900888
Cell 30 2013,9250,5044,270786585.2,3349,8925,5576,7875.894925,547.5811547
Cell 31 2013,9250,5049,271055009.6,4359,8955,4596,8078.345613,511.052325
Cell 32 2013,9250,5053,271269749.2,5634,9040,3406,8221.182664,401.368832
Cell 33 NE 2013,9250,5042,270679215.4,-1894,9971,11865,5773.497818,2445.293946
Cell 33 SE 2013,9250,5041,270625530.5,-1894,9971,11865,5397.752827,2666.162217
Cell 33 SW 2013,9250,5043,270732900.3,-1894,9981,11875,5178.155661,2713.586535
Cell 34 N 2013,9250,5043,270732900.3,-1894,9982,11876,5918.975411,2378.930901
Cell 34 NW 2013,9250,5041,270625530.5,-1894,9971,11865,6087.4146,2306.902894
Cell 34 SE 2013,9250,5046,270893954.9,-1894,9982,11876,5908.042806,2464.994586
Cell 35 2013,9250,5043,270732900.3,-10,9982,9992,4829.463216,2604.970935
Cell 37 2013,9250,5045,270840270.1,1366,9341,7975,7539.032706,828.0837434
Cell 38 2013,9250,5051,271162379.4,6199,9040,2841,8170.077806,362.6387826
Cell 39 2013,9250,5047,270947639.8,6375,9040,2665,8231.17872,348.7011323
Cell 4 2013,9250,5043,270732900.3,382,9275,8893,7282.125719,1183.424607
Cell 40 NE 2013,9250,5038,270464475.8,-1894,9942,11836,5108.860857,2708.264454
Cell 41 N 2013,9250,5047,270947639.8,-1894,9844,11738,5655.017634,2506.869949
Cell 41 NW 2013,9250,5044,270786585.2,-1894,9977,11871,5379.086043,2704.6702
Cell 42 NW 2013,9250,5048,271001324.7,-10,9874,9884,6058.421949,2394.055855
Cell 43 2013,9250,5045,270840270.1,834,9683,8849,5700.553617,2406.901421
Cell 44 2013,9250,5050,271108694.5,1211,9341,8130,6767.997822,1812.475686
Cell 45 2013,9250,5046,270893954.9,1648,9040,7392,7777.413595,693.1504481
Cell 47 2013,9250,5044,270786585.2,422,9874,9452,6471.476606,2142.733918
Cell 48 2013,9250,5044,270786585.2,422,9694,9272,6063.364195,2324.969781
Cell 49 2013,9250,5046,270893954.9,1249,9683,8434,6547.569362,2005.898766
Cell 5 2011/12 Summer,9250,5042,270679215.4,-1875,9827,11702,5642.907576,2478.45759
Cell 5 2013,9250,5044,270786585.2,2251,8869,6618,7872.77498,701.0463384
Cell 50 2013,9250,5047,270947639.8,1353,9040,7687,7023.422033,1712.568996
Cell 51 2013,9250,5050,271108694.5,5785,8935,3150,7996.273663,397.7648342
Cell 52 2013,9250,5042,270679215.4,1274,9383,8109,6581.586275,2106.255487
Cell 53 2013,9250,5050,271108694.5,1387,9157,7770,6889.020594,1858.805369
Cell 54 2013,9250,5048,271001324.7,2166,8961,6795,7817.518819,737.6005086
Cell 55 2013,9250,5050,271108694.5,5785,8961,3176,7909.908515,487.0757194
Cell 56 2013,9250,5050,271108694.5,1505,9931,8426,6963.205941,1517.167868
Cell 57 2013,9250,5050,271108694.5,1694,8887,7193,7210.076238,967.7885142
Cell 58 2013,9250,5047,270947639.8,1694,8961,7267,7727.792352,918.2924746
Cell 59 2013,9250,5042,270679215.4,1505,9931,8426,6908.433955,1497.388534
Cell 6 2011/12,9250,5041,270625530.5,851,9784,8933,5893.302718,2275.633341
Cell 6 2013,9250,5046,270893954.9,5041,9045,4004,8065.51526,478.0638067
Cell 6 NE 2011/12,9250,5039,270518160.7,851,9386,8535,5886.642588,2227.266609
Cell 6 NW 2011/12,9250,5037,270410790.9,383,9784,9401,5997.716299,2379.513659
Cell 6 SW 2011/12,9250,5040,270571845.6,-195,9784,9979,5573.16131,2587.71545
Cell 60 2013,9250,5051,271162379.4,1941,9136,7195,7005.180756,943.8040468
Cell 61 2013,9250,5052,271216064.3,2116,8887,6771,7378.06829,1075.395856
Cell 7 2013,9250,5045,270840270.1,5313,9137,3824,8129.321506,567.0262974
Cell 9 NW 2013,9250,5037,270410790.9,-1970,9827,11797,5259.215009,2492.436545
Cell 9 SE 2013,9250,5040,270571845.6,-1875,9827,11702,5056.803373,2526.309948
Cell 9 SW 2013,9250,5041,270625530.5,-1875,9827,11702,5171.793493,2540.113762
Cell R1,9250,5047,270947639.8,881,9222,8341,5751.471369,1889.423771
Cell R10,9250,5043,270732900.3,382,9275,8893,7282.048186,1183.398307
Cell R100,9250,5047,270947639.8,1353,9040,7687,7023.422033,1712.568996
Cell R101,9250,5047,270947639.8,1454,8935,7481,7591.054488,1085.307185
Cell R104,9250,5048,271001324.7,1282,9157,7875,6966.080824,1818.163571
Cell R105,9250,5052,271216064.3,1387,9157,7770,6889.127474,1858.387389
Cell R106,9250,5045,270840270.1,1401,9069,7668,7278.252329,1272.088685
Cell R107,9250,5048,271001324.7,2166,8961,6795,7817.460182,737.5993551
Cell R11,9250,5044,270786585.2,2251,8869,6618,7872.734933,701.0209603
Cell R111,9250,5050,271108694.5,1351,9931,8580,6728.659802,1973.561076
Cell R112,9250,5045,270840270.1,1694,9931,8237,7365.865213,906.598796
Cell R113,9250,5050,271108694.5,1694,8887,7193,7210.076238,967.7885142
Cell R114,9250,5046,270893954.9,1694,8961,7267,7727.787554,918.3833989
Cell R117,9250,5043,270732900.3,1437,9931,8494,6578.174896,1914.983905
Cell R118,9250,5050,271108694.5,1505,9931,8426,6963.205941,1517.167868
Cell R119,9250,5048,271001324.7,1694,8887,7193,7104.120246,1010.118891
Cell R120,9250,5050,271108694.5,1694,8887,7193,7344.09802,1136.605882
Cell R121,9250,5052,271216064.3,3613,8831,5218,7934.978622,584.1862318
Cell R123,9250,5051,271162379.4,1505,9931,8426,6831.076025,1586.255003
Cell R124,9250,5051,271162379.4,2277,9136,6859,7006.529598,904.378174
Cell R125,9250,5046,270893954.9,2116,8887,6771,6906.42172,917.600974
Cell R126,9250,5047,270947639.8,2116,8887,6771,7285.965722,1078.490471
Cell R15,9250,5042,270679215.4,-1970,9672,11642,5771.824673,2186.882336
Cell R16,9250,5039,270518160.7,-1970,9827,11797,5261.275055,2492.164365
Cell R17,9250,5042,270679215.4,383,9386,9003,6061.586077,2287.757539
Cell R18,9250,5046,270893954.9,-384,9275,9659,6447.234443,1893.570259
Cell R19,9250,5039,270518160.7,1326,9768,8442,6483.549712,1770.253592
Cell R20,9250,5045,270840270.1,1422,8848,7426,7304.346283,1151.73869
Cell R21,9250,5046,270893954.9,1422,8838,7416,7462.638922,1230.377002
Cell R22,9250,5049,271055009.6,1422,8938,7516,7745.696574,1046.724872
Cell R24,9250,5037,270410790.9,-1875,9937,11812,5367.184435,2530.364221
Cell R25,9250,5037,270410790.9,-1875,9827,11702,5352.886837,2700.083513
Cell R26,9250,5044,270786585.2,383,9784,9401,5997.999405,2376.738571
Cell R27,9250,5042,270679215.4,851,9784,8933,6076.92146,2209.17494
Cell R28,9250,5046,270893954.9,1090,9773,8683,5633.612366,2267.779002
Cell R29,9250,5046,270893954.9,1090,9773,8683,6015.507134,2129.307459
Cell R30,9250,5046,270893954.9,1422,8838,7416,7414.299445,1077.744664
Cell R31,9250,5051,271162379.4,1848,8938,7090,7719.020788,848.720707
Cell R35,9250,5042,270679215.4,-1875,9827,11702,5642.907576,2478.45759
Cell R36,9250,5043,270732900.3,-1875,9915,11790,5665.572873,2576.089203
Cell R37,9250,5038,270464475.8,-195,9784,9979,5666.05915,2494.644609
Cell R38,9250,5041,270625530.5,108,9388,9280,5390.688951,2461.290349
Cell R39,9250,5042,270679215.4,1090,9773,8683,6199.389726,2090.484845
Cell R40,9250,5044,270786585.2,1320,9401,8081,6875.028549,1496.960836
Cell R46,9250,5046,270893954.9,-779,9961,10740,5474.063417,2755.73012
Cell R47,9250,5048,271001324.7,-779,9971,10750,5229.100436,2803.408212
Cell R48,9250,5041,270625530.5,-195,9971,10166,5996.969451,2380.852438
Cell R49,9250,5039,270518160.7,-195,9971,10166,6026.160746,2328.022408
Cell R5,9250,5035,270303421.1,-1970,9672,11642,5738.74856,2092.629242
Cell R50,9250,5045,270840270.1,700,9982,9282,4494.236075,2464.476107
Cell R51,9250,5047,270947639.8,1093,9366,8273,6172.658015,2080.790344
Cell R52,9250,5043,270732900.3,2443,8811,6368,7394.168749,714.6836748
Cell R53,9250,5044,270786585.2,2443,8808,6365,7481.15682,693.0605392
Cell R54,9250,5050,271108694.5,4359,8955,4596,8078.343168,511.0017528
Cell R58,9250,5043,270732900.3,-779,9976,10755,5304.514178,2774.5435
Cell R59,9250,5042,270679215.4,-1894,9971,11865,5773.497818,2445.293946
Cell R6,9250,5042,270679215.4,-2000,9230,11230,5941.49405,2204.894296
Cell R60,9250,5041,270625530.5,-1894,9971,11865,6087.4146,2306.902894
Cell R61,9250,5039,270518160.7,-10,9982,9992,4828.24747,2605.182016
Cell R62,9250,5044,270786585.2,716,9879,9163,5134.736717,2495.069734
Cell R63,9250,5047,270947639.8,716,9358,8642,5887.761244,2220.017552
Cell R64,9250,5046,270893954.9,3349,9341,5992,7686.139318,576.9189749
Cell R65,9250,5044,270786585.2,3349,8925,5576,7875.894925,547.5811547
Cell R66,9250,5047,270947639.8,5610,9040,3430,8182.859124,367.217027
Cell R69,9250,5043,270732900.3,-1894,9981,11875,5178.155661,2713.586535
Cell R7,9250,5045,270840270.1,-2000,9371,11371,6377.553419,1824.769712
Cell R70,9250,5041,270625530.5,-1894,9971,11865,5397.752827,2666.162217
Cell R71,9250,5046,270893954.9,-1894,9982,11876,5908.042806,2464.994586
Cell R72,9250,5043,270732900.3,-573,9982,10555,5544.406504,2601.659082
Cell R73,9250,5051,271162379.4,-10,9982,9992,4686.52643,2658.052121
Cell R74,9250,5045,270840270.1,716,9348,8632,6043.458672,2296.33362
Cell R75,9250,5047,270947639.8,1366,9341,7975,7539.1809,827.970168
Cell R76,9250,5050,271108694.5,6008,9040,3032,8061.113861,381.2364947
Cell R77,9250,5052,271216064.3,6199,9040,2841,8170.06829,362.603521
Cell R8,9250,5044,270786585.2,-384,9189,9573,6872.175258,1439.256435
Cell R80,9250,5041,270625530.5,-1894,9942,11836,5107.069827,2709.019801
Cell R81,9250,5042,270679215.4,-1894,9977,11871,5604.624752,2601.875143
Cell R82,9250,5048,271001324.7,-10,9874,9884,6058.421949,2394.055855
Cell R83,9250,5043,270732900.3,-10,9874,9884,6178.95816,2316.449585
Cell R84,9250,5046,270893954.9,834,9683,8849,5493.757035,2449.910532
Cell R85,9250,5044,270786585.2,834,9683,8849,5700.068398,2406.893266
Cell R86,9250,5046,270893954.9,1249,9284,8035,7336.01962,1370.322351
Cell R87,9250,5045,270840270.1,1648,9040,7392,7777.353617,693.2060489
Cell R9,9250,5036,270357106,-384,9275,9659,7071.612391,1313.112339
Cell R90,9250,5044,270786585.2,422,9874,9452,6471.476606,2142.733918
Cell R91,9250,5044,270786585.2,422,9694,9272,6062.661578,2324.992148
Cell R92,9250,5044,270786585.2,1032,9683,8651,5738.718477,2305.552343
Cell R93,9250,5045,270840270.1,1249,9683,8434,6547.250743,2005.969877
Cell R97,9250,5048,271001324.7,784,9694,8910,6930.73851,1864.706182
Cell R98,9250,5048,271001324.7,1032,9683,8651,6390.597464,2266.973007
Cell R99,9250,5042,270679215.4,1274,9383,8109,6581.586275,2106.255487
Cell S102,9250,5048,271001324.7,5785,8935,3150,7987.516838,414.8305476
Cell S108,9250,5049,271055009.6,5785,8961,3176,7909.857001,487.1101966
Cell S13,9250,5049,271055009.6,5628,9125,3497,8189.663102,440.9005759
Cell S14,9250,5044,270786585.2,5313,9137,3824,8129.312252,567.0821216
Cell S2,9250,5046,270893954.9,5041,9045,4004,8065.51526,478.0638067
Cell S23,9250,5048,271001324.7,5313,9125,3812,8110.334588,510.7605613
Cell S32,9250,5047,270947639.8,4888,8938,4050,7950.258173,466.6323356
Cell S33,9250,5047,270947639.8,5348,8941,3593,8111.26174,478.1324986
Cell S34,9250,5048,271001324.7,5452,8939,3487,8102.271395,392.8661278
Cell S41,9250,5047,270947639.8,2443,8808,6365,7582.767585,661.8136171
Cell S42,9250,5041,270625530.5,4359,8939,4580,7975.382662,534.9299766
Cell S44,9250,5046,270893954.9,4887,8939,4052,8096.524178,431.0063427
Cell S56,9250,5050,271108694.5,5441,8955,3514,8056.907921,462.2487321
Cell S67,9250,5052,271216064.3,5634,9040,3406,8221.165875,401.4067797
Cell S78,9250,5047,270947639.8,6375,9040,2665,8231.161284,348.7000407
Cell S88,9250,5054,271323434.1,4473,8986,4513,8058.068461,425.2235736
Cell S94,9250,5050,271108694.5,5222,8935,3713,7919.427129,448.7835033
Cell S95,9250,5049,271055009.6,5785,8935,3150,7996.164587,397.7286971
W287,9250,5041,270625530.5,-1891,9904,11795,4568.664154,2180.771275
W295,9250,5042,270679215.4,984,8991,8007,6717.733836,1970.346952
W338,9250,5035,270303421.1,692,9923,9231,3895.606554,2360.282854
W342,9250,5037,270410790.9,807,8605,7798,5427.896565,2311.362859
W345,9250,5042,270679215.4,1482,8605,7123,7070.093812,1315.597885
W387,9250,5036,270357106,-54,9937,9991,5205.47915,2444.980438
W393,9250,5038,270464475.8,853,9923,9070,5424.876737,2434.355597
W440,9250,5045,270840270.1,1125,9937,8812,5633.540139,2376.852215
W441,9250,5037,270410790.9,1125,8644,7519,6192.588446,1866.953043
W445,9250,5035,270303421.1,1848,8692,6844,6842.091758,1015.061515
W500,9250,5039,270518160.7,1427,8823,7396,6545.635642,1554.397601
1,9500,5319,285549929.9,-2000,9230,11230,5934.256063,2204.748277
2,9500,5319,285549929.9,-384,9386,9770,6307.650122,1980.431074
3,9500,5316,285388875.2,-384,9768,10152,6825.327878,1544.27589
4,9500,5317,285442560.1,1422,9768,8346,7177.134098,1260.549622
5,9500,5315,285335190.3,-1875,9827,11702,5625.698589,2494.582855
6,9500,5317,285442560.1,851,9784,8933,5867.999624,2297.427091
7,9500,5323,285764669.5,1090,9773,8683,5988.420252,2111.426329
8,9500,5317,285442560.1,1422,9773,8351,7283.697386,1157.02374
9,9500,5317,285442560.1,4359,8938,4579,7853.833177,525.816538
10,9500,5318,285496245,-779,9915,10694,5248.042121,2819.254637
11,9500,5323,285764669.5,-195,9971,10166,5984.628029,2385.526367
12,9500,5319,285549929.9,700,9982,9282,4555.630006,2478.404288
13,9500,5323,285764669.5,1093,9401,8308,6147.751268,2100.547099
14,9500,5321,285657299.7,3421,8955,5534,7996.853975,544.9320749
16,9500,5321,285657299.7,-1894,9981,11875,5163.248637,2734.582748
17,9500,5316,285388875.2,-1894,9971,11865,6022.383747,2341.936402
18,9500,5321,285657299.7,192,9982,9790,4897.996805,2580.991779
19,9500,5322,285710984.6,716,9982,9266,5212.759301,2478.844552
20,9500,5322,285710984.6,1342,9341,7999,7494.139045,945.290442
21,9500,5322,285710984.6,6199,9040,2841,8163.513153,365.8256864
22,9500,5319,285549929.9,-1894,9844,11738,5044.961647,2762.840872
23,9500,5325,285872039.2,-10,9874,9884,6081.556995,2384.532511
24,9500,5319,285549929.9,422,9694,9272,6054.105847,2332.534029
25,9500,5330,286140463.7,1249,9683,8434,6537.773358,2022.996292
26,9500,5326,285925724.1,1648,9040,7392,7770.255727,736.2129736
27,9500,5320,285603614.8,1032,9683,8651,6348.301128,2279.284385
28,9500,5322,285710984.6,1367,9157,7790,6892.11631,1853.785832
29,9500,5321,285657299.7,1353,9383,8030,7023.73426,1721.854964
31,9500,5320,285603614.8,1351,9931,8580,6960.028195,1689.774464
32,9500,5324,285818354.4,1694,8887,7193,7230.152329,958.4376373
33,9500,5323,285764669.5,1505,9931,8426,6949.183731,1523.575695
34,9500,5324,285818354.4,1694,9136,7442,6976.178062,1016.122948
10A,9500,5318,285496245,-779,9971,10750,5299.55754,2789.5157
10NE,9500,5316,285388875.2,-779,9971,10750,5328.495297,2790.754102
10NW,9500,5321,285657299.7,-1875,9915,11790,5653.1838,2575.668213
10SW,9500,5323,285764669.5,-779,9961,10740,5267.518505,2829.739509
11NE,9500,5318,285496245,-195,9784,9979,5638.04701,2506.088253
11NW,9500,5312,285174135.7,-195,9784,9979,5884.403991,2461.845846
11SE,9500,5321,285657299.7,-195,9971,10166,6003.231347,2333.817477
17NW,9500,5322,285710984.6,-1894,9971,11865,5716.226231,2466.852019
17SE,9500,5318,285496245,-1894,9982,11876,5906.556036,2458.283253
17SW,9500,5324,285818354.4,-1894,9971,11865,5405.944591,2652.075918
22S,9500,5321,285657299.7,-1894,9844,11738,4995.261229,2776.516712
23S,9500,5320,285603614.8,981,9773,8792,5141.294361,2365.009921
24S,9500,5324,285818354.4,422,9694,9272,6056.369083,2329.466946
27A,9500,5318,285496245,784,9694,8910,6858.774163,1915.631309
2A,9500,5314,285281505.5,-384,9275,9659,6548.624577,1831.522482
5NE,9500,5318,285496245,-1875,9827,11702,5113.797856,2526.251495
5NW,9500,5318,285496245,-1875,9827,11702,5170.907108,2538.172135
5SE,9500,5316,285388875.2,-1875,9827,11702,5407.897291,2695.279491
6NE,9500,5325,285872039.2,851,9386,8535,5850.765446,2246.284436
6NW,9500,5320,285603614.8,383,9784,9401,5998.141917,2360.105332
6SW,9500,5318,285496245,-195,9784,9979,5540.094772,2585.180244
Cell 1 2011/12,9500,5319,285549929.9,-2000,9230,11230,5934.256063,2204.748277
Cell 1 SW 2013,9500,5317,285442560.1,-1970,9827,11797,5780.044198,2179.933103
Cell 10 2011/12,9500,5318,285496245,-779,9915,10694,5248.042121,2819.254637
Cell 10 NE 2011/12,9500,5316,285388875.2,-779,9971,10750,5328.495297,2790.754102
Cell 10 NW 2011/12,9500,5321,285657299.7,-1875,9915,11790,5653.1838,2575.668213
Cell 10 SE 2013,9500,5321,285657299.7,383,9784,9401,5998.215937,2359.889725
Cell 10 SW 2011/12,9500,5323,285764669.5,-779,9961,10740,5267.518505,2829.739509
Cell 10-A 2011/12,9500,5318,285496245,-779,9971,10750,5299.55754,2789.5157
Cell 11 NE 2011/12,9500,5318,285496245,-195,9784,9979,5638.04701,2506.088253
Cell 11 NW 2013,9500,5312,285174135.7,-384,9386,9770,6433.084149,1907.994576
Cell 11 SW 2013,9500,5315,285335190.3,771,9386,8615,5950.283349,2257.724995
Cell 12 2013,9500,5322,285710984.6,1090,9773,8683,5986.7236,2111.197517
Cell 13 2013,9500,5317,285442560.1,1422,9773,8351,7268.409253,1162.938606
Cell 14 2013,9500,5318,285496245,1422,8938,7516,7723.217375,1079.282328
Cell 15 2013,9500,5325,285872039.2,5348,8938,3590,8103.770141,498.9208626
Cell 15-A 2013,9500,5322,285710984.6,5348,8942,3594,8113.494175,478.8878644
Cell 16 2013,9500,5327,285979409,5452,8942,3490,8120.831049,408.5595928
Cell 17 NW 2011/12,9500,5322,285710984.6,-1894,9971,11865,5716.226231,2466.852019
Cell 17 NW 2013,9500,5316,285388875.2,-1875,9937,11812,5359.296464,2533.935277
Cell 17 SE 2013,9500,5321,285657299.7,-1875,9915,11790,5653.1838,2575.668213
Cell 17 SW 2013,9500,5315,285335190.3,-1875,9827,11702,5632.19285,2494.05239
Cell 18 2011/12,9500,5321,285657299.7,192,9982,9790,4897.996805,2580.991779
Cell 18 NE 2013,9500,5316,285388875.2,-195,9784,9979,5540.504891,2584.154263
Cell 18 NW 2013,9500,5319,285549929.9,-1875,9827,11702,5403.799774,2691.459354
Cell 18 SE 2013,9500,5318,285496245,-195,9784,9979,5638.04701,2506.088253
Cell 18 SSE 2013,9500,5318,285496245,-195,9784,9979,5920.839789,2433.660438
Cell 19 NW 2013,9500,5317,285442560.1,851,9784,8933,6040.93455,2218.208765
Cell 2 2011/12,9500,5319,285549929.9,-384,9386,9770,6307.650122,1980.431074
Cell 2 NE 2013,9500,5320,285603614.8,-2000,9096,11096,6501.825188,1797.630178
Cell 2 SW 2013,9500,5318,285496245,-2000,9230,11230,5936.032719,2204.358278
Cell 20 2013,9500,5314,285281505.5,1090,9773,8683,5995.769853,2139.897632
Cell 21 2013,9500,5319,285549929.9,1210,9715,8505,6843.083474,1546.480821
Cell 22 2013,9500,5320,285603614.8,4359,8938,4579,7857,517.8866036
Cell 23 2013,9500,5330,286140463.7,4359,8939,4580,7974.436023,529.7479617
Cell 24 2013,9500,5324,285818354.4,5452,8939,3487,8103.723328,396.8094717
Cell 25 NE 2013,9500,5318,285496245,-779,9915,10694,5248.042121,2819.254637
Cell 25 SE 2013,9500,5323,285764669.5,-779,9961,10740,5267.518505,2829.739509
Cell 26 NE 2013,9500,5323,285764669.5,-195,9971,10166,5984.628029,2385.526367
Cell 26 NNW 2013,9500,5317,285442560.1,-779,9971,10750,5328.871544,2790.62649
Cell 26 NW 2013,9500,5318,285496245,-779,9971,10750,5299.55754,2789.5157
Cell 27 NW 2013,9500,5322,285710984.6,-195,9971,10166,6003.705374,2333.85437
Cell 28 2013,9500,5320,285603614.8,700,9982,9282,4556.226316,2478.552919
Cell 29 2013,9500,5319,285549929.9,1093,9401,8308,6146.43354,2101.964025
Cell 3 NE 2013,9500,5312,285174135.7,-384,9275,9659,6921.429029,1417.763161
Cell 3 NW 2013,9500,5318,285496245,-2000,9371,11371,6368.088191,1847.478449
Cell 30 2013,9500,5322,285710984.6,3349,8925,5576,7871.174934,550.8474074
Cell 31 2013,9500,5323,285764669.5,4359,8955,4596,8075.634792,508.1289001
Cell 32 2013,9500,5322,285710984.6,5634,9040,3406,8219.692221,401.6110168
Cell 33 NE 2013,9500,5321,285657299.7,-1894,9971,11865,5717.055441,2466.342065
Cell 33 SE 2013,9500,5322,285710984.6,-1894,9971,11865,5407.022548,2651.988605
Cell 33 SW 2013,9500,5315,285335190.3,-1894,9981,11875,5170.231797,2719.034938
Cell 34 N 2013,9500,5315,285335190.3,-1894,9982,11876,5885.476388,2396.476574
Cell 34 NW 2013,9500,5316,285388875.2,-1894,9971,11865,6022.383747,2341.936402
Cell 34 SE 2013,9500,5319,285549929.9,-1894,9982,11876,5904.822335,2459.35323
Cell 35 2013,9500,5325,285872039.2,-10,9982,9992,4857.184038,2597.615561
Cell 37 2013,9500,5324,285818354.4,1342,9341,7999,7500.048272,934.7921384
Cell 38 2013,9500,5324,285818354.4,6199,9040,2841,8166.595605,365.3162808
Cell 39 2013,9500,5320,285603614.8,5560,9040,3480,8223.180827,355.8719383
Cell 4 2013,9500,5324,285818354.4,382,9275,8893,7259.840346,1231.323701
Cell 40 NE 2013,9500,5325,285872039.2,-1894,9942,11836,5159.629296,2712.065864
Cell 41 N 2013,9500,5321,285657299.7,-1894,9844,11738,5611.247698,2531.944134
Cell 41 NW 2013,9500,5321,285657299.7,-1894,9977,11871,5327.308964,2718.75237
Cell 42 NW 2013,9500,5320,285603614.8,-10,9874,9884,6049.72688,2398.328578
Cell 43 2013,9500,5328,286033093.9,834,9683,8849,5718.827703,2403.164778
Cell 44 2013,9500,5325,285872039.2,1159,9341,8182,6718.142723,1858.249256
Cell 45 2013,9500,5327,285979409,1648,9040,7392,7771.462362,734.0429484
Cell 47 2013,9500,5316,285388875.2,422,9874,9452,6426.399925,2171.252638
Cell 48 2013,9500,5321,285657299.7,422,9694,9272,6056.984589,2328.496436
Cell 49 2013,9500,5329,286086778.8,1249,9683,8434,6537.468005,2023.063271
Cell 5 2011/12 Summer,9500,5315,285335190.3,-1875,9827,11702,5632.19285,2494.05239
Cell 5 2013,9500,5320,285603614.8,2251,8869,6618,7861.312406,748.0747544
Cell 50 2013,9500,5321,285657299.7,1353,9383,8030,7023.73426,1721.854964
Cell 51 2013,9500,5330,286140463.7,5785,8935,3150,7996.927205,397.0970906
Cell 52 2013,9500,5322,285710984.6,1273,9383,8110,6542.740511,2132.11031
Cell 53 2013,9500,5322,285710984.6,1367,9157,7790,6892.11631,1853.785832
Cell 54 2013,9500,5323,285764669.5,2166,8961,6795,7802.880331,757.9894677
Cell 55 2013,9500,5324,285818354.4,5785,8961,3176,7908.642374,487.7640114
Cell 56 2013,9500,5324,285818354.4,1505,9931,8426,6948.344102,1523.894901
Cell 57 2013,9500,5324,285818354.4,1694,8887,7193,7230.117956,958.4251079
Cell 58 2013,9500,5323,285764669.5,1694,8961,7267,7723.757655,910.5573685
Cell 59 2013,9500,5326,285925724.1,1505,9931,8426,6907.26887,1489.202052
Cell 6 2011/12,9500,5317,285442560.1,851,9784,8933,5867.999624,2297.427091
Cell 6 2013,9500,5320,285603614.8,4987,9045,4058,8064.715226,478.7265496
Cell 6 NE 2011/12,9500,5325,285872039.2,851,9386,8535,5850.765446,2246.284436
Cell 6 NW 2011/12,9500,5320,285603614.8,383,9784,9401,5998.141917,2360.105332
Cell 6 SW 2011/12,9500,5318,285496245,-195,9784,9979,5540.094772,2585.180244
Cell 60 2013,9500,5322,285710984.6,1941,9136,7195,6997.963548,966.135485
Cell 61 2013,9500,5321,285657299.7,2116,8887,6771,7387.031009,1072.080871
Cell 7 2013,9500,5329,286086778.8,5313,9137,3824,8129.763746,561.9403092
Cell 9 NW 2013,9500,5321,285657299.7,-1970,9827,11797,5275.955835,2489.165076
Cell 9 SE 2013,9500,5317,285442560.1,-1875,9827,11702,5113.397969,2526.320745
Cell 9 SW 2013,9500,5319,285549929.9,-1875,9827,11702,5172.141192,2537.568392
Cell R1,9500,5324,285818354.4,881,9222,8341,5765.862885,1882.135408
Cell R10,9500,5324,285818354.4,382,9275,8893,7259.840346,1231.323701
Cell R100,9500,5321,285657299.7,1353,9383,8030,7023.73426,1721.854964
Cell R101,9500,5328,286033093.9,1401,8935,7534,7555.060248,1167.679043
Cell R104,9500,5326,285925724.1,1282,9157,7875,6953.809613,1831.454527
Cell R105,9500,5322,285710984.6,1367,9157,7790,6892.11631,1853.785832
Cell R106,9500,5324,285818354.4,1401,9069,7668,7279.021976,1289.763
Cell R107,9500,5323,285764669.5,2166,8961,6795,7802.880331,757.9894677
Cell R11,9500,5320,285603614.8,2251,8869,6618,7861.312406,748.0747544
Cell R111,9500,5324,285818354.4,1351,9931,8580,6738.546018,1970.666974
Cell R112,9500,5321,285657299.7,1694,9931,8237,7342.512874,952.5677704
Cell R113,9500,5323,285764669.5,1694,8887,7193,7230.06951,958.5086121
Cell R114,9500,5323,285764669.5,1694,8961,7267,7723.757655,910.5573685
Cell R117,9500,5324,285818354.4,1437,9931,8494,6576.052404,1911.077848
Cell R118,9500,5324,285818354.4,1505,9931,8426,6948.344102,1523.894901
Cell R119,9500,5327,285979409,1694,8887,7193,7116.599775,1001.681583
Cell R120,9500,5334,286355203.3,1694,8887,7193,7353.18204,1136.887609
Cell R121,9500,5323,285764669.5,2116,8831,6715,7928.887094,593.6150899
Cell R123,9500,5322,285710984.6,1505,9931,8426,6823.868095,1592.85791
Cell R124,9500,5323,285764669.5,2116,9136,7020,7015.02724,913.6966882
Cell R125,9500,5325,285872039.2,2116,8887,6771,6920.62385,909.8140651
Cell R126,9500,5321,285657299.7,1941,8887,6946,7300.378312,1080.960242
Cell R15,9500,5318,285496245,-1970,9827,11797,5779.921587,2179.746471
Cell R16,9500,5315,285335190.3,-1970,9827,11797,5277.492944,2489.056194
Cell R17,9500,5317,285442560.1,383,9386,9003,6073.254091,2263.250817
Cell R18,9500,5320,285603614.8,-384,9386,9770,6442.576316,1902.284136
Cell R19,9500,5322,285710984.6,1326,9768,8442,6466.149192,1783.702037
Cell R20,9500,5316,285388875.2,1422,8848,7426,7316.473664,1147.116243
Cell R21,9500,5314,285281505.5,1422,8838,7416,7477.168423,1213.490653
Cell R22,9500,5318,285496245,1422,8938,7516,7723.104175,1079.25497
Cell R24,9500,5316,285388875.2,-1875,9937,11812,5359.07374,2534.255919
Cell R25,9500,5317,285442560.1,-1875,9827,11702,5402.859507,2691.525712
Cell R26,9500,5322,285710984.6,-1020,9784,10804,5997.079669,2358.324854
Cell R27,9500,5317,285442560.1,851,9784,8933,6040.342298,2218.141518
Cell R28,9500,5319,285549929.9,1090,9773,8683,5631.064862,2260.460202
Cell R29,9500,5315,285335190.3,1090,9773,8683,5996.945626,2139.379113
Cell R30,9500,5320,285603614.8,1422,8838,7416,7413.47594,1076.766307
Cell R31,9500,5322,285710984.6,1676,8938,7262,7712.044908,880.4460331
Cell R35,9500,5317,285442560.1,-1875,9827,11702,5632.623848,2493.731132
Cell R36,9500,5321,285657299.7,-1875,9915,11790,5653.1838,2575.668213
Cell R37,9500,5318,285496245,-195,9784,9979,5638.04701,2506.088253
Cell R38,9500,5323,285764669.5,-195,9388,9583,5359.976705,2472.248844
Cell R39,9500,5323,285764669.5,1090,9773,8683,6177.609431,2098.041915
Cell R40,9500,5318,285496245,1210,9715,8505,6842.888116,1546.560586
Cell R46,9500,5312,285174135.7,-779,9961,10740,5480.368976,2747.298846
Cell R47,9500,5319,285549929.9,-779,9971,10750,5300.157736,2789.596858
Cell R48,9500,5323,285764669.5,-195,9971,10166,5984.628029,2385.526367
Cell R49,9500,5321,285657299.7,-195,9971,10166,6003.231347,2333.817477
Cell R5,9500,5316,285388875.2,-1970,9672,11642,5712.259217,2101.780118
Cell R50,9500,5320,285603614.8,700,9982,9282,4556.226316,2478.552919
Cell R51,9500,5320,285603614.8,1093,9401,8308,6158.019737,2096.169635
Cell R52,9500,5319,285549929.9,2443,8811,6368,7395.955631,722.911271
Cell R53,9500,5320,285603614.8,2443,8808,6365,7483.309962,692.9146607
Cell R54,9500,5323,285764669.5,4359,8955,4596,8075.634792,508.1289001
Cell R58,9500,5316,285388875.2,-779,9976,10755,5309.70316,2767.031379
Cell R59,9500,5322,285710984.6,-1894,9971,11865,5716.226231,2466.852019
Cell R6,9500,5316,285388875.2,-2000,9230,11230,5935.329007,2204.469733
Cell R60,9500,5316,285388875.2,-1894,9971,11865,6022.383747,2341.936402
Cell R61,9500,5327,285979409,-10,9982,9992,4858.07828,2597.628566
Cell R62,9500,5319,285549929.9,716,9982,9266,5203.888137,2484.907452
Cell R63,9500,5319,285549929.9,716,9358,8642,5859.455349,2249.829937
Cell R64,9500,5322,285710984.6,3061,9341,6280,7695.961856,582.5399447
Cell R65,9500,5322,285710984.6,3349,8925,5576,7871.032131,550.8743949
Cell R66,9500,5328,286033093.9,5610,9040,3430,8172.706081,371.348334
Cell R69,9500,5315,285335190.3,-1894,9981,11875,5169.326623,2719.398537
Cell R7,9500,5318,285496245,-2000,9371,11371,6368.088191,1847.478449
Cell R70,9500,5322,285710984.6,-1894,9971,11865,5407.022548,2651.988605
Cell R71,9500,5317,285442560.1,-1894,9982,11876,5904.313523,2459.654498
Cell R72,9500,5314,285281505.5,-573,9982,10555,5519.867143,2610.809651
Cell R73,9500,5321,285657299.7,-10,9982,9992,4691.930276,2647.61833
Cell R74,9500,5322,285710984.6,716,9348,8632,6057.033258,2292.978113
Cell R75,9500,5324,285818354.4,1342,9341,7999,7500.048272,934.7921384
Cell R76,9500,5327,285979409,6008,9040,3032,8057.191665,386.7405722
Cell R77,9500,5325,285872039.2,6199,9040,2841,8166.600376,365.2821431
Cell R8,9500,5316,285388875.2,-1502,9275,10777,6869.636005,1461.889232
Cell R80,9500,5324,285818354.4,-1894,9942,11836,5159.543764,2712.406617
Cell R81,9500,5323,285764669.5,-1894,9977,11871,5582.560586,2611.854338
Cell R82,9500,5320,285603614.8,-10,9874,9884,6049.72688,2398.328578
Cell R83,9500,5318,285496245,-10,9874,9884,6176.091952,2319.819724
Cell R84,9500,5320,285603614.8,834,9683,8849,5507.717481,2449.284216
Cell R85,9500,5328,286033093.9,834,9683,8849,5718.827703,2403.164778
Cell R86,9500,5320,285603614.8,1249,9284,8035,7320.006579,1421.451894
Cell R87,9500,5327,285979409,1648,9040,7392,7771.462362,734.0429484
Cell R9,9500,5325,285872039.2,-384,9275,9659,7044.813146,1351.179223
Cell R90,9500,5316,285388875.2,422,9874,9452,6426.399925,2171.252638
Cell R91,9500,5322,285710984.6,422,9694,9272,6056.781097,2328.324982
Cell R92,9500,5318,285496245,1032,9683,8651,5807.466529,2285.595881
Cell R93,9500,5328,286033093.9,1249,9683,8434,6537.35229,2023.23548
Cell R97,9500,5319,285549929.9,784,9694,8910,6914.836247,1879.549525
Cell R98,9500,5320,285603614.8,1032,9683,8651,6349.415414,2278.394527
Cell R99,9500,5323,285764669.5,1273,9383,8110,6541.854969,2132.888603
Cell S102,9500,5326,285925724.1,5785,8935,3150,7982.911566,417.6765462
Cell S108,9500,5323,285764669.5,5785,8961,3176,7908.531467,487.7426978
Cell S13,9500,5321,285657299.7,5584,9137,3553,8185.49314,445.8722654
Cell S14,9500,5327,285979409,5313,9137,3824,8129.883612,562.0107382
Cell S2,9500,5320,285603614.8,4987,9045,4058,8064.715226,478.7265496
Cell S23,9500,5321,285657299.7,5313,9125,3812,8107.829355,515.1353798
Cell S32,9500,5319,285549929.9,4888,8938,4050,7945.57774,477.9648487
Cell S33,9500,5322,285710984.6,5348,8942,3594,8113.494175,478.8878644
Cell S34,9500,5324,285818354.4,5452,8939,3487,8103.723328,396.8094717
Cell S41,9500,5317,285442560.1,2443,8808,6365,7569.43107,684.3671352
Cell S42,9500,5330,286140463.7,4359,8939,4580,7974.397936,529.7432825
Cell S44,9500,5321,285657299.7,4549,8939,4390,8091.765646,437.5860133
Cell S56,9500,5322,285710984.6,5441,8982,3541,8058.708192,464.1019472
Cell S67,9500,5323,285764669.5,5634,9040,3406,8219.667105,401.5774709
Cell S78,9500,5321,285657299.7,5560,9040,3480,8223.051682,355.8144086
Cell S88,9500,5323,285764669.5,4473,8986,4513,8054.899493,422.9211684
Cell S94,9500,5325,285872039.2,5222,8935,3713,7911.829296,458.0191295
Cell S95,9500,5332,286247833.5,5785,8935,3150,7997.098275,397.1219979
W287,9500,5314,285281505.5,-1891,9904,11795,4606.543658,2195.339768
W295,9500,5316,285388875.2,984,8991,8007,6692.441309,1998.629698
W338,9500,5318,285496245,692,9923,9231,3950.084242,2358.891298
W342,9500,5321,285657299.7,807,8605,7798,5439.860928,2310.077048
W345,9500,5316,285388875.2,1427,8605,7178,7046.484763,1352.763467
W387,9500,5316,285388875.2,-54,9937,9991,5236.708051,2435.163317
W393,9500,5315,285335190.3,853,9923,9070,5411.924741,2438.024488
W440,9500,5312,285174135.7,1125,9937,8812,5595.121423,2385.999526
W441,9500,5313,285227820.6,1125,8644,7519,6165.65368,1882.230192
W445,9500,5317,285442560.1,1848,8692,6844,6829.74873,1033.108554
W500,9500,5311,285120450.8,1427,8823,7396,6568.65562,1540.736251
1,9750,5601,300689068.9,-2000,9230,11230,5937.316729,2200.879694
2,9750,5602,300742753.8,-384,9386,9770,6310.149232,1984.017426
3,9750,5605,300903808.4,-384,9768,10152,6822.4876,1551.804278
4,9750,5604,300850123.6,1373,9768,8395,7169.422912,1294.20871
5,9750,5604,300850123.6,-1875,9827,11702,5619.977516,2500.349906
6,9750,5596,300420644.4,851,9784,8933,5841.210686,2316.0914
7,9750,5601,300689068.9,1090,9773,8683,5994.347616,2110.301714
8,9750,5611,301225917.8,1422,9773,8351,7303.478524,1144.537035
9,9750,5612,301279602.7,4359,8938,4579,7847.420884,530.9443593
10,9750,5597,300474329.3,-779,9971,10750,5258.555655,2815.89989
11,9750,5596,300420644.4,-195,9971,10166,5967.255718,2394.748015
12,9750,5594,300313274.7,700,9982,9282,4619.843404,2485.731608
13,9750,5601,300689068.9,1029,9401,8372,6134.006785,2121.01857
14,9750,5610,301172232.9,3421,8955,5534,7992.617825,544.874784
16,9750,5596,300420644.4,-1894,9981,11875,5149.530915,2741.027964
17,9750,5601,300689068.9,-1894,9971,11865,5949.638993,2381.107649
18,9750,5606,300957493.3,-10,9982,9992,4907.108098,2575.782167
19,9750,5605,300903808.4,716,9982,9266,5289.065834,2472.01414
20,9750,5605,300903808.4,1342,9341,7999,7448.596075,1064.051597
21,9750,5608,301064863.1,6199,9040,2841,8158.628566,370.0102775
22,9750,5600,300635384,-1894,9844,11738,5082.267679,2761.57741
23,9750,5613,301333287.6,-204,9874,10078,6071.254944,2389.396787
24,9750,5603,300796438.7,422,9694,9272,6044.460825,2337.688677
25,9750,5612,301279602.7,1249,9683,8434,6533.902174,2033.270863
26,9750,5609,301118548,1627,9284,7657,7761.744518,780.8534242
27,9750,5611,301225917.8,1032,9683,8651,6317.881126,2279.457615
28,9750,5611,301225917.8,1367,9383,8016,6889.981287,1857.484897
29,9750,5605,300903808.5,1316,9383,8067,7023.772168,1732.295583
31,9750,5606,300957493.3,1351,9931,8580,6936.794328,1704.690724
32,9750,5611,301225917.8,1694,8887,7193,7250.186598,945.111755
33,9750,5602,300742753.8,1505,9931,8426,6918.989647,1546.357636
34,9750,5611,301225917.8,1694,9136,7442,6987.087685,1012.313009
10A,9750,5597,300474329.3,-779,9971,10750,5360.123816,2770.048232
10NE,9750,5599,300581699.1,-779,9971,10750,5357.203072,2776.63275
10NW,9750,5608,301064863.1,-1875,9915,11790,5631.359486,2578.899231
10SW,9750,5596,300420644.4,-779,9961,10740,5263.483738,2823.344986
11NE,9750,5607,301011178.2,-195,9784,9979,5621.107366,2520.386286
11NW,9750,5599,300581699.1,-195,9784,9979,5886.492409,2459.112283
11SE,9750,5603,300796438.7,-195,9971,10166,5963.369445,2348.382645
17NW,9750,5601,300689068.9,-1894,9971,11865,5671.717372,2487.71456
17SE,9750,5605,300903808.5,-1894,9982,11876,5898.031579,2455.896614
17SW,9750,5596,300420644.4,-1894,9971,11865,5419.0495,2640.84684
22S,9750,5608,301064863.1,-1894,9844,11738,5055.169044,2772.292052
23S,9750,5592,300205904.9,981,9773,8792,5212.380901,2358.955085
24S,9750,5609,301118548,422,9694,9272,6038.395792,2337.368315
27A,9750,5602,300742753.8,784,9694,8910,6854.286148,1919.645406
2A,9750,5601,300689068.9,-384,9275,9659,6545.084449,1837.976074
5NE,9750,5601,300689068.9,-1875,9827,11702,5157.673451,2524.720376
5NW,9750,5601,300689068.9,-1875,9827,11702,5173.225138,2537.893902
5SE,9750,5599,300581699.1,-1875,9827,11702,5454.574031,2681.554913
6NE,9750,5606,300957493.3,771,9386,8615,5823.835355,2263.60718
6NW,9750,5606,300957493.3,-1084,9784,10868,5982.737603,2360.557197
6SW,9750,5607,301011178.2,-195,9784,9979,5527.306581,2584.880044
Cell 1 2011/12,9750,5601,300689068.9,-2000,9230,11230,5937.316729,2200.879694
Cell 1 SW 2013,9750,5595,300366959.5,-1970,9827,11797,5777.951028,2177.315465
Cell 10 2011/12,9750,5597,300474329.3,-779,9971,10750,5258.555655,2815.89989
Cell 10 NE 2011/12,9750,5599,300581699.1,-779,9971,10750,5357.203072,2776.63275
Cell 10 NW 2011/12,9750,5608,301064863.1,-1875,9915,11790,5631.359486,2578.899231
Cell 10 SE 2013,9750,5605,300903808.4,-1084,9784,10868,5983.115789,2360.59794
Cell 10 SW 2011/12,9750,5596,300420644.4,-779,9961,10740,5263.483738,2823.344986
Cell 10-A 2011/12,9750,5597,300474329.3,-779,9971,10750,5360.123816,2770.048232
Cell 11 NE 2011/12,9750,5607,301011178.2,-195,9784,9979,5621.107366,2520.386286
Cell 11 NW 2013,9750,5605,300903808.5,-384,9386,9770,6436.854237,1906.049504
Cell 11 SW 2013,9750,5602,300742753.8,585,9784,9199,5911.590146,2275.279167
Cell 12 2013,9750,5603,300796438.7,1090,9773,8683,5993.833839,2110.573929
Cell 13 2013,9750,5608,301064863.1,1422,9773,8351,7281.349144,1160.757795
Cell 14 2013,9750,5603,300796438.7,1422,8938,7516,7702.558451,1108.053457
Cell 15 2013,9750,5609,301118548,5348,8938,3590,8102.100731,498.8366791
Cell 15-A 2013,9750,5615,301440657.4,5348,8942,3594,8116.577026,479.2768474
Cell 16 2013,9750,5610,301172232.9,5452,8942,3490,8122.110517,410.9171546
Cell 17 NW 2011/12,9750,5601,300689068.9,-1894,9971,11865,5671.717372,2487.71456
Cell 17 NW 2013,9750,5605,300903808.5,-1875,9937,11812,5345.517038,2534.942285
Cell 17 SE 2013,9750,5607,301011178.2,-1875,9915,11790,5630.740681,2578.885822
Cell 17 SW 2013,9750,5595,300366959.5,-1875,9827,11702,5624.686506,2499.255974
Cell 18 2011/12,9750,5606,300957493.3,-10,9982,9992,4907.108098,2575.782167
Cell 18 NE 2013,9750,5600,300635384,-195,9784,9979,5509.625,2582.312541
Cell 18 NW 2013,9750,5602,300742753.8,-1875,9827,11702,5452.919315,2679.898074
Cell 18 SE 2013,9750,5606,300957493.3,-195,9784,9979,5621.734035,2520.174243
Cell 18 SSE 2013,9750,5600,300635384,-195,9784,9979,5908.58625,2443.03049
Cell 19 NW 2013,9750,5603,300796438.7,851,9784,8933,5986.278065,2235.198732
Cell 2 2011/12,9750,5602,300742753.8,-384,9386,9770,6310.149232,1984.017426
Cell 2 NE 2013,9750,5608,301064863.1,-2000,9096,11096,6495.49679,1801.630476
Cell 2 SW 2013,9750,5604,300850123.6,-2000,9230,11230,5935.529265,2201.46361
Cell 20 2013,9750,5606,300957493.3,1090,9773,8683,5985.713343,2146.355124
Cell 21 2013,9750,5603,300796438.7,1210,9764,8554,6823.501339,1587.589539
Cell 22 2013,9750,5612,301279602.7,4359,8938,4579,7856.447969,519.9313366
Cell 23 2013,9750,5613,301333287.6,4359,8939,4580,7975.708177,524.0903414
Cell 24 2013,9750,5612,301279602.7,5452,8939,3487,8103.50588,402.6521672
Cell 25 NE 2013,9750,5596,300420644.4,-779,9971,10750,5258.521801,2816.15034
Cell 25 SE 2013,9750,5596,300420644.4,-779,9961,10740,5263.483738,2823.344986
Cell 26 NE 2013,9750,5596,300420644.4,-195,9971,10166,5967.255718,2394.748015
Cell 26 NNW 2013,9750,5598,300528014.2,-779,9971,10750,5356.598785,2776.51258
Cell 26 NW 2013,9750,5597,300474329.3,-779,9971,10750,5360.123816,2770.048232
Cell 27 NW 2013,9750,5602,300742753.8,-195,9971,10166,5963.957515,2348.179685
Cell 28 2013,9750,5593,300259589.8,700,9982,9282,4620.295906,2485.723428
Cell 29 2013,9750,5601,300689068.9,1029,9401,8372,6134.835565,2120.924773
Cell 3 NE 2013,9750,5602,300742753.8,-384,9275,9659,6912.735452,1436.022981
Cell 3 NW 2013,9750,5608,301064863.1,-2000,9371,11371,6357.475571,1871.944396
Cell 30 2013,9750,5609,301118548,3349,8925,5576,7866.198253,555.613055
Cell 31 2013,9750,5601,300689068.9,4359,8955,4596,8071.101589,506.7597979
Cell 32 2013,9750,5612,301279602.7,5441,9040,3599,8217.308268,403.7032884
Cell 33 NE 2013,9750,5600,300635384,-1894,9971,11865,5671.31625,2487.755548
Cell 33 SE 2013,9750,5594,300313274.7,-1894,9971,11865,5418.675188,2641.121685
Cell 33 SW 2013,9750,5602,300742753.8,-1894,9981,11875,5156.301856,2730.370406
Cell 34 N 2013,9750,5602,300742753.8,-1894,9982,11876,5864.200286,2397.354341
Cell 34 NW 2013,9750,5602,300742753.8,-1894,9971,11865,5948.858265,2381.611969
Cell 34 SE 2013,9750,5604,300850123.6,-1894,9982,11876,5895.319772,2456.194983
Cell 35 2013,9750,5611,301225917.8,-10,9982,9992,4883.765282,2589.765448
Cell 37 2013,9750,5606,300957493.3,1342,9341,7999,7461.761862,1038.000106
Cell 38 2013,9750,5603,300796438.7,6199,9040,2841,8162.860253,367.8682228
Cell 39 2013,9750,5610,301172232.9,5560,9040,3480,8213.472906,366.7472181
Cell 4 2013,9750,5609,301118548,382,9275,8893,7242.045463,1276.559342
Cell 40 NE 2013,9750,5609,301118548,-1894,9942,11836,5207.247638,2713.909841
Cell 41 N 2013,9750,5597,300474329.3,-1894,9977,11871,5562.519207,2558.442385
Cell 41 NW 2013,9750,5602,300742753.8,-1894,9977,11871,5270.381292,2733.404296
Cell 42 NW 2013,9750,5598,300528014.2,-10,9874,9884,6040.213826,2407.197396
Cell 43 2013,9750,5598,300528014.2,834,9683,8849,5746.693819,2394.278171
Cell 44 2013,9750,5601,300689068.9,1159,9341,8182,6682.768256,1891.767944
Cell 45 2013,9750,5609,301118548,1627,9284,7657,7762.083794,781.0065547
Cell 47 2013,9750,5605,300903808.5,422,9874,9452,6397.194291,2189.61184
Cell 48 2013,9750,5606,300957493.3,422,9694,9272,6036.424188,2337.873578
Cell 49 2013,9750,5613,301333287.6,1249,9683,8434,6533.213433,2033.744329
Cell 5 2011/12 Summer,9750,5596,300420644.4,-1875,9827,11702,5625.135633,2499.258453
Cell 5 2013,9750,5607,301011178.2,2197,8869,6672,7852.792224,784.0709016
Cell 50 2013,9750,5605,300903808.5,1316,9383,8067,7023.772168,1732.295583
Cell 51 2013,9750,5596,300420644.4,5785,8935,3150,7998.19228,395.6873759
Cell 52 2013,9750,5607,301011178.2,1259,9383,8124,6515.009988,2152.016862
Cell 53 2013,9750,5612,301279602.7,1367,9383,8016,6890.238418,1857.419264
Cell 54 2013,9750,5610,301172232.9,1694,8961,7267,7793.450267,769.2027436
Cell 55 2013,9750,5615,301440657.3,5785,8961,3176,7908.100089,488.3538416
Cell 56 2013,9750,5600,300635384,1505,9931,8426,6917.015536,1548.276699
Cell 57 2013,9750,5609,301118548,1694,8887,7193,7249.947763,945.2107746
Cell 58 2013,9750,5612,301279602.7,1694,8961,7267,7718.467569,909.6216537
Cell 59 2013,9750,5614,301386972.5,1505,9931,8426,6895.015497,1491.816464
Cell 6 2011/12,9750,5596,300420644.4,851,9784,8933,5841.210686,2316.0914
Cell 6 2013,9750,5601,300689068.9,4772,9045,4273,8063.319407,482.1039024
Cell 6 NE 2011/12,9750,5606,300957493.3,771,9386,8615,5823.835355,2263.60718
Cell 6 NW 2011/12,9750,5606,300957493.3,-1084,9784,10868,5982.737603,2360.557197
Cell 6 SW 2011/12,9750,5607,301011178.2,-195,9784,9979,5527.306581,2584.880044
Cell 60 2013,9750,5605,300903808.5,1694,9136,7442,6994.874219,982.4183827
Cell 61 2013,9750,5608,301064863.1,2116,8887,6771,7396.416548,1068.937485
Cell 7 2013,9750,5599,300581699.1,5313,9137,3824,8130.687087,556.003653
Cell 9 NW 2013,9750,5597,300474329.3,-1970,9827,11797,5301.628372,2488.820103
Cell 9 SE 2013,9750,5601,300689068.9,-1875,9827,11702,5157.673451,2524.720376
Cell 9 SW 2013,9750,5599,300581699.1,-1875,9827,11702,5171.68673,2537.249912
Cell R1,9750,5617,301548027.1,881,9222,8341,5777.611002,1878.183257
Cell R10,9750,5610,301172232.9,382,9275,8893,7241.722816,1276.674263
Cell R100,9750,5605,300903808.5,1316,9383,8067,7023.772168,1732.295583
Cell R101,9750,5607,301011178.2,1401,8935,7534,7529.575709,1219.324889
Cell R104,9750,5613,301333287.6,1282,9365,8083,6936.265633,1851.783431
Cell R105,9750,5613,301333287.6,1367,9383,8016,6890.402993,1857.294721
Cell R106,9750,5604,300850123.6,1401,9069,7668,7278.259279,1304.31277
Cell R107,9750,5610,301172232.9,1694,8961,7267,7793.450267,769.2027436
Cell R11,9750,5607,301011178.2,2197,8869,6672,7852.617086,784.2055164
Cell R111,9750,5613,301333287.6,1351,9931,8580,6752.249955,1962.08564
Cell R112,9750,5610,301172232.9,1694,9931,8237,7320.089483,1003.397168
Cell R113,9750,5610,301172232.9,1694,8887,7193,7249.92139,945.1285912
Cell R114,9750,5612,301279602.7,1694,8961,7267,7718.467569,909.6216537
Cell R117,9750,5609,301118548,1437,9931,8494,6578.955429,1901.572296
Cell R118,9750,5599,300581699.1,1505,9931,8426,6917.108591,1548.399298
Cell R119,9750,5611,301225917.8,1694,8892,7198,7130.245233,997.9536893
Cell R120,9750,5619,301655396.9,1694,8887,7193,7363.272646,1131.365496
Cell R121,9750,5616,301494342.2,2116,8831,6715,7923.4375,599.3748046
Cell R123,9750,5610,301172232.9,1505,9931,8426,6812.990731,1597.169292
Cell R124,9750,5603,300796438.7,2116,9136,7020,7013.394432,920.0775282
Cell R125,9750,5599,300581699.1,2116,8887,6771,6933.445794,905.9322287
Cell R126,9750,5604,300850123.6,1941,8887,6946,7318.079051,1076.616771
Cell R15,9750,5595,300366959.5,-1970,9827,11797,5777.951028,2177.315465
Cell R16,9750,5596,300420644.4,-1970,9827,11797,5304.619728,2489.235631
Cell R17,9750,5597,300474329.3,383,9386,9003,6083.289083,2243.014393
Cell R18,9750,5592,300205904.9,-384,9386,9770,6448.35372,1899.056725
Cell R19,9750,5603,300796438.7,382,9768,9386,6449.996966,1796.976474
Cell R20,9750,5605,300903808.4,1422,8848,7426,7332.956824,1139.928526
Cell R21,9750,5606,300957493.3,1422,8838,7416,7486.271138,1197.442654
Cell R22,9750,5603,300796438.7,1422,8938,7516,7702.583616,1108.054886
Cell R24,9750,5605,300903808.5,-1875,9937,11812,5345.517038,2534.942285
Cell R25,9750,5602,300742753.8,-1875,9827,11702,5452.919315,2679.898074
Cell R26,9750,5606,300957493.3,-1084,9784,10868,5976.692829,2363.21716
Cell R27,9750,5603,300796438.7,851,9784,8933,5985.642334,2235.406052
Cell R28,9750,5608,301064863.1,1090,9773,8683,5634.140157,2254.83401
Cell R29,9750,5606,300957493.3,1090,9773,8683,5985.713343,2146.355124
Cell R30,9750,5611,301225917.8,1422,8838,7416,7416.105329,1073.632701
Cell R31,9750,5602,300742753.8,1676,8938,7262,7702.869689,913.5215069
Cell R35,9750,5595,300366959.5,-1875,9827,11702,5624.686506,2499.255974
Cell R36,9750,5607,301011178.2,-1875,9915,11790,5631.836633,2578.881662
Cell R37,9750,5607,301011178.2,-195,9784,9979,5621.076155,2520.361365
Cell R38,9750,5596,300420644.4,-195,9388,9583,5327.462116,2484.968615
Cell R39,9750,5600,300635384,1090,9773,8683,6159.421786,2101.12026
Cell R40,9750,5605,300903808.5,1210,9764,8554,6821.891169,1589.658754
Cell R46,9750,5601,300689068.9,-779,9961,10740,5475.499197,2740.141568
Cell R47,9750,5597,300474329.3,-779,9971,10750,5360.123816,2770.048232
Cell R48,9750,5596,300420644.4,-195,9971,10166,5967.255718,2394.748015
Cell R49,9750,5601,300689068.9,-195,9971,10166,5964.740046,2347.658808
Cell R5,9750,5604,300850123.6,-1970,9672,11642,5698.45182,2109.975149
Cell R50,9750,5592,300205904.9,700,9982,9282,4620.569385,2485.861539
Cell R51,9750,5601,300689068.9,1029,9401,8372,6140.449563,2118.45644
Cell R52,9750,5603,300796438.7,2443,8811,6368,7387.327325,749.1643116
Cell R53,9750,5607,301011178.2,2443,8808,6365,7488.109506,688.7978588
Cell R54,9750,5600,300635384,4359,8955,4596,8071.075714,506.8013428
Cell R58,9750,5603,300796438.7,-1250,9976,11226,5323.541317,2760.542247
Cell R59,9750,5602,300742753.8,-1894,9971,11865,5671.154945,2488.009662
Cell R6,9750,5604,300850123.6,-2000,9230,11230,5935.750357,2201.616144
Cell R60,9750,5601,300689068.9,-1894,9971,11865,5949.51955,2381.310252
Cell R61,9750,5609,301118548,-10,9982,9992,4884.153503,2590.001575
Cell R62,9750,5601,300689068.9,716,9982,9266,5273.646135,2476.405012
Cell R63,9750,5605,300903808.5,716,9358,8642,5834.897056,2277.352991
Cell R64,9750,5613,301333287.6,2320,9341,7021,7695.927133,608.9098938
Cell R65,9750,5609,301118548,3349,8925,5576,7866.198253,555.613055
Cell R66,9750,5598,300528014.2,5610,9040,3430,8161.937478,377.5990722
Cell R69,9750,5601,300689068.9,-1894,9981,11875,5157.197822,2729.790564
Cell R7,9750,5607,301011178.2,-2000,9371,11371,6358.063492,1871.593538
Cell R70,9750,5596,300420644.4,-1894,9971,11865,5419.0495,2640.84684
Cell R71,9750,5602,300742753.8,-1894,9982,11876,5895.614066,2455.73294
Cell R72,9750,5604,300850123.6,-782,9982,10764,5494.913276,2618.922072
Cell R73,9750,5599,300581699.1,-10,9982,9992,4703.895696,2643.926333
Cell R74,9750,5607,301011178.2,716,9348,8632,6063.382201,2291.992421
Cell R75,9750,5606,300957493.3,1342,9341,7999,7461.761862,1038.000106
Cell R76,9750,5603,300796438.7,6008,9040,3032,8052.30216,391.9651054
Cell R77,9750,5601,300689068.9,6199,9040,2841,8162.747902,367.8843421
Cell R8,9750,5609,301118548,-1502,9275,10777,6872.481369,1474.205236
Cell R80,9750,5609,301118548,-1894,9942,11836,5207.247638,2713.909841
Cell R81,9750,5603,300796438.7,-1894,9977,11871,5569.319115,2610.955633
Cell R82,9750,5598,300528014.2,-10,9874,9884,6040.213826,2407.197396
Cell R83,9750,5602,300742753.8,-10,9874,9884,6162.779543,2330.417753
Cell R84,9750,5609,301118548,651,9683,9032,5523.368871,2451.263385
Cell R85,9750,5596,300420644.4,834,9683,8849,5745.955325,2394.382002
Cell R86,9750,5609,301118548,1249,9284,8035,7302.203601,1462.575201
Cell R87,9750,5610,301172232.9,1627,9284,7657,7762.11533,780.9405146
Cell R9,9750,5610,301172232.9,-384,9275,9659,7027.14902,1378.008027
Cell R90,9750,5605,300903808.5,422,9874,9452,6397.194291,2189.61184
Cell R91,9750,5606,300957493.3,422,9694,9272,6036.424188,2337.873578
Cell R92,9750,5602,300742753.8,1032,9683,8651,5864.495002,2266.413192
Cell R93,9750,5613,301333287.6,1249,9683,8434,6533.213433,2033.744329
Cell R97,9750,5598,300528014.2,784,9694,8910,6898.974455,1891.645924
Cell R98,9750,5612,301279602.7,1032,9683,8651,6318.374198,2279.161454
Cell R99,9750,5608,301064863.1,1259,9383,8124,6515.16423,2151.855979
Cell S102,9750,5609,301118548,5785,8935,3150,7982.423783,417.013833
Cell S108,9750,5615,301440657.3,5785,8961,3176,7908.100089,488.3538416
Cell S13,9750,5605,300903808.5,5584,9137,3553,8173.31686,456.0549303
Cell S14,9750,5599,300581699.1,5313,9137,3824,8130.687087,556.003653
Cell S2,9750,5601,300689068.9,4772,9045,4273,8063.319407,482.1039024
Cell S23,9750,5613,301333287.6,5313,9125,3812,8106.997328,515.9905215
Cell S32,9750,5607,301011178.2,4888,8938,4050,7939.876048,490.0702673
Cell S33,9750,5615,301440657.4,5348,8942,3594,8116.577026,479.2768474
Cell S34,9750,5610,301172232.9,5452,8939,3487,8103.487166,402.6703334
Cell S41,9750,5606,300957493.3,2443,8808,6365,7559.604709,702.1416171
Cell S42,9750,5612,301279602.7,4359,8939,4580,7975.745545,524.1295562
Cell S44,9750,5604,300850123.6,4549,8939,4390,8083.548001,447.5188176
Cell S56,9750,5604,300850123.6,5441,8982,3541,8062.390971,466.3568437
Cell S67,9750,5612,301279602.7,5441,9040,3599,8217.308268,403.7032884
Cell S78,9750,5610,301172232.9,5560,9040,3480,8213.472906,366.7472181
Cell S88,9750,5613,301333287.6,4473,8986,4513,8051.16444,422.8664334
Cell S94,9750,5615,301440657.4,5222,8935,3713,7904.226002,462.9477706
Cell S95,9750,5595,300366959.6,5785,8935,3150,7998.147096,395.7082992
W287,9750,5597,300474329.3,-1891,9904,11795,4640.419332,2213.344501
W295,9750,5604,300850123.6,-1851,8991,10842,6670.337794,2027.12628
W338,9750,5604,300850123.6,692,9923,9231,4003.929872,2358.619496
W342,9750,5611,301225917.8,807,8705,7898,5465.995901,2305.729759
W345,9750,5604,300850123.6,1427,8605,7178,7027.553355,1378.606295
W387,9750,5597,300474329.3,-54,9937,9991,5259.171878,2428.065128
W393,9750,5595,300366959.6,853,9923,9070,5396.900983,2444.16652
W440,9750,5596,300420644.4,1125,9937,8812,5552.29664,2394.143735
W441,9750,5604,300850123.6,1125,9047,7922,6149.221806,1891.77176
W445,9750,5604,300850123.6,1848,8692,6844,6824.799251,1043.045469
W500,9750,5600,300635384,1427,8823,7396,6594.512143,1527.01744
1,10000,5895,316472426.5,-2000,9230,11230,5945.792197,2192.02274
2,10000,5901,316794535.9,-384,9386,9770,6310.822572,1988.145133
3,10000,5889,316150317.2,-384,9768,10152,6816.751061,1563.406068
4,10000,5891,316257687,1373,9768,8395,7162.159056,1324.608159
5,10000,5890,316204002.1,-1875,9827,11702,5609.235144,2508.704156
6,10000,5898,316633481.2,851,9784,8933,5807.899457,2329.830169
7,10000,5901,316794535.9,1090,9773,8683,6000.167938,2105.695504
8,10000,5890,316204002.1,1422,9773,8351,7319.924788,1139.328696
9,10000,5894,316418741.7,4359,8938,4579,7842.862402,532.1124491
10,10000,5893,316365056.8,-779,9971,10750,5285.669269,2810.001719
11,10000,5894,316418741.7,-195,9971,10166,5958.908381,2404.980617
12,10000,5890,316204002.1,700,9982,9282,4685.668421,2488.240979
13,10000,5889,316150317.2,716,9401,8685,6121.926813,2138.545073
14,10000,5891,316257687,3421,8955,5534,7991.191309,541.5197087
16,10000,5894,316418741.7,-1894,9981,11875,5135.378181,2746.528563
17,10000,5893,316365056.8,-1894,9971,11865,5877.995079,2412.239727
18,10000,5902,316848220.8,-10,9982,9992,4920.593189,2569.199848
19,10000,5896,316526111.4,716,9982,9266,5350.002205,2461.212304
20,10000,5891,316257687,1342,9341,7999,7409.173315,1156.684676
21,10000,5904,316955590.6,6199,9040,2841,8153.96477,372.605819
22,10000,5899,316687166.1,-1894,9977,11871,5119.460756,2763.054637
23,10000,5899,316687166.1,-498,9874,10372,6046.418037,2402.667775
24,10000,5889,316150317.2,422,9694,9272,6026.695194,2345.6753
25,10000,5905,317009275.5,1249,9683,8434,6541.182727,2036.488477
26,10000,5902,316848220.8,1627,9284,7657,7756.601322,810.8839432
27,10000,5891,316257687,1032,9683,8651,6295.123578,2278.581111
28,10000,5894,316418741.7,1367,9383,8016,6892.97455,1851.262571
29,10000,5896,316526111.4,1291,9383,8092,7020.608548,1740.972208
31,10000,5901,316794535.9,1351,9931,8580,6911.240807,1727.011614
32,10000,5904,316955590.6,1694,8892,7198,7265.313008,936.6477541
33,10000,5892,316311371.9,1475,9931,8456,6881.732519,1578.157895
34,10000,5907,317116645.2,1694,9136,7442,6994.751651,1012.005975
10A,10000,5888,316096632.3,-779,9971,10750,5417.96892,2751.228144
10NE,10000,5886,315989262.5,-779,9971,10750,5391.845056,2763.462006
10NW,10000,5891,316257687,-1875,9915,11790,5612.894585,2582.865388
10SW,10000,5892,316311371.9,-779,9971,10750,5263.605058,2813.866042
11NE,10000,5902,316848220.8,-195,9784,9979,5600.027618,2531.772901
11NW,10000,5889,316150317.2,-195,9784,9979,5888.719137,2465.13563
11SE,10000,5896,316526111.4,-195,9971,10166,5911.505936,2371.360627
17NW,10000,5893,316365056.8,-1894,9971,11865,5638.821483,2507.450409
17SE,10000,5897,316579796.3,-1894,9982,11876,5882.712566,2460.2294
17SW,10000,5895,316472426.5,-1894,9971,11865,5438.518066,2628.896708
22S,10000,5894,316418741.7,-1894,9844,11738,5112.083644,2768.23893
23S,10000,5889,316150317.2,981,9773,8792,5290.047376,2355.392965
24S,10000,5895,316472426.5,422,9694,9272,6020.598473,2344.608728
27A,10000,5889,316150317.2,784,9694,8910,6845.010019,1925.273434
2A,10000,5890,316204002.1,-1502,9386,10888,6537.407301,1851.021845
5NE,10000,5889,316150317.2,-1875,9827,11702,5201.91119,2527.623847
5NW,10000,5898,316633481.2,-1875,9937,11812,5188.141743,2537.662015
5SE,10000,5886,315989262.5,-1875,9827,11702,5491.816344,2668.209458
6NE,10000,5901,316794535.9,771,9386,8615,5811.363159,2276.174749
6NW,10000,5901,316794535.9,-1842,9784,11626,5960.895103,2367.375884
6SW,10000,5888,316096632.3,-195,9784,9979,5511.638757,2580.863196
Cell 1 2011/12,10000,5895,316472426.5,-2000,9230,11230,5945.792197,2192.02274
Cell 1 SW 2013,10000,5884,315881892.8,-1970,9827,11797,5765.961251,2176.440077
Cell 10 2011/12,10000,5893,316365056.8,-779,9971,10750,5285.669269,2810.001719
Cell 10 NE 2011/12,10000,5886,315989262.5,-779,9971,10750,5391.845056,2763.462006
Cell 10 NW 2011/12,10000,5891,316257687,-1875,9915,11790,5612.894585,2582.865388
Cell 10 SE 2013,10000,5902,316848220.8,-1842,9784,11626,5960.332091,2367.570379
Cell 10 SW 2011/12,10000,5892,316311371.9,-779,9971,10750,5263.605058,2813.866042
Cell 10-A 2011/12,10000,5888,316096632.3,-779,9971,10750,5417.96892,2751.228144
Cell 11 NE 2011/12,10000,5902,316848220.8,-195,9784,9979,5600.027618,2531.772901
Cell 11 NW 2013,10000,5888,316096632.3,-384,9386,9770,6438.38587,1910.746581
Cell 11 SW 2013,10000,5887,316042947.4,585,9784,9199,5874.922881,2294.886491
Cell 12 2013,10000,5897,316579796.3,1090,9773,8683,5999.004748,2106.443286
Cell 13 2013,10000,5890,316204002.1,1422,9773,8351,7283.756876,1167.890111
Cell 14 2013,10000,5892,316311371.9,1422,8938,7516,7683.145961,1129.763662
Cell 15 2013,10000,5906,317062960.3,5313,8938,3625,8101.623942,497.8299855
Cell 15-A 2013,10000,5893,316365056.8,5348,8942,3594,8120.667741,479.3357871
Cell 16 2013,10000,5899,316687166.1,5452,8942,3490,8123.008985,413.6464244
Cell 17 NW 2011/12,10000,5893,316365056.8,-1894,9971,11865,5638.821483,2507.450409
Cell 17 NW 2013,10000,5899,316687166.1,-1875,9937,11812,5324.771826,2532.775954
Cell 17 SE 2013,10000,5890,316204002.1,-1875,9915,11790,5613.425806,2582.762828
Cell 17 SW 2013,10000,5886,315989262.5,-1875,9827,11702,5615.007815,2506.64723
Cell 18 2011/12,10000,5902,316848220.8,-10,9982,9992,4920.593189,2569.199848
Cell 18 NE 2013,10000,5889,316150317.2,-195,9784,9979,5487.05298,2580.41197
Cell 18 NW 2013,10000,5899,316687166.1,-1875,9827,11702,5487.041702,2666.035764
Cell 18 SE 2013,10000,5902,316848220.8,-195,9784,9979,5600.027618,2531.772901
Cell 18 SSE 2013,10000,5901,316794535.9,-195,9784,9979,5901.729029,2448.027935
Cell 19 NW 2013,10000,5898,316633481.2,851,9784,8933,5915.60512,2265.728295
Cell 2 2011/12,10000,5901,316794535.9,-384,9386,9770,6310.822572,1988.145133
Cell 2 NE 2013,10000,5892,316311371.9,-2000,9096,11096,6486.717753,1806.692383
Cell 2 SW 2013,10000,5899,316687166.1,-2000,9230,11230,5947.370402,2191.331459
Cell 20 2013,10000,5889,316150317.2,1090,9773,8683,5983.299032,2148.071123
Cell 21 2013,10000,5889,316150317.2,1210,9773,8563,6796.636101,1635.226421
Cell 22 2013,10000,5897,316579796.3,4359,8938,4579,7854.226556,523.3327679
Cell 23 2013,10000,5908,317170330.1,4359,8939,4580,7974.52759,518.7252869
Cell 24 2013,10000,5905,317009275.4,5452,8939,3487,8102.982049,406.559604
Cell 25 NE 2013,10000,5895,316472426.5,-779,9971,10750,5286.169805,2809.808049
Cell 25 SE 2013,10000,5892,316311371.9,-779,9971,10750,5263.365241,2813.971634
Cell 26 NE 2013,10000,5894,316418741.7,-195,9971,10166,5958.908381,2404.980617
Cell 26 NNW 2013,10000,5886,315989262.5,-779,9971,10750,5392.575433,2763.36852
Cell 26 NW 2013,10000,5889,316150317.2,-779,9971,10750,5418.240618,2751.073542
Cell 27 NW 2013,10000,5895,316472426.6,-195,9971,10166,5912.212553,2370.941
Cell 28 2013,10000,5890,316204002.1,700,9982,9282,4685.555178,2488.182001
Cell 29 2013,10000,5887,316042947.4,716,9401,8685,6121.742823,2139.130952
Cell 3 NE 2013,10000,5890,316204002.1,-384,9275,9659,6904.466553,1454.04771
Cell 3 NW 2013,10000,5895,316472426.5,-2000,9371,11371,6351.456828,1891.231851
Cell 30 2013,10000,5904,316955590.6,3349,9288,5939,7860.028117,564.9740256
Cell 31 2013,10000,5897,316579796.3,4359,8955,4596,8067.030524,507.1562603
Cell 32 2013,10000,5899,316687166.1,5441,9040,3599,8214.345313,405.1264751
Cell 33 NE 2013,10000,5894,316418741.7,-1894,9971,11865,5638.137937,2507.786722
Cell 33 SE 2013,10000,5894,316418741.7,-1894,9971,11865,5439.016288,2628.7107
Cell 33 SW 2013,10000,5886,315989262.5,-1894,9981,11875,5141.262487,2734.160234
Cell 34 N 2013,10000,5888,316096632.3,-1894,9982,11876,5851.505265,2395.809766
Cell 34 NW 2013,10000,5894,316418741.7,-1894,9971,11865,5877.1264,2412.956718
Cell 34 SE 2013,10000,5897,316579796.3,-1894,9982,11876,5881.636595,2460.149095
Cell 35 2013,10000,5899,316687166.1,-10,9982,9992,4913.415664,2583.211876
Cell 37 2013,10000,5905,317009275.4,1342,9341,7999,7417.362066,1145.113773
Cell 38 2013,10000,5895,316472426.5,6199,9040,2841,8157.406785,372.0212737
Cell 39 2013,10000,5894,316418741.7,4841,9040,4199,8201.845945,387.0925703
Cell 4 2013,10000,5894,316418741.7,-384,9275,9659,7229.858839,1312.789514
Cell 40 NE 2013,10000,5896,316526111.4,-1894,9942,11836,5245.380427,2711.506032
Cell 41 N 2013,10000,5893,316365056.8,-1894,9977,11871,5503.589343,2592.329289
Cell 41 NW 2013,10000,5897,316579796.3,-1894,9977,11871,5229.655927,2740.456805
Cell 42 NW 2013,10000,5889,316150317.2,-204,9874,10078,6015.859229,2417.767528
Cell 43 2013,10000,5897,316579796.3,834,9683,8849,5770.993386,2391.451778
Cell 44 2013,10000,5897,316579796.3,1154,9341,8187,6644.241818,1932.027335
Cell 45 2013,10000,5898,316633481.2,1627,9284,7657,7756.600543,811.1000174
Cell 47 2013,10000,5888,316096632.3,422,9874,9452,6373.598505,2207.693556
Cell 48 2013,10000,5898,316633481.2,422,9694,9272,6020.128349,2344.010893
Cell 49 2013,10000,5902,316848220.8,1249,9683,8434,6540.680956,2036.822959
Cell 5 2011/12 Summer,10000,5886,315989262.5,-1875,9827,11702,5615.007815,2506.64723
Cell 5 2013,10000,5892,316311371.9,1984,8869,6885,7843.614562,822.4987083
Cell 50 2013,10000,5897,316579796.3,1291,9383,8092,7020.764457,1740.86575
Cell 51 2013,10000,5896,316526111.4,5785,8935,3150,7997.930461,394.515753
Cell 52 2013,10000,5891,316257687,1259,9383,8124,6489.099813,2172.059453
Cell 53 2013,10000,5893,316365056.8,1367,9383,8016,6893.101307,1851.394063
Cell 54 2013,10000,5907,317116645.2,1694,8961,7267,7778.986118,787.8450921
Cell 55 2013,10000,5895,316472426.6,5785,8961,3176,7908.721459,489.6505463
Cell 56 2013,10000,5895,316472426.5,1475,9931,8456,6879.93028,1579.627139
Cell 57 2013,10000,5908,317170330.1,1694,8892,7198,7265.054502,937.0542656
Cell 58 2013,10000,5893,316365056.8,1694,8961,7267,7713.413881,912.5070062
Cell 59 2013,10000,5913,317438754.6,1505,9931,8426,6875.957382,1501.207404
Cell 6 2011/12,10000,5898,316633481.2,851,9784,8933,5807.899457,2329.830169
Cell 6 2013,10000,5899,316687166.1,4772,9045,4273,8061.303272,483.3931118
Cell 6 NE 2011/12,10000,5901,316794535.9,771,9386,8615,5811.363159,2276.174749
Cell 6 NW 2011/12,10000,5901,316794535.9,-1842,9784,11626,5960.895103,2367.375884
Cell 6 SW 2011/12,10000,5888,316096632.3,-195,9784,9979,5511.638757,2580.863196
Cell 60 2013,10000,5894,316418741.7,1694,9136,7442,6992.215473,988.9102771
Cell 61 2013,10000,5907,317116645.2,2014,8887,6873,7406.734552,1069.360058
Cell 7 2013,10000,5898,316633481.2,5313,9137,3824,8131.213293,550.047504
Cell 9 NW 2013,10000,5892,316311371.9,-1970,9827,11797,5337.464698,2482.967217
Cell 9 SE 2013,10000,5889,316150317.2,-1875,9827,11702,5201.91119,2527.623847
Cell 9 SW 2013,10000,5899,316687166.1,-1875,9937,11812,5187.912189,2537.537431
Cell R1,10000,5900,316740851,881,9222,8341,5803.423559,1868.444281
Cell R10,10000,5894,316418741.7,-384,9275,9659,7229.06583,1313.665999
Cell R100,10000,5897,316579796.3,1291,9383,8092,7020.764457,1740.86575
Cell R101,10000,5902,316848220.8,1401,9040,7639,7504.002033,1267.846328
Cell R104,10000,5897,316579796.3,1282,9474,8192,6917.422927,1872.860299
Cell R105,10000,5894,316418741.7,1367,9383,8016,6892.97455,1851.262571
Cell R106,10000,5903,316901905.7,1401,9157,7756,7274.114349,1323.892524
Cell R107,10000,5907,317116645.2,1694,8961,7267,7778.986118,787.8450921
Cell R11,10000,5891,316257687,1984,8869,6885,7843.520794,822.5370249
Cell R111,10000,5896,316526111.4,1351,9931,8580,6767.011703,1949.956737
Cell R112,10000,5892,316311371.9,1581,9931,8350,7300.325017,1058.305611
Cell R113,10000,5907,317116645.2,1694,8892,7198,7264.911969,937.0765409
Cell R114,10000,5894,316418741.7,1694,8961,7267,7713.515609,912.4630112
Cell R117,10000,5906,317062960.3,1351,9931,8580,6580.05977,1895.80322
Cell R118,10000,5895,316472426.5,1475,9931,8456,6879.93028,1579.627139
Cell R119,10000,5899,316687166.1,1694,8892,7198,7145.722495,993.5461719
Cell R120,10000,5905,317009275.5,1694,8887,7193,7369.38188,1126.186474
Cell R121,10000,5896,316526111.4,2116,8887,6771,7919.456242,603.7204626
Cell R123,10000,5892,316311371.9,1505,9931,8426,6797.117447,1600.532489
Cell R124,10000,5893,316365056.8,1941,9136,7195,7006.07721,942.4627895
Cell R125,10000,5898,316633481.2,1941,8887,6946,6945.859953,905.1307732
Cell R126,10000,5895,316472426.5,1941,8887,6946,7334.007125,1076.657419
Cell R15,10000,5883,315828207.9,-1970,9827,11797,5766.130036,2176.586541
Cell R16,10000,5898,316633481.2,-1970,9827,11797,5341.980841,2482.973586
Cell R17,10000,5892,316311371.9,-736,9386,10122,6085.451799,2231.295798
Cell R18,10000,5884,315881892.8,-384,9386,9770,6446.577668,1904.518188
Cell R19,10000,5899,316687166.1,382,9768,9386,6428.747076,1810.662953
Cell R20,10000,5890,316204002.1,1422,9189,7767,7353.003735,1132.466085
Cell R21,10000,5891,316257687,1422,8838,7416,7497.838737,1181.186885
Cell R22,10000,5892,316311371.9,1422,8938,7516,7683.145961,1129.763662
Cell R24,10000,5899,316687166.1,-1875,9937,11812,5324.771826,2532.775954
Cell R25,10000,5899,316687166.1,-1875,9827,11702,5487.041702,2666.035764
Cell R26,10000,5892,316311371.9,-1842,9784,11626,5957.050916,2367.531519
Cell R27,10000,5897,316579796.3,851,9784,8933,5915.466339,2265.895328
Cell R28,10000,5892,316311371.9,1090,9773,8683,5642.721826,2249.422175
Cell R29,10000,5889,316150317.2,1090,9773,8683,5983.299032,2148.071123
Cell R30,10000,5896,316526111.4,1422,8838,7416,7418.847524,1069.051143
Cell R31,10000,5892,316311371.9,1423,8938,7515,7695.156144,940.4278897
Cell R35,10000,5886,315989262.5,-1875,9827,11702,5615.007815,2506.64723
Cell R36,10000,5890,316204002.1,-1875,9915,11790,5613.425806,2582.762828
Cell R37,10000,5902,316848220.8,-195,9784,9979,5600.027618,2531.772901
Cell R38,10000,5894,316418741.7,-195,9388,9583,5298.360197,2492.931378
Cell R39,10000,5901,316794535.9,1090,9773,8683,6145.311473,2099.958789
Cell R40,10000,5889,316150317.2,1210,9773,8563,6796.636101,1635.226421
Cell R46,10000,5886,315989262.5,-779,9961,10740,5460.240911,2737.454987
Cell R47,10000,5890,316204002.1,-779,9971,10750,5418.661121,2751.029258
Cell R48,10000,5895,316472426.5,-195,9971,10166,5958.47922,2405.002321
Cell R49,10000,5897,316579796.3,-195,9971,10166,5912.347126,2370.704531
Cell R5,10000,5897,316579796.3,-1970,9672,11642,5678.274207,2128.823507
Cell R50,10000,5888,316096632.3,700,9982,9282,4685.472147,2488.565288
Cell R51,10000,5891,316257687,716,9401,8685,6131.544559,2134.106053
Cell R52,10000,5891,316257687,1202,8811,7609,7369.060092,803.4933316
Cell R53,10000,5890,316204002.1,2443,8808,6365,7492.97657,688.4732826
Cell R54,10000,5897,316579796.3,4359,8955,4596,8067.030524,507.1562603
Cell R58,10000,5895,316472426.6,-1894,9976,11870,5319.996777,2751.769303
Cell R59,10000,5893,316365056.8,-1894,9971,11865,5638.821483,2507.450409
Cell R6,10000,5899,316687166.1,-2000,9230,11230,5947.058484,2191.402374
Cell R60,10000,5893,316365056.8,-1894,9971,11865,5877.070083,2413.157567
Cell R61,10000,5899,316687166.1,-10,9982,9992,4913.415664,2583.211876
Cell R62,10000,5896,316526111.4,716,9982,9266,5331.383989,2468.001637
Cell R63,10000,5891,316257687,716,9358,8642,5823.504159,2298.016317
Cell R64,10000,5891,316257687,1342,9341,7999,7683.577831,671.8996752
Cell R65,10000,5905,317009275.5,3349,9288,5939,7859.834378,565.1222874
Cell R66,10000,5899,316687166.1,5610,9040,3430,8153.898118,380.2297763
Cell R69,10000,5888,316096632.3,-1894,9981,11875,5140.874321,2733.918304
Cell R7,10000,5895,316472426.5,-2000,9371,11371,6351.878372,1891.454694
Cell R70,10000,5894,316418741.7,-1894,9971,11865,5439.016288,2628.7107
Cell R71,10000,5898,316633481.2,-1894,9982,11876,5882.29315,2460.457151
Cell R72,10000,5890,316204002.1,-1538,9982,11520,5474.113243,2626.555511
Cell R73,10000,5888,316096632.3,-10,9982,9992,4714.898947,2646.045729
Cell R74,10000,5900,316740851,716,9348,8632,6072.087458,2287.931058
Cell R75,10000,5904,316955590.6,1342,9341,7999,7417.311822,1145.204239
Cell R76,10000,5896,316526111.4,6008,9040,3032,8046.62059,397.4547145
Cell R77,10000,5895,316472426.5,6199,9040,2841,8157.4324,372.0487507
Cell R8,10000,5890,316204002.1,-1502,9275,10777,6869.391681,1484.524172
Cell R80,10000,5897,316579796.3,-1894,9942,11836,5245.71494,2711.397782
Cell R81,10000,5895,316472426.6,-1894,9977,11871,5547.296353,2616.965661
Cell R82,10000,5890,316204002.1,-204,9874,10078,6016.24601,2417.744476
Cell R83,10000,5892,316311371.9,-10,9874,9884,6140.117787,2344.485589
Cell R84,10000,5903,316901905.7,422,9874,9452,5541.96019,2459.580295
Cell R85,10000,5897,316579796.3,834,9683,8849,5770.993386,2391.451778
Cell R86,10000,5902,316848220.8,1249,9284,8035,7292.755845,1488.438296
Cell R87,10000,5898,316633481.2,1627,9284,7657,7756.600543,811.1000174
Cell R9,10000,5902,316848220.8,-384,9275,9659,7014.863097,1396.360203
Cell R90,10000,5889,316150317.2,422,9874,9452,6373.741043,2207.533201
Cell R91,10000,5898,316633481.2,422,9694,9272,6020.128349,2344.010893
Cell R92,10000,5895,316472426.5,1032,9683,8651,5920.704665,2249.947853
Cell R93,10000,5899,316687166.1,1249,9683,8434,6539.811324,2036.96746
Cell R97,10000,5890,316204002.1,784,9694,8910,6869.487097,1918.395756
Cell R98,10000,5892,316311371.9,1032,9683,8651,6294.574678,2278.777217
Cell R99,10000,5890,316204002.1,1259,9383,8124,6488.871138,2172.172922
Cell S102,10000,5903,316901905.7,5785,8935,3150,7981.271896,418.120022
Cell S108,10000,5895,316472426.6,5785,8961,3176,7908.721459,489.6505463
Cell S13,10000,5891,316257687,5584,9137,3553,8156.391954,470.4952421
Cell S14,10000,5898,316633481.2,5313,9137,3824,8131.213293,550.047504
Cell S2,10000,5900,316740851,4772,9045,4273,8061.181864,483.4420807
Cell S23,10000,5892,316311371.9,5313,9125,3812,8105.903598,514.9169087
Cell S32,10000,5893,316365056.8,4888,8938,4050,7938.709995,495.5790339
Cell S33,10000,5893,316365056.8,5348,8942,3594,8120.667741,479.3357871
Cell S34,10000,5904,316955590.6,5452,8939,3487,8102.879743,406.5180224
Cell S41,10000,5891,316257687,2443,8808,6365,7558.27228,712.8368585
Cell S42,10000,5908,317170330.1,4359,8939,4580,7974.52759,518.7252869
Cell S44,10000,5896,316526111.4,4549,8939,4390,8080.79749,448.4787796
Cell S56,10000,5903,316901905.7,5441,8982,3541,8068.05404,465.4141274
Cell S67,10000,5900,316740851,5441,9040,3599,8214.314407,405.0990956
Cell S78,10000,5896,316526111.4,4841,9040,4199,8201.912313,387.0436836
Cell S88,10000,5898,316633481.2,4473,8986,4513,8044.510682,425.0186823
Cell S94,10000,5893,316365056.8,5222,8935,3713,7898.70185,465.6069981
Cell S95,10000,5897,316579796.3,5785,8935,3150,7997.97185,394.4856944
W287,10000,5886,315989262.5,-1891,9904,11795,4665.70914,2228.195366
W295,10000,5894,316418741.7,-1851,8991,10842,6653.608755,2048.774609
W338,10000,5897,316579796.3,692,9923,9231,4056.554858,2358.390509
W342,10000,5901,316794535.9,807,8705,7898,5484.927809,2302.99897
W345,10000,5890,316204002.1,1216,8660,7444,7002.555857,1412.45034
W387,10000,5889,316150317.2,-54,9937,9991,5289.873493,2420.983059
W393,10000,5897,316579796.3,692,9923,9231,5375.215364,2448.895145
W440,10000,5882,315774523,1125,9937,8812,5520.243625,2400.038655
W441,10000,5886,315989262.5,1125,9047,7922,6133.992695,1895.696579
W445,10000,5897,316579796.3,1749,8692,6943,6820.021876,1057.389318
W500,10000,5889,316150317.2,1427,8823,7396,6620.103753,1512.939401
