CAMERA,RADIUS,NCELLS,AREA,MIN,MAX,RANGE,MEAN,STD
1,250,4,214739.56,7780,7952,172,7846,71.80529228
2,250,3,161054.67,6132,6739,607,6532.333333,283.128161
3,250,4,214739.56,7846,7880,34,7863,17
4,250,4,214739.56,7700,7747,47,7726.5,18.17278185
5,250,4,214739.56,6666,6895,229,6723.25,99.15990873
6,250,4,214739.56,7882,8211,329,7991.25,134.3156264
7,250,3,161054.67,6932,8301,1369,7563.333333,563.9269062
8,250,4,214739.56,5047,8121,3074,7352.5,1331.081046
9,250,4,214739.56,8329,8443,114,8365.5,45.76843891
10,250,4,214739.56,6644,7670,1026,7327,411.9860435
11,250,4,214739.56,6691,7603,912,7089.25,382.9401879
12,250,4,214739.56,7098,7706,608,7445.75,267.5036215
13,250,4,214739.56,6846,7605,759,7146.75,279.6635255
14,250,4,214739.56,6238,7844,1606,7111.25,682.5984819
16,250,4,214739.56,4085,8748,4663,7150.25,1901.771723
17,250,4,214739.56,6505,7031,526,6768,263
18,250,3,161054.67,7781,7989,208,7850.333333,98.05214032
19,250,2,107369.78,6881,7968,1087,7424.5,543.5
20,250,4,214739.56,7766,8384,618,8095.25,284.237027
21,250,4,214739.56,7979,8005,26,7998,10.9772492
22,250,3,161054.67,6708,7652,944,7098.666667,402.1851426
23,250,5,268424.45,7412,8118,706,7855.2,287.2096099
24,250,4,214739.56,7391,8585,1194,7853,478.4788397
25,250,4,214739.56,7234,7807,573,7511,277.3256209
26,250,3,161054.67,7467,7769,302,7581.666667,133.5697903
27,250,4,214739.56,7676,8302,626,7911.75,259.8329993
28,250,4,214739.56,7469,7978,509,7825.75,208.3703134
29,250,4,214739.56,8295,8419,124,8356.5,43.84347158
31,250,4,214739.56,7895,8340,445,8030.5,183.0252715
32,250,3,161054.67,6965,7538,573,7232.666667,235.4376539
33,250,4,214739.56,6913,7177,264,7062.25,102.443582
34,250,3,161054.67,5970,7240,1270,6681.333333,529.5943941
10A,250,4,214739.56,8049,8279,230,8221.5,99.59292144
10NE,250,4,214739.56,7208,7432,224,7292.75,91.047721
10NW,250,3,161054.67,7405,7467,62,7425.666667,29.22708029
10SW,250,4,214739.56,7163,7579,416,7362.5,199.8618273
11NE,250,4,214739.56,7293,7711,418,7599.5,177.3266759
11NW,250,4,214739.56,7028,7703,675,7372.75,291.2965628
11SE,250,3,161054.67,7520,7885,365,7704.666667,149.0421268
17NW,250,3,161054.67,6916,7092,176,7033.333333,82.96719566
17SE,250,3,161054.67,6461,6829,368,6706.333333,173.4768637
17SW,250,4,214739.56,8117,8334,217,8225.5,108.5
22S,250,3,161054.67,7291,8498,1207,7930,495.306639
23S,250,4,214739.56,2109,2109,0,2109,0
24S,250,3,161054.67,7463,8585,1122,8106,472.5060846
27A,250,4,214739.56,7972,8138,166,8087.5,67.08762926
2A,250,4,214739.56,7379,7844,465,7546.75,191.1156391
5NE,250,3,161054.67,6559,7229,670,7005.666667,315.8410289
5NW,250,3,161054.67,5912,6185,273,6003,128.6934342
5SE,250,4,214739.56,7938,8449,511,8072.75,217.3032156
6NE,250,4,214739.56,6775,8504,1729,7981,710.7605082
6NW,250,4,214739.56,8101,8516,415,8256.75,157.4299447
6SW,250,3,161054.67,8669,8808,139,8746.666667,57.90989169
Cell 1 2011/12,250,4,214739.56,7780,7952,172,7846,71.80529228
Cell 1 SW 2013,250,4,214739.56,6901,7151,250,7024.5,123.5182173
Cell 10 2011/12,250,4,214739.56,6644,7670,1026,7327,411.9860435
Cell 10 NE 2011/12,250,4,214739.56,7208,7432,224,7292.75,91.047721
Cell 10 NW 2011/12,250,3,161054.67,7405,7467,62,7425.666667,29.22708029
Cell 10 SE 2013,250,4,214739.56,8101,8516,415,8256.75,157.4299447
Cell 10 SW 2011/12,250,4,214739.56,7163,7579,416,7362.5,199.8618273
Cell 10-A 2011/12,250,4,214739.56,8049,8279,230,8221.5,99.59292144
Cell 11 NE 2011/12,250,4,214739.56,7293,7711,418,7599.5,177.3266759
Cell 11 NW 2013,250,4,214739.56,7436,8077,641,7912,274.9281724
Cell 11 SW 2013,250,4,214739.56,7328,7515,187,7407.75,74.05867606
Cell 12 2013,250,3,161054.67,6932,8301,1369,7563.333333,563.9269062
Cell 13 2013,250,4,214739.56,6190,8121,1931,7184,860.858583
Cell 14 2013,250,4,214739.56,7612,7772,160,7705.5,60.38832669
Cell 15 2013,250,3,161054.67,8039,8101,62,8059.666667,29.22708029
Cell 15-A 2013,250,4,214739.56,7628,7741,113,7708.25,46.9114858
Cell 16 2013,250,3,161054.67,7722,7815,93,7753,43.84062043
Cell 17 NW 2011/12,250,3,161054.67,6916,7092,176,7033.333333,82.96719566
Cell 17 NW 2013,250,4,214739.56,5430,6000,570,5814.25,224.7024421
Cell 17 SE 2013,250,3,161054.67,7405,7467,62,7425.666667,29.22708029
Cell 17 SW 2013,250,4,214739.56,6666,7054,388,6877.5,138.2904552
Cell 18 2011/12,250,3,161054.67,7781,7989,208,7850.333333,98.05214032
Cell 18 NE 2013,250,4,214739.56,7697,8808,1111,8124.25,414.4830364
Cell 18 NW 2013,250,3,161054.67,5516,7938,2422,7023.333333,1073.921578
Cell 18 SE 2013,250,4,214739.56,7293,7711,418,7599.5,177.3266759
Cell 18 SSE 2013,250,3,161054.67,7690,7877,187,7752.333333,88.15264539
Cell 19 NW 2013,250,3,161054.67,8139,8172,33,8150,15.55634919
Cell 2 2011/12,250,3,161054.67,6132,6739,607,6532.333333,283.128161
Cell 2 NE 2013,250,4,214739.56,7112,8329,1217,7813.5,529.2497048
Cell 2 SW 2013,250,3,161054.67,7780,7952,172,7868,70.27564775
Cell 20 2013,250,4,214739.56,7895,8199,304,8082.5,113.1912099
Cell 21 2013,250,4,214739.56,5343,5738,395,5631.75,166.8223231
Cell 22 2013,250,3,161054.67,7184,7249,65,7217.666667,26.58738214
Cell 23 2013,250,4,214739.56,8374,8723,349,8470.5,146.5614206
Cell 24 2013,250,3,161054.67,7763,8143,380,7942.666667,155.8211225
Cell 25 NE 2013,250,4,214739.56,6644,7670,1026,7327,411.9860435
Cell 25 SE 2013,250,4,214739.56,7163,7579,416,7362.5,199.8618273
Cell 26 NE 2013,250,4,214739.56,6691,7603,912,7089.25,382.9401879
Cell 26 NNW 2013,250,4,214739.56,7208,7432,224,7292.75,91.047721
Cell 26 NW 2013,250,4,214739.56,8049,8279,230,8221.5,99.59292144
Cell 27 NW 2013,250,3,161054.67,7520,7885,365,7704.666667,149.0421268
Cell 28 2013,250,4,214739.56,7098,7706,608,7445.75,267.5036215
Cell 29 2013,250,4,214739.56,6846,7605,759,7146.75,279.6635255
Cell 3 NE 2013,250,4,214739.56,7306,8556,1250,7955.25,454.2473858
Cell 3 NW 2013,250,3,161054.67,7469,7756,287,7624,118.2906026
Cell 30 2013,250,3,161054.67,6981,7398,417,7259,196.5756852
Cell 31 2013,250,4,214739.56,8095,8397,302,8246,151
Cell 32 2013,250,3,161054.67,8076,8228,152,8177.333333,71.65348716
Cell 33 NE 2013,250,3,161054.67,6916,7092,176,7033.333333,82.96719566
Cell 33 SE 2013,250,4,214739.56,8117,8334,217,8225.5,108.5
Cell 33 SW 2013,250,4,214739.56,6465,7568,1103,7006,541.2037509
Cell 34 N 2013,250,4,214739.56,7421,7662,241,7529.75,86.01271708
Cell 34 NW 2013,250,4,214739.56,6505,7031,526,6768,263
Cell 34 SE 2013,250,4,214739.56,6461,6829,368,6737,159.3486743
Cell 35 2013,250,5,268424.45,3560,8060,4500,7064.8,1753.500887
Cell 37 2013,250,3,161054.67,7766,8384,618,8173.666667,288.312716
Cell 38 2013,250,4,214739.56,7961,8005,44,7993.5,18.76832438
Cell 39 2013,250,4,214739.56,8573,8929,356,8796.25,134.3900573
Cell 4 2013,250,3,161054.67,7779,7914,135,7856.333333,56.84090859
Cell 40 NE 2013,250,4,214739.56,6438,8686,2248,7441.25,810.1985482
Cell 41 N 2013,250,4,214739.56,7826,7849,23,7831.75,9.959292144
Cell 41 NW 2013,250,3,161054.67,7948,9647,1699,8514.333333,800.9162808
Cell 42 NW 2013,250,4,214739.56,7016,8118,1102,7718.25,453.3797387
Cell 43 2013,250,4,214739.56,7099,7389,290,7244,145
Cell 44 2013,250,4,214739.56,7886,8078,192,7969.25,85.18032343
Cell 45 2013,250,3,161054.67,7467,7769,302,7581.666667,133.5697903
Cell 47 2013,250,4,214739.56,7018,7642,624,7366.75,280.1137046
Cell 48 2013,250,3,161054.67,7463,8585,1122,8106,472.5060846
Cell 49 2013,250,4,214739.56,7234,7807,573,7511,277.3256209
Cell 5 2011/12 Summer,250,4,214739.56,6666,7054,388,6877.5,138.2904552
Cell 5 2013,250,4,214739.56,7922,8436,514,8163.75,231.8624323
Cell 50 2013,250,4,214739.56,8295,8419,124,8356.5,43.84347158
Cell 51 2013,250,4,214739.56,8330,8378,48,8364.5,19.95620204
Cell 52 2013,250,4,214739.56,7482,7597,115,7544,53.38070813
Cell 53 2013,250,4,214739.56,7469,7978,509,7825.75,208.3703134
Cell 54 2013,250,3,161054.67,8102,8246,144,8189,62.49799997
Cell 55 2013,250,4,214739.56,7674,8191,517,7822.5,215.0633628
Cell 56 2013,250,4,214739.56,6913,7177,264,7062.25,102.443582
Cell 57 2013,250,3,161054.67,6965,7538,573,7232.666667,235.4376539
Cell 58 2013,250,4,214739.56,7932,8470,538,8276,204.4639332
Cell 59 2013,250,3,161054.67,7191,7719,528,7490.333333,221.2710756
Cell 6 2011/12,250,4,214739.56,7882,8211,329,7991.25,134.3156264
Cell 6 2013,250,4,214739.56,8271,8425,154,8337.5,66.53382598
Cell 6 NE 2011/12,250,4,214739.56,6775,8504,1729,7981,710.7605082
Cell 6 NW 2011/12,250,4,214739.56,8101,8516,415,8256.75,157.4299447
Cell 6 SW 2011/12,250,3,161054.67,8669,8808,139,8746.666667,57.90989169
Cell 60 2013,250,4,214739.56,7091,7337,246,7230.5,88.52542008
Cell 61 2013,250,4,214739.56,7140,7872,732,7557.75,293.1658021
Cell 7 2013,250,4,214739.56,7310,7873,563,7580.75,271.1764877
Cell 9 NW 2013,250,4,214739.56,6502,7242,740,6821.5,308.5453775
Cell 9 SE 2013,250,3,161054.67,6559,7229,670,7005.666667,315.8410289
Cell 9 SW 2013,250,3,161054.67,5912,6185,273,6003,128.6934342
Cell R1,250,5,268424.45,6396,8178,1782,7197.8,616.7256765
Cell R10,250,3,161054.67,7779,7914,135,7856.333333,56.84090859
Cell R100,250,4,214739.56,8295,8419,124,8356.5,43.84347158
Cell R101,250,3,161054.67,7522,8193,671,7827.666667,277.1646121
Cell R104,250,3,161054.67,8031,8232,201,8114.666667,85.4413379
Cell R105,250,4,214739.56,7469,7978,509,7825.75,208.3703134
Cell R106,250,3,161054.67,8108,8322,214,8216.666667,87.39692341
Cell R107,250,3,161054.67,8102,8246,144,8189,62.49799997
Cell R11,250,4,214739.56,7922,8436,514,8163.75,231.8624323
Cell R111,250,3,161054.67,8312,8544,232,8422,95.092937
Cell R112,250,4,214739.56,7874,8168,294,7977.25,120.368964
Cell R113,250,3,161054.67,6965,7538,573,7232.666667,235.4376539
Cell R114,250,4,214739.56,7932,8470,538,8276,204.4639332
Cell R117,250,3,161054.67,7066,7891,825,7616,388.9087297
Cell R118,250,4,214739.56,6913,7177,264,7062.25,102.443582
Cell R119,250,3,161054.67,5143,7017,1874,6391.333333,882.7058148
Cell R120,250,5,268424.45,8303,8513,210,8417.8,86.13338493
Cell R121,250,4,214739.56,7030,8308,1278,7572,559.0903326
Cell R123,250,4,214739.56,7627,7909,282,7838.5,122.1095819
Cell R124,250,4,214739.56,6743,6743,0,6743,0
Cell R125,250,4,214739.56,6939,7947,1008,7402.25,466.8208302
Cell R126,250,4,214739.56,7834,7977,143,7905.5,71.5
Cell R15,250,4,214739.56,6901,7151,250,7024.5,123.5182173
Cell R16,250,4,214739.56,6502,7242,740,6821.5,308.5453775
Cell R17,250,4,214739.56,7272,7523,251,7408.5,93.0712093
Cell R18,250,4,214739.56,7436,8077,641,7912,274.9281724
Cell R19,250,3,161054.67,7932,8153,221,8079.333333,104.1803991
Cell R20,250,4,214739.56,7384,7553,169,7430,71.10203935
Cell R21,250,4,214739.56,7551,7609,58,7569.25,23.60481942
Cell R22,250,4,214739.56,7612,7772,160,7705.5,60.38832669
Cell R24,250,4,214739.56,5430,6000,570,5814.25,224.7024421
Cell R25,250,3,161054.67,5516,7938,2422,7023.333333,1073.921578
Cell R26,250,3,161054.67,8217,8516,299,8324,136.0612607
Cell R27,250,3,161054.67,8139,8172,33,8150,15.55634919
Cell R28,250,4,214739.56,7038,7265,227,7112,92.7173123
Cell R29,250,4,214739.56,7895,8199,304,8082.5,113.1912099
Cell R30,250,3,161054.67,7063,7918,855,7487,349.0873816
Cell R31,250,4,214739.56,8169,8303,134,8219.5,50.16722037
Cell R35,250,4,214739.56,6666,7054,388,6877.5,138.2904552
Cell R36,250,3,161054.67,7405,7467,62,7425.666667,29.22708029
Cell R37,250,4,214739.56,7293,7711,418,7599.5,177.3266759
Cell R38,250,4,214739.56,8044,8244,200,8171.5,75.86995453
Cell R39,250,3,161054.67,7654,8029,375,7854.666667,154.2213417
Cell R40,250,4,214739.56,5343,5738,395,5631.75,166.8223231
Cell R46,250,4,214739.56,3784,6127,2343,5014.5,1009.432142
Cell R47,250,4,214739.56,8049,8279,230,8221.5,99.59292144
Cell R48,250,4,214739.56,6691,7603,912,7089.25,382.9401879
Cell R49,250,3,161054.67,7520,7885,365,7704.666667,149.0421268
Cell R5,250,4,214739.56,6498,7416,918,6957,459
Cell R50,250,4,214739.56,7098,7706,608,7445.75,267.5036215
Cell R51,250,4,214739.56,6846,7605,759,7146.75,279.6635255
Cell R52,250,4,214739.56,7704,8220,516,7896.5,213.6275965
Cell R53,250,4,214739.56,7856,7947,91,7883.25,37.53248593
Cell R54,250,4,214739.56,8095,8397,302,8246,151
Cell R58,250,4,214739.56,7173,8629,1456,8064.5,595.8961738
Cell R59,250,3,161054.67,6916,7092,176,7033.333333,82.96719566
Cell R6,250,3,161054.67,7780,7952,172,7868,70.27564775
Cell R60,250,4,214739.56,6505,7031,526,6768,263
Cell R61,250,5,268424.45,3560,8060,4500,7064.8,1753.500887
Cell R62,250,4,214739.56,6565,8385,1820,7448,748.7182381
Cell R63,250,4,214739.56,7431,7737,306,7619.5,113.8628561
Cell R64,250,4,214739.56,7940,8113,173,8026.25,61.16524749
Cell R65,250,3,161054.67,6981,7398,417,7259,196.5756852
Cell R66,250,4,214739.56,8379,8590,211,8522.5,86.28006722
Cell R69,250,4,214739.56,6465,7568,1103,7006,541.2037509
Cell R7,250,3,161054.67,7469,7756,287,7624,118.2906026
Cell R70,250,4,214739.56,8117,8334,217,8225.5,108.5
Cell R71,250,4,214739.56,6461,6829,368,6737,159.3486743
Cell R72,250,4,214739.56,5481,7242,1761,5958.75,741.5171525
Cell R73,250,4,214739.56,7374,8345,971,7972.25,396.5453158
Cell R74,250,3,161054.67,8294,8294,0,8294,0
Cell R75,250,3,161054.67,7766,8384,618,8173.666667,288.312716
Cell R76,250,4,214739.56,8762,8837,75,8796.25,34.5570181
Cell R77,250,4,214739.56,7961,8005,44,7993.5,18.76832438
Cell R8,250,4,214739.56,7914,8543,629,8213,299.8024349
Cell R80,250,4,214739.56,6438,8686,2248,7441.25,810.1985482
Cell R81,250,3,161054.67,6739,7000,261,6884,108.5080642
Cell R82,250,4,214739.56,7016,8118,1102,7718.25,453.3797387
Cell R83,250,4,214739.56,7330,7463,133,7429.75,57.59068935
Cell R84,250,3,161054.67,6704,8320,1616,7752.333333,742.1340101
Cell R85,250,4,214739.56,7099,7389,290,7244,145
Cell R86,250,3,161054.67,7972,8301,329,8102,142.9008981
Cell R87,250,3,161054.67,7467,7769,302,7581.666667,133.5697903
Cell R9,250,5,268424.45,6280,8011,1731,7042.8,606.4471618
Cell R90,250,4,214739.56,7018,7642,624,7366.75,280.1137046
Cell R91,250,3,161054.67,7463,8585,1122,8106,472.5060846
Cell R92,250,4,214739.56,6339,7495,1156,6837.5,511.0212814
Cell R93,250,4,214739.56,7234,7807,573,7511,277.3256209
Cell R97,250,4,214739.56,7856,8101,245,7980.75,92.55370063
Cell R98,250,4,214739.56,7676,8302,626,7911.75,259.8329993
Cell R99,250,4,214739.56,7482,7597,115,7544,53.38070813
Cell S102,250,4,214739.56,7546,8098,552,7960,239.0230114
Cell S108,250,4,214739.56,7674,8191,517,7822.5,215.0633628
Cell S13,250,4,214739.56,7780,7931,151,7873,63.05949572
Cell S14,250,4,214739.56,7310,7873,563,7580.75,271.1764877
Cell S2,250,4,214739.56,8271,8425,154,8337.5,66.53382598
Cell S23,250,4,214739.56,8269,8522,253,8419.75,107.8479833
Cell S32,250,4,214739.56,8239,8553,314,8395.25,127.4409177
Cell S33,250,4,214739.56,7628,7741,113,7708.25,46.9114858
Cell S34,250,3,161054.67,7763,8143,380,7942.666667,155.8211225
Cell S41,250,4,214739.56,7692,8128,436,8014,186.0860016
Cell S42,250,4,214739.56,8374,8723,349,8470.5,146.5614206
Cell S44,250,4,214739.56,7708,8068,360,7904.25,144.3439902
Cell S56,250,4,214739.56,7128,7792,664,7581.5,264.3411621
Cell S67,250,3,161054.67,8076,8228,152,8177.333333,71.65348716
Cell S78,250,4,214739.56,8573,8929,356,8796.25,134.3900573
Cell S88,250,3,161054.67,7674,8378,704,7908.666667,331.8687826
Cell S94,250,4,214739.56,8098,8340,242,8218.5,120.5020747
Cell S95,250,4,214739.56,8330,8378,48,8364.5,19.95620204
W287,250,4,214739.56,5413,6508,1095,5725.25,453.9396298
W295,250,3,161054.67,3335,7779,4444,5309.666667,1847.666156
W338,250,4,214739.56,6987,7595,608,7296,215.2463705
W342,250,3,161054.67,6775,7793,1018,7114.333333,479.8898022
W345,250,4,214739.56,7451,7640,189,7568.25,78.63324679
W387,250,3,161054.67,6468,7047,579,6854,272.9432175
W393,250,4,214739.56,7268,7553,285,7448.75,107.8363923
W440,250,4,214739.56,6402,6451,49,6426.5,24.5
W441,250,4,214739.56,7506,7764,258,7698.5,111.142926
W445,250,4,214739.56,6822,7176,354,6913.5,151.5742392
W500,250,4,214739.56,7772,8447,675,8149.75,277.8447183
1,500,14,751588.46,7776,8059,283,7897.214286,93.43154757
2,500,14,751588.46,5151,7574,2423,6627.071429,668.9149491
3,500,14,751588.46,7718,8028,310,7884.571429,87.6304858
4,500,14,751588.46,7498,7882,384,7703.928571,112.4801343
5,500,15,805273.35,6621,7071,450,6844.8,168.9395158
6,500,16,858958.24,7250,8530,1280,8125.75,308.657476
7,500,15,805273.35,5720,8301,2581,7358.4,792.9681625
8,500,14,751588.46,5047,8121,3074,6894.5,1103.143803
9,500,14,751588.46,7443,8584,1141,8221.142857,273.629535
10,500,16,858958.24,6644,8062,1418,7500.625,356.0210448
11,500,15,805273.35,6691,7847,1156,7325.8,391.6376216
12,500,16,858958.24,6165,7967,1802,7389.25,542.0551748
13,500,14,751588.46,5653,7809,2156,7057.357143,593.9323683
14,500,14,751588.46,6238,8323,2085,7310.928571,670.5141379
16,500,14,751588.46,3390,8776,5386,6805.928571,1778.307239
17,500,14,751588.46,6505,8000,1495,7086.785714,518.5448291
18,500,15,805273.35,6269,8482,2213,7796.133333,451.5113681
19,500,16,858958.24,6280,8385,2105,7231.3125,702.2112146
20,500,14,751588.46,7707,8389,682,8137.571429,241.1018499
21,500,15,805273.35,7608,8387,779,8015.533333,184.8003848
22,500,15,805273.35,-834,8498,9332,5532.866667,3077.111413
23,500,14,751588.46,6053,8501,2448,7434.428571,621.4681597
24,500,14,751588.46,7079,8597,1518,7959.785714,474.3740505
25,500,15,805273.35,7058,7807,749,7479.333333,272.0133984
26,500,15,805273.35,7467,8083,616,7753.533333,188.504241
27,500,16,858958.24,7395,8440,1045,7785.3125,335.7803819
28,500,16,858958.24,6916,8093,1177,7730.625,405.5281857
29,500,14,751588.46,8265,8659,394,8386,113.5064504
31,500,16,858958.24,7895,8340,445,8152.5625,152.7309598
32,500,14,751588.46,6446,7850,1404,7186.285714,382.2636391
33,500,14,751588.46,6889,7177,288,7043.642857,98.6759539
34,500,15,805273.35,5658,7250,1592,6638.6,484.8391898
10A,500,14,751588.46,8049,8364,315,8202.928571,116.7136081
10NE,500,14,751588.46,7061,7432,371,7228.142857,136.6867415
10NW,500,16,858958.24,6703,7619,916,7312.625,252.8974286
10SW,500,14,751588.46,5234,8592,3358,7367.857143,776.6927005
11NE,500,15,805273.35,7191,7803,612,7515.866667,207.0223391
11NW,500,14,751588.46,7028,8053,1025,7548.071429,285.806494
11SE,500,15,805273.35,7428,8407,979,7806.466667,282.1285444
17NW,500,15,805273.35,6779,7205,426,6996.266667,132.3925812
17SE,500,14,751588.46,6461,7527,1066,6838.571429,345.4822125
17SW,500,15,805273.35,6217,8958,2741,7841.6,849.4994448
22S,500,16,858958.24,4222,8498,4276,7103.625,1306.314945
23S,500,16,858958.24,2066,4285,2219,2581.875,575.1197566
24S,500,16,858958.24,7079,8602,1523,8038.1875,489.8549809
27A,500,14,751588.46,7502,8956,1454,8075.142857,395.0581977
2A,500,14,751588.46,6459,8812,2353,7490,525.3348592
5NE,500,15,805273.35,6531,7857,1326,7125,424.0710632
5NW,500,14,751588.46,4157,6200,2043,5580.428571,674.7448951
5SE,500,14,751588.46,4343,8449,4106,6802.5,1540.260542
6NE,500,15,805273.35,6775,8579,1804,8145.466667,567.1951888
6NW,500,16,858958.24,7203,8593,1390,8124,346.6415656
6SW,500,15,805273.35,7240,8808,1568,8198.133333,494.0782484
Cell 1 2011/12,500,14,751588.46,7776,8059,283,7897.214286,93.43154757
Cell 1 SW 2013,500,14,751588.46,6492,7410,918,7048.214286,254.6291922
Cell 10 2011/12,500,16,858958.24,6644,8062,1418,7500.625,356.0210448
Cell 10 NE 2011/12,500,14,751588.46,7061,7432,371,7228.142857,136.6867415
Cell 10 NW 2011/12,500,16,858958.24,6703,7619,916,7312.625,252.8974286
Cell 10 SE 2013,500,16,858958.24,7203,8593,1390,8124,346.6415656
Cell 10 SW 2011/12,500,14,751588.46,5234,8592,3358,7367.857143,776.6927005
Cell 10-A 2011/12,500,14,751588.46,8049,8364,315,8202.928571,116.7136081
Cell 11 NE 2011/12,500,15,805273.35,7191,7803,612,7515.866667,207.0223391
Cell 11 NW 2013,500,14,751588.46,6223,8077,1854,7508.785714,617.738176
Cell 11 SW 2013,500,14,751588.46,6492,7744,1252,7335.785714,336.361026
Cell 12 2013,500,15,805273.35,5720,8301,2581,7358.4,792.9681625
Cell 13 2013,500,14,751588.46,3078,8121,5043,6604.214286,1539.909282
Cell 14 2013,500,14,751588.46,7320,7949,629,7676.857143,159.8427161
Cell 15 2013,500,14,751588.46,7691,8201,510,8018.5,156.6259192
Cell 15-A 2013,500,14,751588.46,7605,8070,465,7779.642857,139.6964092
Cell 16 2013,500,16,858958.24,7578,8798,1220,7872.625,282.4380186
Cell 17 NW 2011/12,500,15,805273.35,6779,7205,426,6996.266667,132.3925812
Cell 17 NW 2013,500,15,805273.35,2952,7501,4549,5906.333333,1210.786778
Cell 17 SE 2013,500,16,858958.24,6703,7619,916,7312.625,252.8974286
Cell 17 SW 2013,500,14,751588.46,6621,7071,450,6863,171.6782705
Cell 18 2011/12,500,15,805273.35,6269,8482,2213,7796.133333,451.5113681
Cell 18 NE 2013,500,14,751588.46,7240,8808,1568,8105.214286,456.6780952
Cell 18 NW 2013,500,16,858958.24,4343,8449,4106,7319.8125,1264.509105
Cell 18 SE 2013,500,16,858958.24,7191,7803,612,7495.5625,215.321843
Cell 18 SSE 2013,500,15,805273.35,7144,8258,1114,7716.066667,283.9160596
Cell 19 NW 2013,500,14,751588.46,7781,8516,735,8185.571429,164.6961333
Cell 2 2011/12,500,14,751588.46,5151,7574,2423,6627.071429,668.9149491
Cell 2 NE 2013,500,16,858958.24,6030,8487,2457,7539.625,699.9581126
Cell 2 SW 2013,500,14,751588.46,7776,8059,283,7897.214286,93.43154757
Cell 20 2013,500,14,751588.46,7609,8199,590,7979.142857,209.1137275
Cell 21 2013,500,14,751588.46,4970,7476,2506,5750.714286,712.7997543
Cell 22 2013,500,16,858958.24,7142,8219,1077,7670.625,409.3700763
Cell 23 2013,500,15,805273.35,8163,8920,757,8540.066667,227.0910145
Cell 24 2013,500,15,805273.35,7629,8776,1147,8051.666667,291.6275402
Cell 25 NE 2013,500,16,858958.24,6644,8062,1418,7500.625,356.0210448
Cell 25 SE 2013,500,14,751588.46,5234,8592,3358,7367.857143,776.6927005
Cell 26 NE 2013,500,15,805273.35,6691,7847,1156,7325.8,391.6376216
Cell 26 NNW 2013,500,14,751588.46,7061,7432,371,7228.142857,136.6867415
Cell 26 NW 2013,500,14,751588.46,8049,8364,315,8202.928571,116.7136081
Cell 27 NW 2013,500,15,805273.35,7428,8407,979,7806.466667,282.1285444
Cell 28 2013,500,16,858958.24,6165,7967,1802,7389.25,542.0551748
Cell 29 2013,500,14,751588.46,5653,7809,2156,7057.357143,593.9323683
Cell 3 NE 2013,500,14,751588.46,6377,9023,2646,8055.785714,670.6024135
Cell 3 NW 2013,500,14,751588.46,6275,8969,2694,7826.785714,641.8937583
Cell 30 2013,500,15,805273.35,6794,7762,968,7304.4,278.5253549
Cell 31 2013,500,15,805273.35,7297,8425,1128,8158.733333,364.1482238
Cell 32 2013,500,16,858958.24,7051,8228,1177,7932.25,346.7370221
Cell 33 NE 2013,500,15,805273.35,6779,7205,426,6996.266667,132.3925812
Cell 33 SE 2013,500,15,805273.35,6217,8958,2741,7841.6,849.4994448
Cell 33 SW 2013,500,14,751588.46,3390,8776,5386,6717.142857,1558.391793
Cell 34 N 2013,500,14,751588.46,6102,7731,1629,7277.928571,459.0808308
Cell 34 NW 2013,500,14,751588.46,6505,8000,1495,7086.785714,518.5448291
Cell 34 SE 2013,500,14,751588.46,6461,7527,1066,6838.571429,345.4822125
Cell 35 2013,500,15,805273.35,3560,8230,4670,7315.8,1487.712616
Cell 37 2013,500,15,805273.35,7707,8389,682,8106.066667,240.5295454
Cell 38 2013,500,14,751588.46,7608,8199,591,7958.571429,147.9153785
Cell 39 2013,500,14,751588.46,7939,8929,990,8734.142857,246.8408559
Cell 4 2013,500,16,858958.24,7445,8386,941,7859.1875,295.7404307
Cell 40 NE 2013,500,15,805273.35,5055,8686,3631,7303.333333,781.2047676
Cell 41 N 2013,500,14,751588.46,7730,9851,2121,8263.714286,744.2460642
Cell 41 NW 2013,500,14,751588.46,720,9647,8927,6278.357143,3124.124394
Cell 42 NW 2013,500,14,751588.46,5904,8118,2214,7196.5,675.3206381
Cell 43 2013,500,15,805273.35,7099,7971,872,7507.933333,288.9490074
Cell 44 2013,500,14,751588.46,7845,8497,652,8093.857143,201.2890094
Cell 45 2013,500,16,858958.24,7467,8219,752,7782.625,214.4944274
Cell 47 2013,500,14,751588.46,7018,7917,899,7505.571429,243.0369502
Cell 48 2013,500,15,805273.35,7079,8602,1523,8056.533333,500.5696577
Cell 49 2013,500,15,805273.35,7058,7807,749,7479.333333,272.0133984
Cell 5 2011/12 Summer,500,14,751588.46,6621,7071,450,6863,171.6782705
Cell 5 2013,500,14,751588.46,7814,8707,893,8119.142857,280.9796274
Cell 50 2013,500,14,751588.46,8265,8659,394,8386,113.5064504
Cell 51 2013,500,16,858958.24,7811,8378,567,8200.875,210.3202543
Cell 52 2013,500,14,751588.46,7212,8475,1263,7887.214286,408.0845813
Cell 53 2013,500,16,858958.24,6916,8093,1177,7730.625,405.5281857
Cell 54 2013,500,14,751588.46,7320,8570,1250,8192.714286,337.0585851
Cell 55 2013,500,14,751588.46,7674,8284,610,7903.214286,210.1469481
Cell 56 2013,500,15,805273.35,6889,7177,288,7038.533333,97.22816236
Cell 57 2013,500,14,751588.46,6446,7850,1404,7186.285714,382.2636391
Cell 58 2013,500,15,805273.35,7810,8606,796,8241.4,261.037111
Cell 59 2013,500,15,805273.35,6718,7814,1096,7316.4,290.0047816
Cell 6 2011/12,500,16,858958.24,7250,8530,1280,8125.75,308.657476
Cell 6 2013,500,16,858958.24,8110,8425,315,8327.1875,79.20086706
Cell 6 NE 2011/12,500,15,805273.35,6775,8579,1804,8145.466667,567.1951888
Cell 6 NW 2011/12,500,16,858958.24,7203,8593,1390,8124,346.6415656
Cell 6 SW 2011/12,500,15,805273.35,7240,8808,1568,8198.133333,494.0782484
Cell 60 2013,500,14,751588.46,6822,7547,725,7240.357143,191.2734046
Cell 61 2013,500,16,858958.24,7140,8549,1409,7752.5625,363.4145307
Cell 7 2013,500,15,805273.35,7310,8299,989,7654.066667,243.3922668
Cell 9 NW 2013,500,16,858958.24,4842,8044,3202,6740.25,939.1047931
Cell 9 SE 2013,500,15,805273.35,6531,7857,1326,7125,424.0710632
Cell 9 SW 2013,500,13,697903.57,4157,6200,2043,5650.153846,649.7997142
Cell R1,500,13,697903.57,6396,8178,1782,7184.461538,597.3461328
Cell R10,500,16,858958.24,7445,8386,941,7859.1875,295.7404307
Cell R100,500,14,751588.46,8265,8659,394,8386,113.5064504
Cell R101,500,15,805273.35,7522,8298,776,8010.8,264.0937207
Cell R104,500,16,858958.24,7825,8232,407,8034.4375,122.0455697
Cell R105,500,16,858958.24,6916,8093,1177,7730.625,405.5281857
Cell R106,500,15,805273.35,7688,8452,764,8114.066667,198.0220414
Cell R107,500,14,751588.46,7320,8570,1250,8192.714286,337.0585851
Cell R11,500,14,751588.46,7814,8707,893,8119.142857,280.9796274
Cell R111,500,16,858958.24,7479,8632,1153,8357.3125,268.1372593
Cell R112,500,14,751588.46,7874,8294,420,8052.214286,123.2507193
Cell R113,500,14,751588.46,6446,7850,1404,7186.285714,382.2636391
Cell R114,500,14,751588.46,7810,8606,796,8256.142857,264.0970755
Cell R117,500,15,805273.35,6630,7891,1261,7324.266667,387.883396
Cell R118,500,15,805273.35,6889,7177,288,7038.533333,97.22816236
Cell R119,500,16,858958.24,4628,7118,2490,6249.875,847.7900591
Cell R120,500,13,697903.57,8204,8513,309,8394.692308,90.52869041
Cell R121,500,15,805273.35,6875,8308,1433,7568.933333,450.2666568
Cell R123,500,16,858958.24,7121,8233,1112,7710.6875,341.9153255
Cell R124,500,14,751588.46,6712,7612,900,6991,314.4466796
Cell R125,500,15,805273.35,6939,7947,1008,7432,369.2659385
Cell R126,500,14,751588.46,7830,8411,581,8086.714286,228.9901522
Cell R15,500,14,751588.46,6492,7410,918,7048.214286,254.6291922
Cell R16,500,16,858958.24,4842,8044,3202,6740.25,939.1047931
Cell R17,500,14,751588.46,5871,8643,2772,7338.285714,755.6785436
Cell R18,500,16,858958.24,6223,8077,1854,7412.1875,657.3545674
Cell R19,500,15,805273.35,7687,8153,466,7933.4,135.2049309
Cell R20,500,14,751588.46,7347,7642,295,7460.214286,115.344316
Cell R21,500,14,751588.46,7289,7784,495,7545.571429,160.405163
Cell R22,500,14,751588.46,7320,7949,629,7676.857143,159.8427161
Cell R24,500,15,805273.35,2952,7501,4549,5906.333333,1210.786778
Cell R25,500,15,805273.35,4343,8449,4106,7244.533333,1270.791452
Cell R26,500,16,858958.24,7929,8593,664,8276.4375,180.5443051
Cell R27,500,15,805273.35,7747,8516,769,8156.333333,193.0922635
Cell R28,500,16,858958.24,4510,8066,3556,6747.125,1094.828404
Cell R29,500,14,751588.46,7609,8199,590,7979.142857,209.1137275
Cell R30,500,16,858958.24,5843,8074,2231,7449.25,667.4426473
Cell R31,500,14,751588.46,7712,8380,668,8104.071429,202.4240472
Cell R35,500,14,751588.46,6621,7071,450,6863,171.6782705
Cell R36,500,16,858958.24,6703,7619,916,7312.625,252.8974286
Cell R37,500,15,805273.35,7191,7803,612,7515.866667,207.0223391
Cell R38,500,15,805273.35,7953,8280,327,8171.8,89.28769979
Cell R39,500,15,805273.35,7351,8078,727,7816.133333,203.4387268
Cell R40,500,14,751588.46,4970,7476,2506,5750.714286,712.7997543
Cell R46,500,14,751588.46,3773,6838,3065,5124.142857,1179.98165
Cell R47,500,14,751588.46,8049,8364,315,8202.928571,116.7136081
Cell R48,500,15,805273.35,6691,7847,1156,7325.8,391.6376216
Cell R49,500,16,858958.24,7109,8407,1298,7762.875,321.1311794
Cell R5,500,16,858958.24,5810,7416,1606,6767.875,437.5975427
Cell R50,500,16,858958.24,6165,7967,1802,7389.25,542.0551748
Cell R51,500,14,751588.46,5653,7809,2156,7057.357143,593.9323683
Cell R52,500,14,751588.46,6784,8220,1436,7677.714286,399.5904025
Cell R53,500,14,751588.46,7532,8136,604,7873.714286,163.1565543
Cell R54,500,15,805273.35,7297,8425,1128,8158.733333,364.1482238
Cell R58,500,14,751588.46,5958,8750,2792,8044.357143,764.6687992
Cell R59,500,15,805273.35,6779,7205,426,6996.266667,132.3925812
Cell R6,500,14,751588.46,7776,8059,283,7897.214286,93.43154757
Cell R60,500,14,751588.46,6505,8000,1495,7086.785714,518.5448291
Cell R61,500,15,805273.35,3560,8230,4670,7315.8,1487.712616
Cell R62,500,14,751588.46,6261,8385,2124,7371,658.8217838
Cell R63,500,14,751588.46,7252,7946,694,7609.214286,155.6475775
Cell R64,500,14,751588.46,7787,8368,581,7997.571429,130.256184
Cell R65,500,15,805273.35,6794,7762,968,7304.4,278.5253549
Cell R66,500,14,751588.46,8238,8783,545,8523.642857,144.5157466
Cell R69,500,14,751588.46,3390,8776,5386,6717.142857,1558.391793
Cell R7,500,14,751588.46,6275,8969,2694,7826.785714,641.8937583
Cell R70,500,15,805273.35,6217,8958,2741,7841.6,849.4994448
Cell R71,500,14,751588.46,6461,7527,1066,6838.571429,345.4822125
Cell R72,500,14,751588.46,4422,7843,3421,5918.857143,1017.472208
Cell R73,500,14,751588.46,7050,8345,1295,7843.928571,431.5416656
Cell R74,500,14,751588.46,6937,8294,1357,7985.785714,384.6962027
Cell R75,500,15,805273.35,7707,8389,682,8106.066667,240.5295454
Cell R76,500,14,751588.46,7735,8837,1102,8589.214286,379.9671374
Cell R77,500,14,751588.46,7608,8199,591,7958.571429,147.9153785
Cell R8,500,14,751588.46,7527,8849,1322,8264.142857,401.7683869
Cell R80,500,15,805273.35,5055,8686,3631,7303.333333,781.2047676
Cell R81,500,15,805273.35,6598,8270,1672,7043.4,469.9114527
Cell R82,500,14,751588.46,5904,8118,2214,7196.5,675.3206381
Cell R83,500,14,751588.46,6654,8532,1878,7740.428571,516.6679943
Cell R84,500,14,751588.46,4789,8329,3540,7379.642857,985.3707502
Cell R85,500,15,805273.35,7099,7971,872,7507.933333,288.9490074
Cell R86,500,14,751588.46,7772,8406,634,8097.928571,168.9490474
Cell R87,500,16,858958.24,7467,8219,752,7782.625,214.4944274
Cell R9,500,15,805273.35,6167,8177,2010,7307.933333,692.9911463
Cell R90,500,14,751588.46,7018,7917,899,7505.571429,243.0369502
Cell R91,500,15,805273.35,7079,8602,1523,8056.533333,500.5696577
Cell R92,500,14,751588.46,6339,9280,2941,7273.285714,831.2044985
Cell R93,500,15,805273.35,7058,7807,749,7479.333333,272.0133984
Cell R97,500,14,751588.46,7699,8271,572,7997.214286,170.3614555
Cell R98,500,16,858958.24,7395,8440,1045,7785.3125,335.7803819
Cell R99,500,14,751588.46,7212,8475,1263,7887.214286,408.0845813
Cell S102,500,15,805273.35,6670,8293,1623,7737.6,396.1792187
Cell S108,500,14,751588.46,7674,8284,610,7903.214286,210.1469481
Cell S13,500,14,751588.46,7127,8163,1036,7786.214286,227.0082373
Cell S14,500,15,805273.35,7310,8299,989,7654.066667,243.3922668
Cell S2,500,16,858958.24,8110,8425,315,8327.1875,79.20086706
Cell S23,500,14,751588.46,8255,8606,351,8446.642857,111.1515099
Cell S32,500,14,751588.46,8017,8566,549,8339.642857,168.8505709
Cell S33,500,14,751588.46,7605,8070,465,7779.642857,139.6964092
Cell S34,500,15,805273.35,7629,8776,1147,8051.666667,291.6275402
Cell S41,500,14,751588.46,7441,8260,819,7905.5,256.2553832
Cell S42,500,15,805273.35,8163,8920,757,8540.066667,227.0910145
Cell S44,500,14,751588.46,7682,8592,910,7903.071429,240.3599872
Cell S56,500,15,805273.35,7128,8399,1271,7770.933333,293.7451201
Cell S67,500,16,858958.24,7051,8228,1177,7932.25,346.7370221
Cell S78,500,14,751588.46,7939,8929,990,8734.142857,246.8408559
Cell S88,500,16,858958.24,7301,8570,1269,8038.5625,414.8534333
Cell S94,500,16,858958.24,8011,8425,414,8260,132.3886324
Cell S95,500,16,858958.24,7811,8378,567,8200.875,210.3202543
W287,500,14,751588.46,4841,7619,2778,6262.428571,896.2514566
W295,500,14,751588.46,3335,7869,4534,5988.285714,1711.83529
W338,500,16,858958.24,5143,7717,2574,6901.0625,749.3617675
W342,500,15,805273.35,4841,7793,2952,6955.533333,805.3393377
W345,500,16,858958.24,7185,7740,555,7471.625,138.9788091
W387,500,15,805273.35,5933,7371,1438,6607.4,486.372395
W393,500,16,858958.24,6880,7710,830,7364.75,205.9160933
W440,500,14,751588.46,4759,6981,2222,6314.642857,533.0396135
W441,500,15,805273.35,7462,7764,302,7639,114.7054198
W445,500,16,858958.24,6822,7326,504,7034.75,206.064462
W500,500,14,751588.46,7772,8447,675,8194.428571,228.3611533
1,750,32,1717916.48,7723,8136,413,7936.78125,112.3670699
2,750,33,1771601.37,4854,7705,2851,6723.787879,782.4963068
3,750,34,1825286.26,7486,8285,799,7915.029412,158.388481
4,750,32,1717916.48,7379,7966,587,7676.65625,142.3408342
5,750,33,1771601.37,6537,7204,667,6889.333333,207.1491436
6,750,33,1771601.37,7250,8530,1280,8207.969697,306.6881236
7,750,33,1771601.37,5720,8301,2581,7431.939394,760.1966229
8,750,34,1825286.26,3078,8121,5043,6544.411765,1378.541922
9,750,34,1825286.26,7346,8584,1238,8073.647059,340.6606801
10,750,32,1717916.48,5914,8062,2148,7441.65625,440.5079177
11,750,32,1717916.48,6691,8163,1472,7408.65625,407.4824083
12,750,32,1717916.48,2348,8212,5864,6986.1875,1295.620253
13,750,32,1717916.48,5653,8264,2611,7174.03125,692.7792074
14,750,34,1825286.26,6238,8444,2206,7579.558824,699.3028962
16,750,32,1717916.48,1731,8776,7045,6376.78125,2108.749685
17,750,33,1771601.37,6011,8221,2210,7107.575758,601.1756175
18,750,34,1825286.26,4759,9170,4411,7746.352941,895.0939774
19,750,34,1825286.26,4826,8460,3634,6888.705882,872.0474059
20,750,32,1717916.48,7131,8421,1290,8109.34375,264.6705038
21,750,34,1825286.26,7573,8387,814,7970.676471,205.9608359
22,750,33,1771601.37,-834,9500,10334,6028.151515,2915.223097
23,750,37,1986340.93,3088,8594,5506,7049.108108,1140.689308
24,750,32,1717916.48,7079,8602,1523,8019.90625,454.3959149
25,750,36,1932656.04,6475,8282,1807,7549.611111,344.3594922
26,750,33,1771601.37,7323,8263,940,7849.181818,251.4779892
27,750,33,1771601.37,7395,8474,1079,7923.757576,361.2818115
28,750,33,1771601.37,6418,8093,1675,7570.545455,489.7209528
29,750,33,1771601.37,7795,8718,923,8336.545455,202.5561038
31,750,33,1771601.37,7895,8340,445,8176.848485,132.0165557
32,750,33,1771601.37,6443,7850,1407,7212.575758,398.4417398
33,750,32,1717916.48,6804,7212,408,7015.5,117.1209311
34,750,34,1825286.26,5658,7369,1711,6784.441176,464.8700762
10A,750,32,1717916.48,6471,9189,2718,8179.6875,465.6817876
10NE,750,32,1717916.48,6258,7432,1174,7120.0625,316.4983153
10NW,750,32,1717916.48,6703,7879,1176,7294.34375,297.1653169
10SW,750,32,1717916.48,5234,8592,3358,7314.90625,904.5193945
11NE,750,35,1878971.15,5190,8109,2919,7399.028571,506.614843
11NW,750,32,1717916.48,7028,8608,1580,7718.5625,379.1843992
11SE,750,33,1771601.37,7109,8632,1523,7783.787879,358.5346235
17NW,750,33,1771601.37,6779,7561,782,7037.424242,186.4390436
17SE,750,32,1717916.48,4222,7673,3451,6923.84375,620.7024805
17SW,750,32,1717916.48,4404,9597,5193,7758.375,1205.396142
22S,750,32,1717916.48,1170,9381,8211,6709.03125,1632.064882
23S,750,32,1717916.48,1834,4285,2451,2695.71875,627.9528363
24S,750,32,1717916.48,7079,8602,1523,8087.125,434.1727587
27A,750,32,1717916.48,6448,8956,2508,7885,480.7798353
2A,750,33,1771601.37,6223,8812,2589,7582.939394,597.3839403
5NE,750,33,1771601.37,5667,7857,2190,7110.212121,534.3615708
5NW,750,33,1771601.37,2829,7965,5136,5877,1124.444024
5SE,750,32,1717916.48,1687,8449,6762,6479.4375,1849.853997
6NE,750,35,1878971.15,6636,8579,1943,8044.114286,600.0763176
6NW,750,35,1878971.15,6854,8994,2140,8051.114286,487.0115734
6SW,750,34,1825286.26,5103,8808,3705,7971.676471,779.9899969
Cell 1 2011/12,750,32,1717916.48,7723,8136,413,7936.78125,112.3670699
Cell 1 SW 2013,750,32,1717916.48,6376,7410,1034,6997.90625,297.7112023
Cell 10 2011/12,750,32,1717916.48,5914,8062,2148,7441.65625,440.5079177
Cell 10 NE 2011/12,750,32,1717916.48,6258,7432,1174,7120.0625,316.4983153
Cell 10 NW 2011/12,750,32,1717916.48,6703,7879,1176,7294.34375,297.1653169
Cell 10 SE 2013,750,34,1825286.26,7203,8994,1791,8086.323529,448.0702886
Cell 10 SW 2011/12,750,32,1717916.48,5234,8592,3358,7314.90625,904.5193945
Cell 10-A 2011/12,750,32,1717916.48,6471,9189,2718,8179.6875,465.6817876
Cell 11 NE 2011/12,750,35,1878971.15,5190,8109,2919,7399.028571,506.614843
Cell 11 NW 2013,750,34,1825286.26,6223,8077,1854,7334.058824,606.191289
Cell 11 SW 2013,750,33,1771601.37,6492,8440,1948,7395.484848,511.6338725
Cell 12 2013,750,33,1771601.37,5720,8301,2581,7431.939394,760.1966229
Cell 13 2013,750,34,1825286.26,3078,8121,5043,6215.882353,1607.923776
Cell 14 2013,750,32,1717916.48,7320,8316,996,7799.96875,242.4537951
Cell 15 2013,750,33,1771601.37,7167,8411,1244,7957.969697,311.6712997
Cell 15-A 2013,750,33,1771601.37,7323,8070,747,7814.181818,191.6492147
Cell 16 2013,750,33,1771601.37,7326,8798,1472,7818,266.2123782
Cell 17 NW 2011/12,750,33,1771601.37,6779,7561,782,7037.424242,186.4390436
Cell 17 NW 2013,750,35,1878971.15,2952,7501,4549,5935.342857,1361.773087
Cell 17 SE 2013,750,32,1717916.48,6703,7879,1176,7294.34375,297.1653169
Cell 17 SW 2013,750,32,1717916.48,6537,7259,722,6881.84375,203.4970991
Cell 18 2011/12,750,34,1825286.26,4759,9170,4411,7746.352941,895.0939774
Cell 18 NE 2013,750,32,1717916.48,5103,8824,3721,7960.9375,785.2827093
Cell 18 NW 2013,750,34,1825286.26,1687,8449,6762,6399.529412,1749.023362
Cell 18 SE 2013,750,35,1878971.15,5190,8109,2919,7399.028571,506.614843
Cell 18 SSE 2013,750,33,1771601.37,7003,8258,1255,7686.636364,319.2462542
Cell 19 NW 2013,750,33,1771601.37,6512,8516,2004,7991.848485,562.2512714
Cell 2 2011/12,750,33,1771601.37,4854,7705,2851,6723.787879,782.4963068
Cell 2 NE 2013,750,32,1717916.48,6030,8997,2967,7711.84375,883.0719503
Cell 2 SW 2013,750,32,1717916.48,7723,8136,413,7936.78125,112.3670699
Cell 20 2013,750,33,1771601.37,7413,8199,786,7856.393939,221.6970277
Cell 21 2013,750,32,1717916.48,4970,8914,3944,6423.28125,1178.667183
Cell 22 2013,750,34,1825286.26,6917,8254,1337,7730.617647,392.9555442
Cell 23 2013,750,35,1878971.15,7834,8920,1086,8538.285714,247.7152249
Cell 24 2013,750,34,1825286.26,7495,8963,1468,8081.5,395.6007531
Cell 25 NE 2013,750,32,1717916.48,5914,8062,2148,7441.65625,440.5079177
Cell 25 SE 2013,750,32,1717916.48,5234,8592,3358,7314.90625,904.5193945
Cell 26 NE 2013,750,32,1717916.48,6691,8163,1472,7408.65625,407.4824083
Cell 26 NNW 2013,750,32,1717916.48,6258,7432,1174,7120.0625,316.4983153
Cell 26 NW 2013,750,32,1717916.48,6471,9189,2718,8179.6875,465.6817876
Cell 27 NW 2013,750,33,1771601.37,7109,8632,1523,7783.787879,358.5346235
Cell 28 2013,750,32,1717916.48,2348,8212,5864,6986.1875,1295.620253
Cell 29 2013,750,32,1717916.48,5653,8264,2611,7174.03125,692.7792074
Cell 3 NE 2013,750,34,1825286.26,3256,9023,5767,7662.029412,1183.777739
Cell 3 NW 2013,750,32,1717916.48,6275,9048,2773,7638.78125,703.929317
Cell 30 2013,750,34,1825286.26,6794,8301,1507,7636.705882,425.0364365
Cell 31 2013,750,32,1717916.48,7228,8425,1197,8039.9375,402.5411421
Cell 32 2013,750,33,1771601.37,7051,8397,1346,7931.181818,334.2928724
Cell 33 NE 2013,750,33,1771601.37,6779,7561,782,7037.424242,186.4390436
Cell 33 SE 2013,750,32,1717916.48,4404,9597,5193,7758.375,1205.396142
Cell 33 SW 2013,750,33,1771601.37,1625,8776,7151,6207.515152,1980.313537
Cell 34 N 2013,750,33,1771601.37,6102,8037,1935,7333,441.0252518
Cell 34 NW 2013,750,33,1771601.37,6011,8221,2210,7107.575758,601.1756175
Cell 34 SE 2013,750,32,1717916.48,4222,7673,3451,6923.84375,620.7024805
Cell 35 2013,750,37,1986340.93,2457,9931,7474,7100.162162,1915.291997
Cell 37 2013,750,33,1771601.37,7131,8421,1290,8109.757576,261.0918833
Cell 38 2013,750,32,1717916.48,7573,8387,814,7973.96875,206.5737587
Cell 39 2013,750,33,1771601.37,7609,8929,1320,8601.333333,365.3998778
Cell 4 2013,750,33,1771601.37,7445,8386,941,7889.121212,293.4167331
Cell 40 NE 2013,750,36,1932656.04,4663,8686,4023,7164.722222,975.1153952
Cell 41 N 2013,750,32,1717916.48,7730,9851,2121,8461.0625,721.0548669
Cell 41 NW 2013,750,32,1717916.48,720,9647,8927,5852.3125,3123.443577
Cell 42 NW 2013,750,32,1717916.48,2403,8501,6098,6802,1411.731317
Cell 43 2013,750,32,1717916.48,6819,8227,1408,7615.9375,340.3239208
Cell 44 2013,750,32,1717916.48,7195,8497,1302,8044.8125,363.907306
Cell 45 2013,750,33,1771601.37,7323,8263,940,7849.181818,251.4779892
Cell 47 2013,750,34,1825286.26,7018,8053,1035,7623.735294,258.3050304
Cell 48 2013,750,33,1771601.37,7079,8602,1523,8091.393939,428.2252267
Cell 49 2013,750,36,1932656.04,6475,8282,1807,7549.611111,344.3594922
Cell 5 2011/12 Summer,750,32,1717916.48,6537,7259,722,6881.84375,203.4970991
Cell 5 2013,750,34,1825286.26,7319,8707,1388,8107.264706,305.9831126
Cell 50 2013,750,33,1771601.37,7795,8718,923,8336.545455,202.5561038
Cell 51 2013,750,32,1717916.48,7811,8556,745,8149.5625,218.0653482
Cell 52 2013,750,32,1717916.48,7212,8535,1323,7941.71875,371.7084908
Cell 53 2013,750,33,1771601.37,6418,8093,1675,7570.545455,489.7209528
Cell 54 2013,750,33,1771601.37,7320,8738,1418,8231,363.9234019
Cell 55 2013,750,34,1825286.26,6942,8784,1842,8032.323529,350.1832059
Cell 56 2013,750,32,1717916.48,6804,7212,408,7015.5,117.1209311
Cell 57 2013,750,33,1771601.37,6443,7850,1407,7212.575758,398.4417398
Cell 58 2013,750,34,1825286.26,7810,8783,973,8281.470588,304.9064693
Cell 59 2013,750,35,1878971.15,6692,7814,1122,7253.371429,317.6559761
Cell 6 2011/12,750,33,1771601.37,7250,8530,1280,8207.969697,306.6881236
Cell 6 2013,750,33,1771601.37,7327,8425,1098,8261.909091,199.0211445
Cell 6 NE 2011/12,750,35,1878971.15,6636,8579,1943,8044.114286,600.0763176
Cell 6 NW 2011/12,750,35,1878971.15,6854,8994,2140,8051.114286,487.0115734
Cell 6 SW 2011/12,750,34,1825286.26,5103,8808,3705,7971.676471,779.9899969
Cell 60 2013,750,32,1717916.48,6169,7816,1647,7174.03125,358.7399375
Cell 61 2013,750,33,1771601.37,7140,8549,1409,7848.666667,381.7577105
Cell 7 2013,750,32,1717916.48,7310,8321,1011,7754.84375,273.8634593
Cell 9 NW 2013,750,33,1771601.37,2749,8044,5295,6511.636364,1387.173381
Cell 9 SE 2013,750,33,1771601.37,5667,7857,2190,7110.212121,534.3615708
Cell 9 SW 2013,750,33,1771601.37,2829,7965,5136,5877,1124.444024
Cell R1,750,37,1986340.93,6260,8178,1918,7055.081081,581.4255258
Cell R10,750,33,1771601.37,7445,8386,941,7889.121212,293.4167331
Cell R100,750,33,1771601.37,7795,8718,923,8336.545455,202.5561038
Cell R101,750,33,1771601.37,7513,8353,840,8014.606061,254.8094879
Cell R104,750,32,1717916.48,7490,8232,742,7997.75,156.6640514
Cell R105,750,33,1771601.37,6418,8093,1675,7570.545455,489.7209528
Cell R106,750,33,1771601.37,6661,8452,1791,7905.30303,445.1418899
Cell R107,750,33,1771601.37,7320,8738,1418,8231,363.9234019
Cell R11,750,34,1825286.26,7319,8707,1388,8107.264706,305.9831126
Cell R111,750,32,1717916.48,7160,8632,1472,8271.3125,387.5398719
Cell R112,750,34,1825286.26,7475,8294,819,8027.823529,165.0328792
Cell R113,750,33,1771601.37,6443,7850,1407,7212.575758,398.4417398
Cell R114,750,34,1825286.26,7810,8783,973,8281.470588,304.9064693
Cell R117,750,34,1825286.26,6300,7891,1591,7132.941176,405.3281126
Cell R118,750,32,1717916.48,6804,7212,408,7015.5,117.1209311
Cell R119,750,32,1717916.48,4316,7325,3009,6273.96875,872.3077326
Cell R120,750,37,1986340.93,8128,8513,385,8334.351351,106.8899955
Cell R121,750,34,1825286.26,6617,8308,1691,7625.735294,468.7483527
Cell R123,750,33,1771601.37,7121,8233,1112,7702,310.3918345
Cell R124,750,32,1717916.48,6712,7914,1202,7222.34375,350.0555857
Cell R125,750,32,1717916.48,6762,7966,1204,7426.4375,351.6156404
Cell R126,750,32,1717916.48,6962,8527,1565,8058.28125,334.5050667
Cell R15,750,32,1717916.48,6376,7410,1034,6997.90625,297.7112023
Cell R16,750,34,1825286.26,2749,8044,5295,6326.529412,1507.922221
Cell R17,750,33,1771601.37,5871,8643,2772,7296.272727,836.7174054
Cell R18,750,32,1717916.48,6223,8077,1854,7317.625,621.1629592
Cell R19,750,34,1825286.26,7212,8153,941,7859.441176,245.6613153
Cell R20,750,35,1878971.15,7347,7827,480,7524.571429,139.6997363
Cell R21,750,34,1825286.26,7191,8005,814,7638.235294,205.3883064
Cell R22,750,32,1717916.48,7320,8316,996,7799.96875,242.4537951
Cell R24,750,35,1878971.15,2952,7501,4549,5935.342857,1361.773087
Cell R25,750,34,1825286.26,1687,8449,6762,6399.529412,1749.023362
Cell R26,750,32,1717916.48,6854,8593,1739,8002.6875,451.6459784
Cell R27,750,33,1771601.37,6512,8516,2004,7991.848485,562.2512714
Cell R28,750,33,1771601.37,4394,8722,4328,7098.090909,1242.09655
Cell R29,750,33,1771601.37,7413,8199,786,7856.393939,221.6970277
Cell R30,750,33,1771601.37,5843,8074,2231,7548.606061,522.8231023
Cell R31,750,32,1717916.48,6171,8653,2482,7998.6875,506.5771435
Cell R35,750,32,1717916.48,6537,7259,722,6881.84375,203.4970991
Cell R36,750,32,1717916.48,6703,7879,1176,7294.34375,297.1653169
Cell R37,750,35,1878971.15,5190,8109,2919,7399.028571,506.614843
Cell R38,750,32,1717916.48,7824,8488,664,8194.03125,178.7659931
Cell R39,750,33,1771601.37,7351,8154,803,7831.69697,191.5549585
Cell R40,750,33,1771601.37,4970,8914,3944,6449.757576,1170.294628
Cell R46,750,32,1717916.48,1611,6838,5227,4886.6875,1312.031474
Cell R47,750,32,1717916.48,6471,9189,2718,8179.6875,465.6817876
Cell R48,750,32,1717916.48,6691,8163,1472,7408.65625,407.4824083
Cell R49,750,33,1771601.37,7109,8632,1523,7783.787879,358.5346235
Cell R5,750,35,1878971.15,-1428,7416,8844,6511.942857,1448.376982
Cell R50,750,32,1717916.48,2348,8212,5864,6986.1875,1295.620253
Cell R51,750,32,1717916.48,5653,8264,2611,7174.03125,692.7792074
Cell R52,750,32,1717916.48,6695,8220,1525,7515.53125,439.2723375
Cell R53,750,34,1825286.26,7263,8136,873,7885.235294,201.5342707
Cell R54,750,32,1717916.48,7228,8425,1197,8039.9375,402.5411421
Cell R58,750,33,1771601.37,4911,8750,3839,7452.181818,1197.87725
Cell R59,750,33,1771601.37,6779,7561,782,7037.424242,186.4390436
Cell R6,750,32,1717916.48,7723,8136,413,7936.78125,112.3670699
Cell R60,750,33,1771601.37,6011,8221,2210,7107.575758,601.1756175
Cell R61,750,37,1986340.93,2457,9931,7474,7100.162162,1915.291997
Cell R62,750,33,1771601.37,4826,8697,3871,7102.606061,934.3944381
Cell R63,750,34,1825286.26,7252,7946,694,7603.294118,160.3045868
Cell R64,750,34,1825286.26,7766,8429,663,8020.852941,168.389802
Cell R65,750,34,1825286.26,6794,8301,1507,7636.705882,425.0364365
Cell R66,750,32,1717916.48,7833,8921,1088,8582.25,198.1426254
Cell R69,750,33,1771601.37,1625,8776,7151,6207.515152,1980.313537
Cell R7,750,32,1717916.48,6275,9048,2773,7638.78125,703.929317
Cell R70,750,32,1717916.48,4404,9597,5193,7758.375,1205.396142
Cell R71,750,33,1771601.37,4222,7673,3451,6923.242424,611.2350156
Cell R72,750,34,1825286.26,2573,7843,5270,5386.382353,1157.819427
Cell R73,750,32,1717916.48,7050,8345,1295,7916.25,411.2231754
Cell R74,750,33,1771601.37,5985,8294,2309,7757.090909,638.4990621
Cell R75,750,33,1771601.37,7131,8421,1290,8109.757576,261.0918833
Cell R76,750,32,1717916.48,7735,8903,1168,8557.15625,325.7064542
Cell R77,750,32,1717916.48,7573,8387,814,7973.96875,206.5737587
Cell R8,750,34,1825286.26,2662,8849,6187,7857.382353,1300.406385
Cell R80,750,35,1878971.15,4663,8686,4023,7211.2,948.8153456
Cell R81,750,33,1771601.37,6598,8685,2087,7225.969697,589.8517782
Cell R82,750,32,1717916.48,2403,8501,6098,6802,1411.731317
Cell R83,750,32,1717916.48,6654,8644,1990,7836.625,552.3333318
Cell R84,750,33,1771601.37,4035,8329,4294,6952.969697,1283.494295
Cell R85,750,32,1717916.48,6819,8227,1408,7615.9375,340.3239208
Cell R86,750,33,1771601.37,7488,8406,918,8032.30303,189.8079548
Cell R87,750,33,1771601.37,7323,8263,940,7849.181818,251.4779892
Cell R9,750,35,1878971.15,5869,8177,2308,7390.285714,727.5674371
Cell R90,750,33,1771601.37,7018,8053,1035,7615.060606,257.2641538
Cell R91,750,33,1771601.37,7079,8602,1523,8091.393939,428.2252267
Cell R92,750,32,1717916.48,1665,9280,7615,6440.71875,2106.328325
Cell R93,750,37,1986340.93,6475,8282,1807,7546.378378,340.2274558
Cell R97,750,32,1717916.48,7437,8271,834,7960.1875,174.5776041
Cell R98,750,33,1771601.37,7395,8474,1079,7923.757576,361.2818115
Cell R99,750,33,1771601.37,7212,8535,1323,7949.060606,368.3818786
Cell S102,750,32,1717916.48,6670,8293,1623,7753.625,365.3587064
Cell S108,750,34,1825286.26,6942,8784,1842,8032.323529,350.1832059
Cell S13,750,33,1771601.37,7127,8396,1269,7765.393939,271.029456
Cell S14,750,32,1717916.48,7310,8321,1011,7754.84375,273.8634593
Cell S2,750,33,1771601.37,7327,8425,1098,8261.909091,199.0211445
Cell S23,750,34,1825286.26,8252,8634,382,8460.441176,108.1176351
Cell S32,750,33,1771601.37,7041,8615,1574,8144.909091,389.9059998
Cell S33,750,33,1771601.37,7323,8070,747,7814.181818,191.6492147
Cell S34,750,34,1825286.26,7495,8963,1468,8081.5,395.6007531
Cell S41,750,34,1825286.26,6697,8260,1563,7778.029412,401.9776468
Cell S42,750,35,1878971.15,7834,8920,1086,8538.285714,247.7152249
Cell S44,750,32,1717916.48,7669,8592,923,7920.03125,203.9455326
Cell S56,750,33,1771601.37,6630,8399,1769,7588.151515,390.4457531
Cell S67,750,33,1771601.37,7051,8397,1346,7931.181818,334.2928724
Cell S78,750,33,1771601.37,7609,8929,1320,8601.333333,365.3998778
Cell S88,750,33,1771601.37,7227,8570,1343,8051.636364,396.1087101
Cell S94,750,33,1771601.37,8011,8556,545,8273.69697,159.9169263
Cell S95,750,32,1717916.48,7811,8556,745,8149.5625,218.0653482
W287,750,32,1717916.48,3389,7906,4517,6050.90625,1193.013054
W295,750,33,1771601.37,3335,7869,4534,6340.69697,1554.719101
W338,750,34,1825286.26,4324,7778,3454,6766.5,1021.527986
W342,750,35,1878971.15,4841,7793,2952,7013.914286,664.6957358
W345,750,33,1771601.37,6909,7740,831,7445.242424,171.7337669
W387,750,33,1771601.37,5624,7371,1747,6669.939394,493.0637637
W393,750,34,1825286.26,6880,7710,830,7294.088235,188.5497855
W440,750,32,1717916.48,4193,6981,2788,5955.09375,894.2031844
W441,750,34,1825286.26,7358,7819,461,7628.058824,109.3553143
W445,750,35,1878971.15,6307,7365,1058,7051.257143,245.2122513
W500,750,33,1771601.37,4424,8447,4023,7873.060606,727.259611
1,1000,60,3221093.4,7547,8180,633,7939.883333,144.6125965
2,1000,60,3221093.4,4141,8033,3892,6676.416667,1053.969438
3,1000,58,3113723.62,7486,8311,825,7935.465517,172.0939214
4,1000,58,3113723.62,7311,7985,674,7668.155172,162.9884491
5,1000,58,3113723.62,5598,7284,1686,6853.810345,344.7820629
6,1000,59,3167408.51,6646,8530,1884,8245.610169,328.8631685
7,1000,60,3221093.4,5720,8301,2581,7539.283333,657.351329
8,1000,58,3113723.62,3078,8121,5043,6328.689655,1432.258792
9,1000,58,3113723.62,6917,8584,1667,7947.741379,422.0119528
10,1000,59,3167408.51,3774,8062,4288,7181.711864,849.2906522
11,1000,57,3060038.73,6691,8163,1472,7463.192982,405.5058543
12,1000,58,3113723.62,2348,8212,5864,6691.448276,1687.815066
13,1000,58,3113723.62,5653,8359,2706,7367.017241,672.0054262
14,1000,58,3113723.62,6238,8444,2206,7674.741379,645.5398051
16,1000,57,3060038.73,1125,8776,7651,5628.315789,2392.47773
17,1000,58,3113723.62,6011,8503,2492,7351.051724,651.3095409
18,1000,62,3328463.18,1783,9707,7924,7329.096774,1782.784662
19,1000,60,3221093.4,2892,8697,5805,6547.566667,1163.308248
20,1000,58,3113723.62,7131,8421,1290,8087,235.2856664
21,1000,59,3167408.51,7432,8387,955,7961.440678,215.0188223
22,1000,60,3221093.4,-834,9500,10334,5961.166667,2767.837568
23,1000,61,3274778.29,2403,8594,6191,6501.147541,1702.98078
24,1000,58,3113723.62,7079,8602,1523,8123.362069,399.1771147
25,1000,61,3274778.29,6104,8282,2178,7492.737705,342.4610018
26,1000,60,3221093.4,7274,8307,1033,7907.933333,254.2714997
27,1000,58,3113723.62,6958,8474,1516,7970.431034,365.246875
28,1000,59,3167408.51,6418,8256,1838,7505.288136,515.7484951
29,1000,59,3167408.51,7624,8718,1094,8255.728814,245.652009
31,1000,59,3167408.51,7895,8350,455,8170.779661,124.1726611
32,1000,60,3221093.4,5444,8210,2766,7306.133333,545.8758854
33,1000,57,3060038.73,6404,7232,828,6935.894737,187.5958407
34,1000,62,3328463.18,5658,7786,2128,6887.435484,465.108715
10A,1000,56,3006353.84,3874,9189,5315,7924.375,1039.9293
10NE,1000,58,3113723.62,6165,7432,1267,7004.741379,397.1428806
10NW,1000,59,3167408.51,6124,7929,1805,7294.237288,377.1848146
10SW,1000,56,3006353.84,3104,8665,5561,6968.285714,1278.186728
11NE,1000,61,3274778.29,4280,8109,3829,7179.868852,851.7975684
11NW,1000,58,3113723.62,7028,8608,1580,7867.534483,400.9757158
11SE,1000,60,3221093.4,7029,8632,1603,7815.766667,347.2786281
17NW,1000,60,3221093.4,6769,7790,1021,7139.716667,252.3901142
17SE,1000,59,3167408.51,2816,7752,4936,6761.033898,1030.618557
17SW,1000,57,3060038.73,4114,9597,5483,7561.807018,1266.844269
22S,1000,59,3167408.51,710,9381,8671,6244.254237,2074.999715
23S,1000,58,3113723.62,1834,6437,4603,2855.293103,847.0657673
24S,1000,59,3167408.51,7079,8602,1523,8128.966102,400.3674992
27A,1000,58,3113723.62,5128,8956,3828,7592.827586,776.8475228
2A,1000,58,3113723.62,3199,8812,5613,7346.62069,931.6074508
5NE,1000,58,3113723.62,5477,9139,3662,7169.982759,676.4282079
5NW,1000,61,3274778.29,2456,8547,6091,6042.262295,1322.642981
5SE,1000,56,3006353.84,821,8449,7628,5661.678571,2162.024994
6NE,1000,60,3221093.4,6636,8579,1943,8005.833333,588.9428995
6NW,1000,60,3221093.4,6306,9147,2841,8028.833333,560.8157798
6SW,1000,59,3167408.51,5103,8824,3721,7941.983051,786.9076032
Cell 1 2011/12,1000,60,3221093.4,7547,8180,633,7939.883333,144.6125965
Cell 1 SW 2013,1000,57,3060038.73,4788,7411,2623,6917.684211,443.6960062
Cell 10 2011/12,1000,59,3167408.51,3774,8062,4288,7181.711864,849.2906522
Cell 10 NE 2011/12,1000,58,3113723.62,6165,7432,1267,7004.741379,397.1428806
Cell 10 NW 2011/12,1000,59,3167408.51,6124,7929,1805,7294.237288,377.1848146
Cell 10 SE 2013,1000,60,3221093.4,6306,9147,2841,8028.833333,560.8157798
Cell 10 SW 2011/12,1000,56,3006353.84,3104,8665,5561,6968.285714,1278.186728
Cell 10-A 2011/12,1000,56,3006353.84,3874,9189,5315,7924.375,1039.9293
Cell 11 NE 2011/12,1000,61,3274778.29,4280,8109,3829,7179.868852,851.7975684
Cell 11 NW 2013,1000,58,3113723.62,5723,8091,2368,7275.982759,600.4474048
Cell 11 SW 2013,1000,58,3113723.62,6177,8493,2316,7507.241379,585.7306169
Cell 12 2013,1000,60,3221093.4,5720,8301,2581,7539.283333,657.351329
Cell 13 2013,1000,58,3113723.62,3078,8121,5043,6186.741379,1612.04067
Cell 14 2013,1000,58,3113723.62,7320,8692,1372,7888.034483,288.5531664
Cell 15 2013,1000,60,3221093.4,7167,8411,1244,7940.5,277.7438568
Cell 15-A 2013,1000,58,3113723.62,7198,8333,1135,7847.586207,267.7764144
Cell 16 2013,1000,59,3167408.51,7186,8858,1672,7858.271186,343.2552951
Cell 17 NW 2011/12,1000,60,3221093.4,6769,7790,1021,7139.716667,252.3901142
Cell 17 NW 2013,1000,59,3167408.51,2952,7711,4759,5981.322034,1404.160916
Cell 17 SE 2013,1000,59,3167408.51,6124,7929,1805,7294.237288,377.1848146
Cell 17 SW 2013,1000,58,3113723.62,5598,7284,1686,6875.224138,299.1482185
Cell 18 2011/12,1000,62,3328463.18,1783,9707,7924,7329.096774,1782.784662
Cell 18 NE 2013,1000,58,3113723.62,5103,8824,3721,7893.948276,774.7178446
Cell 18 NW 2013,1000,62,3328463.18,821,8449,7628,5644.5,2100.537564
Cell 18 SE 2013,1000,60,3221093.4,4280,8109,3829,7183.133333,858.488021
Cell 18 SSE 2013,1000,60,3221093.4,7003,8258,1255,7654.1,312.5229432
Cell 19 NW 2013,1000,59,3167408.51,6512,8516,2004,7973.728814,586.9279063
Cell 2 2011/12,1000,60,3221093.4,4141,8033,3892,6676.416667,1053.969438
Cell 2 NE 2013,1000,60,3221093.4,5882,8997,3115,7790.933333,855.034714
Cell 2 SW 2013,1000,59,3167408.51,7547,8180,633,7938.864407,145.6192455
Cell 20 2013,1000,58,3113723.62,7334,8199,865,7801.741379,243.0150812
Cell 21 2013,1000,58,3113723.62,4970,8914,3944,6832.275862,1191.864647
Cell 22 2013,1000,59,3167408.51,6917,8349,1432,7742.542373,420.8133095
Cell 23 2013,1000,60,3221093.4,7834,8920,1086,8573,230.0273897
Cell 24 2013,1000,60,3221093.4,7050,8963,1913,8098.6,441.6837556
Cell 25 NE 2013,1000,59,3167408.51,3774,8062,4288,7181.711864,849.2906522
Cell 25 SE 2013,1000,56,3006353.84,3104,8665,5561,6968.285714,1278.186728
Cell 26 NE 2013,1000,57,3060038.73,6691,8163,1472,7463.192982,405.5058543
Cell 26 NNW 2013,1000,58,3113723.62,6165,7432,1267,7004.741379,397.1428806
Cell 26 NW 2013,1000,56,3006353.84,3874,9189,5315,7924.375,1039.9293
Cell 27 NW 2013,1000,60,3221093.4,7029,8632,1603,7815.766667,347.2786281
Cell 28 2013,1000,58,3113723.62,2348,8212,5864,6691.448276,1687.815066
Cell 29 2013,1000,58,3113723.62,5653,8359,2706,7367.017241,672.0054262
Cell 3 NE 2013,1000,58,3113723.62,-959,9023,9982,7297.741379,1823.453512
Cell 3 NW 2013,1000,60,3221093.4,6275,9266,2991,7527.8,775.9310064
Cell 30 2013,1000,62,3328463.18,6794,8427,1633,7793.145161,404.6455178
Cell 31 2013,1000,57,3060038.73,7228,8482,1254,8109.877193,354.2955982
Cell 32 2013,1000,59,3167408.51,6879,8533,1654,7850.389831,385.1313673
Cell 33 NE 2013,1000,60,3221093.4,6769,7790,1021,7139.716667,252.3901142
Cell 33 SE 2013,1000,58,3113723.62,4114,9597,5483,7565.862069,1256.248815
Cell 33 SW 2013,1000,58,3113723.62,1125,8776,7651,5888.172414,2159.854594
Cell 34 N 2013,1000,58,3113723.62,6102,8144,2042,7405.87931,391.7426177
Cell 34 NW 2013,1000,58,3113723.62,6011,8503,2492,7351.051724,651.3095409
Cell 34 SE 2013,1000,59,3167408.51,2816,7752,4936,6841.186441,895.7580915
Cell 35 2013,1000,61,3274778.29,2380,9950,7570,6971.360656,2178.040472
Cell 37 2013,1000,60,3221093.4,7131,8421,1290,8102.233333,228.8226654
Cell 38 2013,1000,56,3006353.84,7432,8387,955,7968.321429,219.1556123
Cell 39 2013,1000,58,3113723.62,6681,8929,2248,8543.775862,419.0072851
Cell 4 2013,1000,59,3167408.51,7287,8386,1099,7840.186441,271.5898874
Cell 40 NE 2013,1000,61,3274778.29,3115,9381,6266,7009.885246,1196.144038
Cell 41 N 2013,1000,57,3060038.73,5163,9959,4796,8437.280702,824.2823514
Cell 41 NW 2013,1000,60,3221093.4,720,9647,8927,6249.983333,2956.354289
Cell 42 NW 2013,1000,56,3006353.84,2362,8594,6232,6233.535714,1861.311394
Cell 43 2013,1000,57,3060038.73,6819,8422,1603,7718.140351,382.2486762
Cell 44 2013,1000,56,3006353.84,7195,8497,1302,8048.446429,395.8540911
Cell 45 2013,1000,59,3167408.51,7274,8307,1033,7907.20339,256.3549433
Cell 47 2013,1000,58,3113723.62,6810,8286,1476,7615.293103,285.0687158
Cell 48 2013,1000,59,3167408.51,7079,8602,1523,8128.966102,400.3674992
Cell 49 2013,1000,61,3274778.29,6104,8282,2178,7492.737705,342.4610018
Cell 5 2011/12 Summer,1000,58,3113723.62,5598,7284,1686,6875.224138,299.1482185
Cell 5 2013,1000,58,3113723.62,7319,8707,1388,8078.051724,302.5619015
Cell 50 2013,1000,60,3221093.4,7624,8718,1094,8250.45,246.9478639
Cell 51 2013,1000,59,3167408.51,7777,8697,920,8154.40678,250.1791981
Cell 52 2013,1000,58,3113723.62,7097,8535,1438,7909.810345,358.5601694
Cell 53 2013,1000,58,3113723.62,6418,8256,1838,7503.413793,519.9763269
Cell 54 2013,1000,60,3221093.4,7320,8743,1423,8264.5,350.9637921
Cell 55 2013,1000,58,3113723.62,6942,8815,1873,8105.931034,393.3554093
Cell 56 2013,1000,57,3060038.73,6404,7232,828,6943.684211,190.4888594
Cell 57 2013,1000,60,3221093.4,5444,8210,2766,7306.133333,545.8758854
Cell 58 2013,1000,58,3113723.62,7810,8841,1031,8320.034483,306.3996132
Cell 59 2013,1000,62,3328463.18,6692,7892,1200,7254.435484,321.5684656
Cell 6 2011/12,1000,59,3167408.51,6646,8530,1884,8245.610169,328.8631685
Cell 6 2013,1000,59,3167408.51,7327,8554,1227,8281.016949,164.6837227
Cell 6 NE 2011/12,1000,60,3221093.4,6636,8579,1943,8005.833333,588.9428995
Cell 6 NW 2011/12,1000,60,3221093.4,6306,9147,2841,8028.833333,560.8157798
Cell 6 SW 2011/12,1000,59,3167408.51,5103,8824,3721,7941.983051,786.9076032
Cell 60 2013,1000,57,3060038.73,5658,7816,2158,7156.789474,440.6670278
Cell 61 2013,1000,59,3167408.51,7140,8549,1409,7803.610169,356.975051
Cell 7 2013,1000,58,3113723.62,7310,8353,1043,7846.706897,296.2072905
Cell 9 NW 2013,1000,60,3221093.4,2749,8239,5490,6367.15,1571.14963
Cell 9 SE 2013,1000,58,3113723.62,5477,9139,3662,7169.982759,676.4282079
Cell 9 SW 2013,1000,61,3274778.29,2456,8547,6091,6042.262295,1322.642981
Cell R1,1000,61,3274778.29,6051,8178,2127,7056.901639,574.7389915
Cell R10,1000,59,3167408.51,7287,8386,1099,7840.186441,271.5898874
Cell R100,1000,60,3221093.4,7624,8718,1094,8250.45,246.9478639
Cell R101,1000,59,3167408.51,7513,8391,878,8065.525424,235.2695789
Cell R104,1000,60,3221093.4,7490,8232,742,7966.366667,157.1151347
Cell R105,1000,59,3167408.51,6418,8256,1838,7505.288136,515.7484951
Cell R106,1000,61,3274778.29,6223,8480,2257,7756.04918,633.4980023
Cell R107,1000,60,3221093.4,7320,8743,1423,8264.5,350.9637921
Cell R11,1000,58,3113723.62,7319,8707,1388,8078.051724,302.5619015
Cell R111,1000,60,3221093.4,7160,8732,1572,8181.516667,437.9000454
Cell R112,1000,58,3113723.62,7475,8294,819,8021.603448,165.2609159
Cell R113,1000,60,3221093.4,5444,8210,2766,7306.133333,545.8758854
Cell R114,1000,58,3113723.62,7810,8841,1031,8320.034483,306.3996132
Cell R117,1000,62,3328463.18,6206,7891,1685,7059.870968,393.6299426
Cell R118,1000,57,3060038.73,6404,7232,828,6943.684211,190.4888594
Cell R119,1000,59,3167408.51,3792,7521,3729,6401,891.7152392
Cell R120,1000,61,3274778.29,7196,8513,1317,8253.590164,262.6037579
Cell R121,1000,58,3113723.62,6617,8504,1887,7756.189655,463.180588
Cell R123,1000,58,3113723.62,7121,8233,1112,7631.293103,287.7056691
Cell R124,1000,58,3113723.62,6575,7914,1339,7280.568966,376.7560316
Cell R125,1000,57,3060038.73,6762,7988,1226,7471.017544,363.4209048
Cell R126,1000,59,3167408.51,6571,8549,1978,8006.762712,449.6333474
Cell R15,1000,56,3006353.84,4788,7411,2623,6911.446429,445.1558684
Cell R16,1000,59,3167408.51,2749,8239,5490,6335.966102,1565.887672
Cell R17,1000,60,3221093.4,4886,8643,3757,7380.316667,842.7474808
Cell R18,1000,60,3221093.4,6223,8812,2589,7366.566667,568.2029088
Cell R19,1000,61,3274778.29,7212,8153,941,7882.114754,230.3260767
Cell R20,1000,58,3113723.62,7347,8042,695,7590.482759,182.8012149
Cell R21,1000,58,3113723.62,7081,8067,986,7676.810345,241.5808894
Cell R22,1000,58,3113723.62,7320,8692,1372,7888.034483,288.5531664
Cell R24,1000,59,3167408.51,2952,7711,4759,5981.322034,1404.160916
Cell R25,1000,62,3328463.18,821,8449,7628,5644.5,2100.537564
Cell R26,1000,60,3221093.4,6854,8994,2140,8055.633333,478.6046025
Cell R27,1000,59,3167408.51,6512,8516,2004,7973.728814,586.9279063
Cell R28,1000,58,3113723.62,4394,8722,4328,7116.87931,1251.253579
Cell R29,1000,58,3113723.62,7334,8199,865,7801.741379,243.0150812
Cell R30,1000,59,3167408.51,5843,8415,2572,7547.186441,507.7119654
Cell R31,1000,56,3006353.84,5639,8653,3014,7851.410714,680.9355638
Cell R35,1000,58,3113723.62,5598,7284,1686,6875.224138,299.1482185
Cell R36,1000,59,3167408.51,6124,7929,1805,7294.237288,377.1848146
Cell R37,1000,60,3221093.4,4280,8109,3829,7183.133333,858.488021
Cell R38,1000,57,3060038.73,7824,8532,708,8193.912281,177.3012384
Cell R39,1000,60,3221093.4,7178,8154,976,7819.55,186.0192127
Cell R40,1000,58,3113723.62,4970,8914,3944,6832.275862,1191.864647
Cell R46,1000,56,3006353.84,1611,8287,6676,4788.446429,1563.954682
Cell R47,1000,56,3006353.84,3874,9189,5315,7924.375,1039.9293
Cell R48,1000,57,3060038.73,6691,8163,1472,7463.192982,405.5058543
Cell R49,1000,60,3221093.4,7029,8632,1603,7815.766667,347.2786281
Cell R5,1000,60,3221093.4,-1428,7659,9087,6134.516667,1912.872626
Cell R50,1000,60,3221093.4,2348,8212,5864,6715.15,1665.49487
Cell R51,1000,58,3113723.62,5653,8359,2706,7367.017241,672.0054262
Cell R52,1000,59,3167408.51,6560,8220,1660,7412.271186,436.0360283
Cell R53,1000,58,3113723.62,5656,8252,2596,7877.637931,363.8097124
Cell R54,1000,57,3060038.73,7228,8482,1254,8109.877193,354.2955982
Cell R58,1000,59,3167408.51,3072,8750,5678,7029.033898,1392.77191
Cell R59,1000,60,3221093.4,6769,7790,1021,7139.716667,252.3901142
Cell R6,1000,60,3221093.4,7547,8180,633,7939.883333,144.6125965
Cell R60,1000,58,3113723.62,6011,8503,2492,7351.051724,651.3095409
Cell R61,1000,61,3274778.29,2380,9950,7570,6971.360656,2178.040472
Cell R62,1000,60,3221093.4,2892,8697,5805,6772.3,1181.113166
Cell R63,1000,58,3113723.62,7183,8114,931,7626.258621,191.6770416
Cell R64,1000,58,3113723.62,7755,8429,674,8055.965517,188.6256981
Cell R65,1000,62,3328463.18,6794,8427,1633,7793.145161,404.6455178
Cell R66,1000,57,3060038.73,7833,8921,1088,8614.210526,198.3513396
Cell R69,1000,58,3113723.62,1125,8776,7651,5888.172414,2159.854594
Cell R7,1000,60,3221093.4,6275,9266,2991,7527.8,775.9310064
Cell R70,1000,58,3113723.62,4114,9597,5483,7565.862069,1256.248815
Cell R71,1000,59,3167408.51,2816,7752,4936,6841.186441,895.7580915
Cell R72,1000,58,3113723.62,1806,7843,6037,4851.224138,1477.440226
Cell R73,1000,56,3006353.84,7050,8770,1720,7982.553571,383.7570809
Cell R74,1000,59,3167408.51,5638,8294,2656,7714.322034,644.0007485
Cell R75,1000,60,3221093.4,7131,8421,1290,8102.233333,228.8226654
Cell R76,1000,56,3006353.84,7600,8903,1303,8515.410714,364.9882472
Cell R77,1000,56,3006353.84,7432,8387,955,7968.321429,219.1556123
Cell R8,1000,58,3113723.62,-1067,8874,9941,7610.724138,1957.964194
Cell R80,1000,61,3274778.29,3115,9381,6266,7009.885246,1196.144038
Cell R81,1000,60,3221093.4,3137,9496,6359,7364.816667,890.9329285
Cell R82,1000,56,3006353.84,2362,8594,6232,6233.535714,1861.311394
Cell R83,1000,58,3113723.62,4133,8644,4511,7594.241379,926.1270917
Cell R84,1000,59,3167408.51,1558,8476,6918,6315.338983,1820.182582
Cell R85,1000,57,3060038.73,6819,8422,1603,7718.140351,382.2486762
Cell R86,1000,59,3167408.51,7488,8406,918,7983.457627,200.1426883
Cell R87,1000,59,3167408.51,7274,8307,1033,7907.20339,256.3549433
Cell R9,1000,60,3221093.4,5797,8447,2650,7498.65,748.0098445
Cell R90,1000,58,3113723.62,6810,8286,1476,7615.293103,285.0687158
Cell R91,1000,59,3167408.51,7079,8602,1523,8128.966102,400.3674992
Cell R92,1000,58,3113723.62,1561,9280,7719,6008.551724,2430.216942
Cell R93,1000,61,3274778.29,6104,8282,2178,7492.737705,342.4610018
Cell R97,1000,57,3060038.73,7338,9135,1797,8028.105263,444.5271757
Cell R98,1000,58,3113723.62,6958,8474,1516,7970.431034,365.246875
Cell R99,1000,58,3113723.62,7097,8535,1438,7909.810345,358.5601694
Cell S102,1000,60,3221093.4,6670,8692,2022,7962.2,427.510226
Cell S108,1000,58,3113723.62,6942,8815,1873,8105.931034,393.3554093
Cell S13,1000,58,3113723.62,6887,8643,1756,7740.931034,319.0270155
Cell S14,1000,58,3113723.62,7310,8353,1043,7846.706897,296.2072905
Cell S2,1000,59,3167408.51,7327,8554,1227,8281.016949,164.6837227
Cell S23,1000,58,3113723.62,8060,8634,574,8443.431034,119.4692446
Cell S32,1000,58,3113723.62,6980,8656,1676,8125.327586,392.1937588
Cell S33,1000,58,3113723.62,7198,8333,1135,7847.586207,267.7764144
Cell S34,1000,60,3221093.4,7050,8963,1913,8098.6,441.6837556
Cell S41,1000,58,3113723.62,6697,8269,1572,7731.241379,424.2446151
Cell S42,1000,60,3221093.4,7834,8920,1086,8573,230.0273897
Cell S44,1000,58,3113723.62,7669,8592,923,7988.793103,213.0733853
Cell S56,1000,59,3167408.51,6630,8399,1769,7587.915254,364.8932181
Cell S67,1000,59,3167408.51,6879,8533,1654,7850.389831,385.1313673
Cell S78,1000,58,3113723.62,6681,8929,2248,8543.775862,419.0072851
Cell S88,1000,59,3167408.51,7227,8660,1433,8088.79661,380.499038
Cell S94,1000,58,3113723.62,7844,9017,1173,8319,225.0009962
Cell S95,1000,59,3167408.51,7777,8697,920,8154.40678,250.1791981
W287,1000,58,3113723.62,2623,7906,5283,5468.896552,1419.396371
W295,1000,59,3167408.51,3299,7869,4570,6385.101695,1425.4233
W338,1000,60,3221093.4,3165,7855,4690,6664.85,1237.043947
W342,1000,60,3221093.4,4250,7793,3543,6855.933333,718.8665353
W345,1000,58,3113723.62,6907,7740,833,7397.293103,209.1409365
W387,1000,60,3221093.4,5117,7487,2370,6607.983333,566.7373728
W393,1000,59,3167408.51,6877,7710,833,7241.389831,196.306835
W440,1000,56,3006353.84,3387,7276,3889,5844.732143,963.7786403
W441,1000,58,3113723.62,7259,7819,560,7616.534483,113.1474801
W445,1000,60,3221093.4,6102,7462,1360,7037.016667,289.3726255
W500,1000,58,3113723.62,3205,8497,5292,7583.017241,1055.917471
1,1250,94,5046379.66,7398,8180,782,7889.191489,171.6871398
2,1250,94,5046379.66,2970,8077,5107,6610.37234,1246.014224
3,1250,93,4992694.77,7486,8311,825,7973.301075,170.8028975
4,1250,90,4831640.1,7259,7990,731,7659.911111,173.8896613
5,1250,91,4885324.99,5598,7476,1878,6852.901099,380.8635086
6,1250,93,4992694.77,6646,8543,1897,8228.27957,362.4188857
7,1250,94,5046379.66,5720,8478,2758,7594.840426,585.5099669
8,1250,91,4885324.99,2876,8265,5389,6331.538462,1437.8453
9,1250,90,4831640.1,6917,8584,1667,7880.711111,413.7031476
10,1250,93,4992694.77,3104,8546,5442,6867.225806,1134.404454
11,1250,88,4724270.32,5964,8256,2292,7490.147727,414.8418795
12,1250,88,4724270.32,2348,8212,5864,6635.056818,1705.408978
13,1250,90,4831640.1,5627,8670,3043,7521.188889,695.2264203
14,1250,92,4939009.88,6238,8444,2206,7780.73913,582.8824154
16,1250,90,4831640.1,928,8776,7848,5262.011111,2443.768681
17,1250,93,4992694.77,5968,8503,2535,7397.989247,657.5473243
18,1250,93,4992694.77,1537,9707,8170,6821.494624,2229.287767
19,1250,92,4939009.88,1293,8697,7404,6277.423913,1546.998147
20,1250,90,4831640.1,7131,8421,1290,8073.933333,222.1213782
21,1250,93,4992694.77,7420,8389,969,7914.397849,244.1944025
22,1250,93,4992694.77,-834,9500,10334,5978.548387,2738.715206
23,1250,94,5046379.66,1361,8594,7233,6010.617021,2165.467529
24,1250,90,4831640.1,7079,8602,1523,8168.966667,364.9948691
25,1250,94,5046379.66,6104,8282,2178,7469.893617,362.9046961
26,1250,93,4992694.77,7274,8402,1128,7957.172043,264.849993
27,1250,92,4939009.88,6958,8474,1516,8013.836957,364.9434524
28,1250,92,4939009.88,6350,8270,1920,7564.586957,527.7988985
29,1250,91,4885324.99,7521,8718,1197,8156.043956,277.8723287
31,1250,93,4992694.77,6293,8523,2230,8129.419355,274.1108136
32,1250,94,5046379.66,5444,8210,2766,7388.053191,553.4484421
33,1250,91,4885324.99,6404,7232,828,6904.978022,192.6936291
34,1250,94,5046379.66,5169,7855,2686,6873.978723,484.6146962
10A,1250,90,4831640.1,2952,9189,6237,7624.866667,1424.707363
10NE,1250,90,4831640.1,5996,8539,2543,7034.122222,462.526968
10NW,1250,93,4992694.77,4513,7930,3417,7267.075269,510.6090657
10SW,1250,88,4724270.32,2055,8665,6610,6499.534091,1577.620943
11NE,1250,93,4992694.77,3518,8510,4992,7147.784946,1020.235402
11NW,1250,90,4831640.1,6070,8608,2538,7763.233333,499.5715731
11SE,1250,94,5046379.66,5887,8632,2745,7719.457447,454.3312285
17NW,1250,93,4992694.77,6769,7931,1162,7218.086022,288.4884842
17SE,1250,93,4992694.77,2759,7752,4993,6724.72043,1237.863876
17SW,1250,88,4724270.32,4114,9597,5483,7547.988636,1178.238752
22S,1250,93,4992694.77,-834,9500,10334,6025.526882,2398.954537
23S,1250,88,4724270.32,1389,6437,5048,2838.181818,1031.381824
24S,1250,92,4939009.88,7079,8602,1523,8166.815217,359.2919344
27A,1250,90,4831640.1,1628,9061,7433,7226.755556,1472.090368
2A,1250,93,4992694.77,3199,8812,5613,7114.924731,1168.037102
5NE,1250,94,5046379.66,4689,9550,4861,7273.255319,834.5452442
5NW,1250,94,5046379.66,2261,9736,7475,6143.404255,1435.904121
5SE,1250,90,4831640.1,798,8449,7651,5173.644444,2166.048283
6NE,1250,93,4992694.77,6018,8579,2561,7971.193548,610.0598289
6NW,1250,94,5046379.66,2419,9147,6728,7872.648936,911.0760847
6SW,1250,92,4939009.88,2318,8824,6506,7770.152174,1102.714821
Cell 1 2011/12,1250,94,5046379.66,7398,8180,782,7889.191489,171.6871398
Cell 1 SW 2013,1250,90,4831640.1,4788,7718,2930,6816.755556,662.6661186
Cell 10 2011/12,1250,93,4992694.77,3104,8546,5442,6867.225806,1134.404454
Cell 10 NE 2011/12,1250,90,4831640.1,5996,8539,2543,7034.122222,462.526968
Cell 10 NW 2011/12,1250,93,4992694.77,4513,7930,3417,7267.075269,510.6090657
Cell 10 SE 2013,1250,94,5046379.66,2419,9147,6728,7872.648936,911.0760847
Cell 10 SW 2011/12,1250,88,4724270.32,2055,8665,6610,6499.534091,1577.620943
Cell 10-A 2011/12,1250,90,4831640.1,2952,9189,6237,7624.866667,1424.707363
Cell 11 NE 2011/12,1250,93,4992694.77,3518,8510,4992,7147.784946,1020.235402
Cell 11 NW 2013,1250,91,4885324.99,4649,8812,4163,7198.769231,811.2553842
Cell 11 SW 2013,1250,90,4831640.1,6177,8675,2498,7706.9,620.6576807
Cell 12 2013,1250,93,4992694.77,5720,8478,2758,7596.978495,589.3252745
Cell 13 2013,1250,90,4831640.1,2677,8121,5444,6102.444444,1613.384904
Cell 14 2013,1250,91,4885324.99,7298,8730,1432,7922.736264,320.7334601
Cell 15 2013,1250,94,5046379.66,7165,8411,1246,7886.43617,283.6665168
Cell 15-A 2013,1250,91,4885324.99,6876,8333,1457,7826.153846,320.2736784
Cell 16 2013,1250,92,4939009.88,7186,8858,1672,7871.945652,362.9297562
Cell 17 NW 2011/12,1250,93,4992694.77,6769,7931,1162,7218.086022,288.4884842
Cell 17 NW 2013,1250,93,4992694.77,2549,7830,5281,6095.827957,1394.906939
Cell 17 SE 2013,1250,92,4939009.88,5657,7930,2273,7297.01087,424.5167968
Cell 17 SW 2013,1250,91,4885324.99,5598,7327,1729,6861.208791,370.4030331
Cell 18 2011/12,1250,93,4992694.77,1537,9707,8170,6821.494624,2229.287767
Cell 18 NE 2013,1250,91,4885324.99,2318,8824,6506,7627.153846,1283.487308
Cell 18 NW 2013,1250,94,5046379.66,798,8449,7651,4950.265957,2215.761625
Cell 18 SE 2013,1250,93,4992694.77,3518,8510,4992,7147.784946,1020.235402
Cell 18 SSE 2013,1250,94,5046379.66,5150,8608,3458,7675.074468,467.5282046
Cell 19 NW 2013,1250,93,4992694.77,6512,8516,2004,7991.193548,563.2862535
Cell 2 2011/12,1250,94,5046379.66,2970,8077,5107,6610.37234,1246.014224
Cell 2 NE 2013,1250,93,4992694.77,5219,9266,4047,7804.946237,853.8231839
Cell 2 SW 2013,1250,94,5046379.66,7398,8180,782,7889.191489,171.6871398
Cell 20 2013,1250,90,4831640.1,7247,8629,1382,7813.111111,298.8965798
Cell 21 2013,1250,89,4777955.21,3928,8914,4986,6863.213483,1246.948522
Cell 22 2013,1250,92,4939009.88,6917,8532,1615,7820.01087,452.8306261
Cell 23 2013,1250,94,5046379.66,7834,8920,1086,8562.138298,207.3555689
Cell 24 2013,1250,94,5046379.66,7050,8963,1913,8046.255319,433.6555142
Cell 25 NE 2013,1250,93,4992694.77,3104,8546,5442,6867.225806,1134.404454
Cell 25 SE 2013,1250,88,4724270.32,2055,8665,6610,6499.534091,1577.620943
Cell 26 NE 2013,1250,88,4724270.32,5964,8256,2292,7490.147727,414.8418795
Cell 26 NNW 2013,1250,90,4831640.1,5996,8539,2543,7034.122222,462.526968
Cell 26 NW 2013,1250,90,4831640.1,2952,9189,6237,7624.866667,1424.707363
Cell 27 NW 2013,1250,94,5046379.66,5887,8632,2745,7719.457447,454.3312285
Cell 28 2013,1250,88,4724270.32,2348,8212,5864,6635.056818,1705.408978
Cell 29 2013,1250,90,4831640.1,5627,8670,3043,7521.188889,695.2264203
Cell 3 NE 2013,1250,92,4939009.88,-1067,9023,10090,7376.521739,1839.39841
Cell 3 NW 2013,1250,93,4992694.77,5925,9266,3341,7496.763441,796.6559598
Cell 30 2013,1250,93,4992694.77,6794,8427,1633,7868.72043,375.1776172
Cell 31 2013,1250,91,4885324.99,7228,8525,1297,8140.296703,320.4238777
Cell 32 2013,1250,92,4939009.88,6879,8619,1740,7824.282609,405.4035651
Cell 33 NE 2013,1250,93,4992694.77,6769,7931,1162,7218.086022,288.4884842
Cell 33 SE 2013,1250,88,4724270.32,4114,9597,5483,7547.988636,1178.238752
Cell 33 SW 2013,1250,90,4831640.1,849,8776,7927,5318.255556,2410.944267
Cell 34 N 2013,1250,90,4831640.1,6102,8321,2219,7471.911111,372.7766875
Cell 34 NW 2013,1250,93,4992694.77,5968,8503,2535,7397.989247,657.5473243
Cell 34 SE 2013,1250,93,4992694.77,2759,7752,4993,6724.72043,1237.863876
Cell 35 2013,1250,93,4992694.77,2337,9950,7613,6766.182796,2193.460991
Cell 37 2013,1250,93,4992694.77,7131,8421,1290,8084.827957,216.1474817
Cell 38 2013,1250,90,4831640.1,7432,8389,957,7931.922222,234.9871972
Cell 39 2013,1250,90,4831640.1,6681,8955,2274,8499.166667,449.7764939
Cell 4 2013,1250,92,4939009.88,7287,8386,1099,7841.945652,244.3585375
Cell 40 NE 2013,1250,94,5046379.66,1325,9381,8056,6648.425532,1726.010906
Cell 41 N 2013,1250,90,4831640.1,3173,9959,6786,8160.088889,1235.855184
Cell 41 NW 2013,1250,94,5046379.66,349,9834,9485,6350.319149,2914.316238
Cell 42 NW 2013,1250,90,4831640.1,1331,8594,7263,5773.177778,2309.686263
Cell 43 2013,1250,88,4724270.32,6288,8422,2134,7685.386364,501.905402
Cell 44 2013,1250,90,4831640.1,7167,8531,1364,8032.266667,403.0114914
Cell 45 2013,1250,92,4939009.88,7274,8402,1128,7956.576087,266.2234773
Cell 47 2013,1250,90,4831640.1,6495,8340,1845,7608.933333,320.874458
Cell 48 2013,1250,92,4939009.88,7079,8602,1523,8166.815217,359.2919344
Cell 49 2013,1250,94,5046379.66,6104,8282,2178,7469.893617,362.9046961
Cell 5 2011/12 Summer,1250,92,4939009.88,5598,7327,1729,6861.043478,368.3878483
Cell 5 2013,1250,93,4992694.77,7253,8707,1454,8039.365591,315.2048245
Cell 50 2013,1250,92,4939009.88,7521,8718,1197,8152.380435,278.5589799
Cell 51 2013,1250,88,4724270.32,7464,8697,1233,8150.829545,279.8018057
Cell 52 2013,1250,90,4831640.1,7097,8535,1438,7876.133333,337.3278722
Cell 53 2013,1250,92,4939009.88,6350,8270,1920,7564.586957,527.7988985
Cell 54 2013,1250,94,5046379.66,7320,8786,1466,8288.393617,361.0513083
Cell 55 2013,1250,91,4885324.99,6942,8815,1873,8166.450549,395.8918785
Cell 56 2013,1250,90,4831640.1,6404,7232,828,6906.244444,193.3842066
Cell 57 2013,1250,94,5046379.66,5444,8210,2766,7388.053191,553.4484421
Cell 58 2013,1250,92,4939009.88,7810,8885,1075,8349.413043,287.0262506
Cell 59 2013,1250,93,4992694.77,6692,7892,1200,7278.741935,318.7633667
Cell 6 2011/12,1250,93,4992694.77,6646,8543,1897,8228.27957,362.4188857
Cell 6 2013,1250,93,4992694.77,7327,8659,1332,8267.387097,157.4547576
Cell 6 NE 2011/12,1250,93,4992694.77,6018,8579,2561,7971.193548,610.0598289
Cell 6 NW 2011/12,1250,94,5046379.66,2419,9147,6728,7872.648936,911.0760847
Cell 6 SW 2011/12,1250,92,4939009.88,2318,8824,6506,7770.152174,1102.714821
Cell 60 2013,1250,91,4885324.99,5658,7827,2169,7072.120879,486.5398538
Cell 61 2013,1250,93,4992694.77,6774,8549,1775,7788.204301,379.3352295
Cell 7 2013,1250,88,4724270.32,6868,8557,1689,7893.102273,339.9173375
Cell 9 NW 2013,1250,93,4992694.77,2727,8280,5553,6401.344086,1505.296131
Cell 9 SE 2013,1250,93,4992694.77,4689,9550,4861,7265.956989,836.0309059
Cell 9 SW 2013,1250,93,4992694.77,2261,9736,7475,6156.182796,1438.277232
Cell R1,1250,97,5207434.33,5866,8178,2312,7083.402062,582.8670103
Cell R10,1250,92,4939009.88,7287,8386,1099,7841.945652,244.3585375
Cell R100,1250,92,4939009.88,7521,8718,1197,8152.380435,278.5589799
Cell R101,1250,94,5046379.66,7513,8656,1143,8087.468085,255.4170433
Cell R104,1250,93,4992694.77,7490,8690,1200,7957.387097,172.7433943
Cell R105,1250,92,4939009.88,6350,8270,1920,7564.586957,527.7988985
Cell R106,1250,94,5046379.66,6054,8480,2426,7595.265957,706.42631
Cell R107,1250,94,5046379.66,7320,8786,1466,8288.393617,361.0513083
Cell R11,1250,93,4992694.77,7253,8707,1454,8039.365591,315.2048245
Cell R111,1250,93,4992694.77,7082,8732,1650,8107.569892,457.7061178
Cell R112,1250,93,4992694.77,7475,8387,912,8052.11828,175.4956636
Cell R113,1250,94,5046379.66,5444,8210,2766,7388.053191,553.4484421
Cell R114,1250,92,4939009.88,7810,8885,1075,8349.413043,287.0262506
Cell R117,1250,94,5046379.66,5522,7891,2369,7001.021277,506.6097365
Cell R118,1250,90,4831640.1,6404,7232,828,6906.244444,193.3842066
Cell R119,1250,92,4939009.88,3672,7645,3973,6514.119565,914.8969275
Cell R120,1250,94,5046379.66,7196,8513,1317,8175.712766,332.4235194
Cell R121,1250,91,4885324.99,6617,8504,1887,7829.186813,432.270492
Cell R123,1250,92,4939009.88,6822,8233,1411,7562.271739,299.4339625
Cell R124,1250,90,4831640.1,6575,7978,1403,7306.666667,374.3590374
Cell R125,1250,88,4724270.32,5110,7988,2878,7408.681818,536.3708763
Cell R126,1250,92,4939009.88,6307,8551,2244,7936.532609,476.9024021
Cell R15,1250,90,4831640.1,4788,7718,2930,6816.755556,662.6661186
Cell R16,1250,93,4992694.77,2727,8280,5553,6401.344086,1505.296131
Cell R17,1250,93,4992694.77,4814,8746,3932,7338.086022,893.0403868
Cell R18,1250,88,4724270.32,5314,8812,3498,7300.897727,679.6891174
Cell R19,1250,94,5046379.66,7212,8265,1053,7881.510638,234.370626
Cell R20,1250,92,4939009.88,7311,8109,798,7648.597826,212.7887327
Cell R21,1250,92,4939009.88,7081,8067,986,7686.097826,247.1626405
Cell R22,1250,91,4885324.99,7298,8730,1432,7922.736264,320.7334601
Cell R24,1250,93,4992694.77,2549,7830,5281,6095.827957,1394.906939
Cell R25,1250,94,5046379.66,798,8449,7651,4950.265957,2215.761625
Cell R26,1250,92,4939009.88,5953,9147,3194,7992.728261,578.8178752
Cell R27,1250,94,5046379.66,6512,8516,2004,7990.93617,560.2875365
Cell R28,1250,92,4939009.88,2337,8775,6438,7058.184783,1360.548123
Cell R29,1250,92,4939009.88,7247,8629,1382,7808.358696,299.005474
Cell R30,1250,91,4885324.99,5843,8415,2572,7579.516484,508.1171744
Cell R31,1250,90,4831640.1,5527,8653,3126,7774.311111,698.6704778
Cell R35,1250,92,4939009.88,5598,7327,1729,6861.043478,368.3878483
Cell R36,1250,92,4939009.88,5657,7930,2273,7297.01087,424.5167968
Cell R37,1250,93,4992694.77,3518,8510,4992,7147.784946,1020.235402
Cell R38,1250,88,4724270.32,7436,8634,1198,8186.556818,215.0457065
Cell R39,1250,95,5100064.55,7178,8356,1178,7832.336842,227.2667624
Cell R40,1250,90,4831640.1,3928,8914,4986,6842.077778,1255.930759
Cell R46,1250,90,4831640.1,1611,8665,7054,4676.033333,1813.039311
Cell R47,1250,90,4831640.1,2952,9189,6237,7624.866667,1424.707363
Cell R48,1250,88,4724270.32,5964,8256,2292,7490.147727,414.8418795
Cell R49,1250,93,4992694.77,5887,8632,2745,7732.096774,440.0223373
Cell R5,1250,94,5046379.66,-1428,8079,9507,5901.606383,1991.715636
Cell R50,1250,88,4724270.32,2348,8212,5864,6635.056818,1705.408978
Cell R51,1250,91,4885324.99,5627,8670,3043,7526.241758,693.0556856
Cell R52,1250,91,4885324.99,6560,8400,1840,7471.681319,453.8659791
Cell R53,1250,93,4992694.77,4902,8419,3517,7775.516129,617.4389807
Cell R54,1250,90,4831640.1,7228,8525,1297,8146.211111,317.2208307
Cell R58,1250,93,4992694.77,1306,8750,7444,6561.602151,1915.545051
Cell R59,1250,93,4992694.77,6769,7931,1162,7218.086022,288.4884842
Cell R6,1250,94,5046379.66,7398,8180,782,7889.191489,171.6871398
Cell R60,1250,93,4992694.77,5968,8503,2535,7397.989247,657.5473243
Cell R61,1250,93,4992694.77,2337,9950,7613,6766.182796,2193.460991
Cell R62,1250,93,4992694.77,1293,8810,7517,6483.16129,1576.330633
Cell R63,1250,92,4939009.88,6779,8169,1390,7590.152174,256.7268441
Cell R64,1250,91,4885324.99,7674,8448,774,8056.450549,193.1552506
Cell R65,1250,93,4992694.77,6794,8427,1633,7868.72043,375.1776172
Cell R66,1250,89,4777955.21,7483,8921,1438,8608.662921,236.85092
Cell R69,1250,90,4831640.1,849,8776,7927,5318.255556,2410.944267
Cell R7,1250,94,5046379.66,5925,9266,3341,7502.095745,794.073876
Cell R70,1250,88,4724270.32,4114,9597,5483,7547.988636,1178.238752
Cell R71,1250,93,4992694.77,2759,7752,4993,6724.72043,1237.863876
Cell R72,1250,92,4939009.88,1746,7934,6188,4603.826087,1656.324589
Cell R73,1250,90,4831640.1,7050,9015,1965,8054.855556,398.9728356
Cell R74,1250,93,4992694.77,5180,8819,3639,7653.677419,719.9630391
Cell R75,1250,93,4992694.77,7131,8421,1290,8084.827957,216.1474817
Cell R76,1250,90,4831640.1,7600,8920,1320,8502.555556,361.2186199
Cell R77,1250,90,4831640.1,7432,8389,957,7931.922222,234.9871972
Cell R8,1250,91,4885324.99,-1067,9038,10105,7373.032967,2171.901251
Cell R80,1250,94,5046379.66,1325,9381,8056,6648.425532,1726.010906
Cell R81,1250,93,4992694.77,3137,9496,6359,7532.978495,869.9205869
Cell R82,1250,90,4831640.1,1331,8594,7263,5773.177778,2309.686263
Cell R83,1250,90,4831640.1,2402,8644,6242,7256.711111,1306.085085
Cell R84,1250,94,5046379.66,1384,8476,7092,5950.297872,2080.756439
Cell R85,1250,88,4724270.32,6288,8422,2134,7685.386364,501.905402
Cell R86,1250,94,5046379.66,7141,8406,1265,7929.43617,250.1367949
Cell R87,1250,92,4939009.88,7274,8402,1128,7956.576087,266.2234773
Cell R9,1250,93,4992694.77,5380,8510,3130,7513.053763,766.9279363
Cell R90,1250,90,4831640.1,6495,8340,1845,7608.933333,320.874458
Cell R91,1250,92,4939009.88,7079,8602,1523,8166.815217,359.2919344
Cell R92,1250,90,4831640.1,1558,9904,8346,5338.555556,2619.649752
Cell R93,1250,94,5046379.66,6104,8282,2178,7469.893617,362.9046961
Cell R97,1250,91,4885324.99,6301,9135,2834,7936.054945,475.4064626
Cell R98,1250,92,4939009.88,6958,8474,1516,8013.836957,364.9434524
Cell R99,1250,90,4831640.1,7097,8535,1438,7876.133333,337.3278722
Cell S102,1250,94,5046379.66,6670,8754,2084,8062.202128,442.1195463
Cell S108,1250,91,4885324.99,6942,8815,1873,8166.450549,395.8918785
Cell S13,1250,91,4885324.99,6887,8829,1942,7821.505495,349.584286
Cell S14,1250,88,4724270.32,6868,8557,1689,7893.102273,339.9173375
Cell S2,1250,93,4992694.77,7327,8659,1332,8267.387097,157.4547576
Cell S23,1250,91,4885324.99,7974,8634,660,8403.197802,152.2066423
Cell S32,1250,90,4831640.1,6980,8656,1676,8068.744444,423.2652061
Cell S33,1250,91,4885324.99,6876,8333,1457,7826.153846,320.2736784
Cell S34,1250,94,5046379.66,7050,8963,1913,8046.255319,433.6555142
Cell S41,1250,91,4885324.99,6697,8311,1614,7731.89011,397.8399217
Cell S42,1250,94,5046379.66,7834,8920,1086,8562.138298,207.3555689
Cell S44,1250,90,4831640.1,7434,8592,1158,8019.222222,229.7077263
Cell S56,1250,92,4939009.88,6630,8399,1769,7626.130435,342.2380692
Cell S67,1250,92,4939009.88,6879,8619,1740,7824.282609,405.4035651
Cell S78,1250,90,4831640.1,6681,8955,2274,8499.166667,449.7764939
Cell S88,1250,92,4939009.88,7209,8660,1451,8102.619565,374.2802613
Cell S94,1250,92,4939009.88,7536,9085,1549,8283,291.861976
Cell S95,1250,88,4724270.32,7464,8697,1233,8150.829545,279.8018057
W287,1250,90,4831640.1,1737,7906,6169,5055.2,1566.602965
W295,1250,93,4992694.77,2234,7869,5635,6440.935484,1425.137864
W338,1250,94,5046379.66,3165,7903,4738,6677.329787,1244.728539
W342,1250,93,4992694.77,2972,7811,4839,6701.860215,905.8015234
W345,1250,92,4939009.88,6756,7771,1015,7393.630435,225.1829072
W387,1250,93,4992694.77,2584,7487,4903,6368.688172,973.277679
W393,1250,93,4992694.77,6877,7710,833,7242.612903,188.180366
W440,1250,90,4831640.1,2570,7276,4706,5668.188889,1057.311001
W441,1250,91,4885324.99,6853,8095,1242,7600.89011,206.6609715
W445,1250,94,5046379.66,5638,7548,1910,7037.319149,333.1877693
W500,1250,93,4992694.77,1876,8546,6670,6915.462366,1819.122526
1,1500,134,7193775.26,6052,8244,2192,7845.902985,239.5281079
2,1500,135,7247460.15,2970,8077,5107,6614.17037,1244.312004
3,1500,132,7086405.48,7486,8311,825,7960.318182,172.0942447
4,1500,132,7086405.48,6763,8035,1272,7647.674242,201.8803087
5,1500,131,7032720.59,535,7524,6989,6704.473282,939.2256217
6,1500,133,7140090.37,6512,8547,2035,8214.721805,378.3894313
7,1500,133,7140090.37,5720,8722,3002,7636.909774,551.166193
8,1500,132,7086405.48,2677,8265,5588,6290.30303,1430.690631
9,1500,131,7032720.59,6917,8584,1667,7833.625954,421.8214111
10,1500,133,7140090.37,2384,8546,6162,6571.992481,1367.24779
11,1500,131,7032720.59,4012,8456,4444,7337.648855,694.3616314
12,1500,129,6925350.81,1978,9055,7077,6488.364341,1722.266759
13,1500,133,7140090.37,5627,8670,3043,7652.285714,696.1699038
14,1500,133,7140090.37,6238,8445,2207,7855.932331,531.81757
16,1500,130,6979035.7,849,8776,7927,4893.169231,2536.756637
17,1500,133,7140090.37,5968,8503,2535,7435.541353,616.397288
18,1500,134,7193775.26,1132,9836,8704,6210.835821,2667.12486
19,1500,131,7032720.59,1284,8810,7526,5993.099237,1944.904569
20,1500,131,7032720.59,7131,8421,1290,8070.778626,220.0451477
21,1500,132,7086405.48,6445,8391,1946,7887.598485,285.1327936
22,1500,132,7086405.48,-1781,9500,11281,5736.598485,2803.011889
23,1500,137,7354829.93,1297,8769,7472,5686.226277,2365.737067
24,1500,133,7140090.37,7079,8602,1523,8143.924812,355.0188732
25,1500,137,7354829.93,6104,8529,2425,7454.525547,417.7942091
26,1500,133,7140090.37,7274,8414,1140,7975.849624,266.0741176
27,1500,131,7032720.59,6681,8474,1793,8007.885496,368.8204975
28,1500,131,7032720.59,6341,8417,2076,7626.854962,549.3157871
29,1500,133,7140090.37,7124,8718,1594,8086.300752,309.3174631
31,1500,133,7140090.37,6293,8523,2230,8055.345865,440.6804043
32,1500,135,7247460.15,5444,8394,2950,7438.037037,553.1782434
33,1500,132,7086405.48,6133,7232,1099,6895.348485,212.3532286
34,1500,134,7193775.26,5169,7915,2746,6881.119403,511.5094584
10A,1500,131,7032720.59,2952,9270,6318,7322.396947,1675.50725
10NE,1500,131,7032720.59,4283,8539,4256,7124.458015,633.889475
10NW,1500,132,7086405.48,2194,7930,5736,7155.333333,819.6392099
10SW,1500,131,7032720.59,1342,8665,7323,5947.442748,1878.46406
11NE,1500,133,7140090.37,2414,8607,6193,7205.157895,1140.172496
11NW,1500,133,7140090.37,3307,8608,5301,7569.503759,870.6439638
11SE,1500,133,7140090.37,3384,8632,5248,7571.548872,666.1577007
17NW,1500,132,7086405.48,6622,8033,1411,7252.94697,314.1868368
17SE,1500,133,7140090.37,2062,7752,5690,6624.706767,1410.285327
17SW,1500,131,7032720.59,2560,9597,7037,7205.183206,1510.524098
22S,1500,133,7140090.37,-834,9500,10334,5513.736842,2637.894595
23S,1500,128,6871665.92,1389,7019,5630,2875.671875,1206.910636
24S,1500,133,7140090.37,7079,8651,1572,8147.729323,349.7895635
27A,1500,132,7086405.48,1628,9061,7433,6969.765152,1712.926513
2A,1500,134,7193775.26,2459,8812,6353,6879.708955,1387.313359
5NE,1500,133,7140090.37,3937,9550,5613,7212.887218,970.8606573
5NW,1500,135,7247460.15,2131,9736,7605,6141.488889,1504.766845
5SE,1500,132,7086405.48,798,8449,7651,4763.098485,2235.741209
6NE,1500,135,7247460.15,3561,8598,5037,7829.822222,756.8045872
6NW,1500,135,7247460.15,1838,9147,7309,7633.637037,1266.81137
6SW,1500,132,7086405.48,2318,8824,6506,7496.174242,1420.295042
Cell 1 2011/12,1500,134,7193775.26,6052,8244,2192,7845.902985,239.5281079
Cell 1 SW 2013,1500,132,7086405.48,3672,7718,4046,6696.477273,769.5520978
Cell 10 2011/12,1500,133,7140090.37,2384,8546,6162,6571.992481,1367.24779
Cell 10 NE 2011/12,1500,131,7032720.59,4283,8539,4256,7124.458015,633.889475
Cell 10 NW 2011/12,1500,132,7086405.48,2194,7930,5736,7155.333333,819.6392099
Cell 10 SE 2013,1500,135,7247460.15,1838,9147,7309,7633.637037,1266.81137
Cell 10 SW 2011/12,1500,131,7032720.59,1342,8665,7323,5947.442748,1878.46406
Cell 10-A 2011/12,1500,131,7032720.59,2952,9270,6318,7322.396947,1675.50725
Cell 11 NE 2011/12,1500,133,7140090.37,2414,8607,6193,7205.157895,1140.172496
Cell 11 NW 2013,1500,132,7086405.48,4141,8812,4671,7124.795455,970.3623795
Cell 11 SW 2013,1500,131,7032720.59,6177,8675,2498,7834.053435,612.909708
Cell 12 2013,1500,132,7086405.48,5720,8722,3002,7640.007576,552.0485334
Cell 13 2013,1500,131,7032720.59,2677,8265,5588,6051.045802,1560.588502
Cell 14 2013,1500,134,7193775.26,7298,8730,1432,7946.238806,328.0903402
Cell 15 2013,1500,135,7247460.15,7164,8429,1265,7907.562963,306.873037
Cell 15-A 2013,1500,131,7032720.59,6876,8739,1863,7861.961832,356.83003
Cell 16 2013,1500,133,7140090.37,7186,8858,1672,7878.097744,364.7853806
Cell 17 NW 2011/12,1500,132,7086405.48,6622,8033,1411,7252.94697,314.1868368
Cell 17 NW 2013,1500,134,7193775.26,1428,9733,8305,6269.11194,1419.863898
Cell 17 SE 2013,1500,132,7086405.48,2194,7930,5736,7155.333333,819.6392099
Cell 17 SW 2013,1500,131,7032720.59,535,7524,6989,6756.496183,869.654844
Cell 18 2011/12,1500,134,7193775.26,1132,9836,8704,6210.835821,2667.12486
Cell 18 NE 2013,1500,133,7140090.37,2188,8828,6640,7472.511278,1475.860109
Cell 18 NW 2013,1500,134,7193775.26,798,8449,7651,4569.313433,2232.882544
Cell 18 SE 2013,1500,133,7140090.37,2414,8607,6193,7205.157895,1140.172496
Cell 18 SSE 2013,1500,133,7140090.37,4206,8608,4402,7642.180451,606.0772158
Cell 19 NW 2013,1500,133,7140090.37,6512,8530,2018,8030.503759,530.5841528
Cell 2 2011/12,1500,135,7247460.15,2970,8077,5107,6614.17037,1244.312004
Cell 2 NE 2013,1500,133,7140090.37,4045,9266,5221,7699.052632,1037.683578
Cell 2 SW 2013,1500,134,7193775.26,6052,8244,2192,7845.902985,239.5281079
Cell 20 2013,1500,132,7086405.48,7247,8629,1382,7828.856061,308.2732488
Cell 21 2013,1500,131,7032720.59,2206,8914,6708,6878.580153,1348.251868
Cell 22 2013,1500,133,7140090.37,6712,8532,1820,7888.218045,440.0913839
Cell 23 2013,1500,135,7247460.15,7834,8920,1086,8539.807407,192.1258267
Cell 24 2013,1500,133,7140090.37,7050,8963,1913,8009.894737,401.6073582
Cell 25 NE 2013,1500,133,7140090.37,2384,8546,6162,6571.992481,1367.24779
Cell 25 SE 2013,1500,131,7032720.59,1342,8665,7323,5947.442748,1878.46406
Cell 26 NE 2013,1500,131,7032720.59,4012,8456,4444,7337.648855,694.3616314
Cell 26 NNW 2013,1500,131,7032720.59,4283,8539,4256,7124.458015,633.889475
Cell 26 NW 2013,1500,131,7032720.59,2952,9270,6318,7322.396947,1675.50725
Cell 27 NW 2013,1500,133,7140090.37,3384,8632,5248,7571.548872,666.1577007
Cell 28 2013,1500,128,6871665.92,1978,8212,6234,6468.3125,1713.916101
Cell 29 2013,1500,133,7140090.37,5627,8670,3043,7652.285714,696.1699038
Cell 3 NE 2013,1500,133,7140090.37,-1067,9023,10090,7436.954887,1830.365804
Cell 3 NW 2013,1500,133,7140090.37,4179,9266,5087,7392.233083,961.4363072
Cell 30 2013,1500,134,7193775.26,6794,8427,1633,7939.462687,348.4103272
Cell 31 2013,1500,130,6979035.7,7228,8525,1297,8135.430769,311.3161623
Cell 32 2013,1500,132,7086405.48,6439,8671,2232,7802.848485,447.8280664
Cell 33 NE 2013,1500,132,7086405.48,6622,8033,1411,7252.94697,314.1868368
Cell 33 SE 2013,1500,131,7032720.59,2560,9597,7037,7205.183206,1510.524098
Cell 33 SW 2013,1500,131,7032720.59,725,8776,8051,4927.923664,2476.48474
Cell 34 N 2013,1500,131,7032720.59,6102,8321,2219,7443.572519,366.2962141
Cell 34 NW 2013,1500,133,7140090.37,5968,8503,2535,7435.541353,616.397288
Cell 34 SE 2013,1500,134,7193775.26,2062,7752,5690,6630.19403,1406.437616
Cell 35 2013,1500,137,7354829.93,1735,9950,8215,6396.744526,2348.133323
Cell 37 2013,1500,132,7086405.48,7131,8421,1290,8080.659091,223.477537
Cell 38 2013,1500,132,7086405.48,6445,8391,1946,7893.977273,286.2994159
Cell 39 2013,1500,132,7086405.48,6681,8955,2274,8474.772727,422.4400189
Cell 4 2013,1500,133,7140090.37,7287,8386,1099,7846.819549,223.3318726
Cell 40 NE 2013,1500,137,7354829.93,1098,9381,8283,6237.678832,2073.490048
Cell 41 N 2013,1500,130,6979035.7,2080,9959,7879,8016.2,1295.151006
Cell 41 NW 2013,1500,134,7193775.26,349,9851,9502,6384.037313,2914.613429
Cell 42 NW 2013,1500,131,7032720.59,1194,8769,7575,5446.755725,2517.168981
Cell 43 2013,1500,130,6979035.7,4195,8783,4588,7580.469231,660.7184689
Cell 44 2013,1500,131,7032720.59,7167,8531,1364,8010.152672,379.1303321
Cell 45 2013,1500,133,7140090.37,7274,8414,1140,7978.323308,267.5428305
Cell 47 2013,1500,131,7032720.59,6495,8356,1861,7605.549618,349.9334771
Cell 48 2013,1500,133,7140090.37,7079,8651,1572,8142.458647,354.3643788
Cell 49 2013,1500,137,7354829.93,6104,8529,2425,7454.525547,417.7942091
Cell 5 2011/12 Summer,1500,131,7032720.59,535,7524,6989,6756.496183,869.654844
Cell 5 2013,1500,133,7140090.37,6707,8707,2000,7995.210526,358.7976801
Cell 50 2013,1500,133,7140090.37,7124,8718,1594,8086.300752,309.3174631
Cell 51 2013,1500,129,6925350.81,7230,8697,1467,8109.44186,312.0109794
Cell 52 2013,1500,131,7032720.59,7097,8535,1438,7865.274809,304.1643553
Cell 53 2013,1500,131,7032720.59,6341,8417,2076,7626.854962,549.3157871
Cell 54 2013,1500,133,7140090.37,7320,8792,1472,8284.781955,375.9876885
Cell 55 2013,1500,132,7086405.48,6942,8845,1903,8211.977273,380.0232542
Cell 56 2013,1500,130,6979035.7,6133,7232,1099,6894.407692,213.7726937
Cell 57 2013,1500,135,7247460.15,5444,8394,2950,7438.037037,553.1782434
Cell 58 2013,1500,133,7140090.37,7586,8885,1299,8383.270677,282.0414871
Cell 59 2013,1500,135,7247460.15,6614,8233,1619,7275.614815,345.3005773
Cell 6 2011/12,1500,133,7140090.37,6512,8547,2035,8214.721805,378.3894313
Cell 6 2013,1500,133,7140090.37,7327,8726,1399,8237.571429,183.67384
Cell 6 NE 2011/12,1500,135,7247460.15,3561,8598,5037,7829.822222,756.8045872
Cell 6 NW 2011/12,1500,135,7247460.15,1838,9147,7309,7633.637037,1266.81137
Cell 6 SW 2011/12,1500,132,7086405.48,2318,8824,6506,7496.174242,1420.295042
Cell 60 2013,1500,131,7032720.59,5658,7914,2256,7116.610687,492.7497324
Cell 61 2013,1500,133,7140090.37,6620,8549,1929,7726.458647,422.1073076
Cell 7 2013,1500,131,7032720.59,6845,8575,1730,7932.29771,381.5134325
Cell 9 NW 2013,1500,133,7140090.37,2727,8280,5553,6443.43609,1490.222264
Cell 9 SE 2013,1500,133,7140090.37,3937,9550,5613,7212.887218,970.8606573
Cell 9 SW 2013,1500,135,7247460.15,2131,9736,7605,6141.488889,1504.766845
Cell R1,1500,137,7354829.93,3509,8178,4669,7068.664234,746.3659039
Cell R10,1500,133,7140090.37,7287,8386,1099,7846.819549,223.3318726
Cell R100,1500,133,7140090.37,7124,8718,1594,8086.300752,309.3174631
Cell R101,1500,133,7140090.37,7384,8722,1338,8100.879699,279.3594186
Cell R104,1500,133,7140090.37,7490,8782,1292,7987.390977,223.226438
Cell R105,1500,131,7032720.59,6341,8417,2076,7626.854962,549.3157871
Cell R106,1500,133,7140090.37,5949,8480,2531,7581.473684,715.4845729
Cell R107,1500,133,7140090.37,7320,8792,1472,8284.781955,375.9876885
Cell R11,1500,133,7140090.37,6707,8707,2000,7995.210526,358.7976801
Cell R111,1500,133,7140090.37,1960,8732,6772,7902.789474,995.5998536
Cell R112,1500,133,7140090.37,7475,8388,913,8053.578947,185.3318588
Cell R113,1500,135,7247460.15,5444,8394,2950,7438.037037,553.1782434
Cell R114,1500,133,7140090.37,7586,8885,1299,8383.270677,282.0414871
Cell R117,1500,134,7193775.26,5522,8063,2541,7010.253731,534.1151657
Cell R118,1500,130,6979035.7,6133,7232,1099,6894.407692,213.7726937
Cell R119,1500,133,7140090.37,3672,7835,4163,6597.75188,892.4175614
Cell R120,1500,137,7354829.93,6338,8513,2175,8110.890511,431.5042384
Cell R121,1500,132,7086405.48,6617,8504,1887,7887.189394,394.4864735
Cell R123,1500,131,7032720.59,6822,8233,1411,7512.419847,314.0139287
Cell R124,1500,133,7140090.37,6575,7978,1403,7338.278195,376.8758866
Cell R125,1500,131,7032720.59,4022,7988,3966,7260.137405,760.3522161
Cell R126,1500,133,7140090.37,6286,8551,2265,7846.195489,524.2395489
Cell R15,1500,132,7086405.48,3672,7718,4046,6696.477273,769.5520978
Cell R16,1500,132,7086405.48,2727,8280,5553,6464.75,1475.522534
Cell R17,1500,133,7140090.37,4811,8746,3935,7407.037594,838.0338914
Cell R18,1500,124,6656926.36,4649,8812,4163,7193.516129,871.8251386
Cell R19,1500,133,7140090.37,7212,8265,1053,7896.360902,236.7170303
Cell R20,1500,132,7086405.48,7084,8144,1060,7690.265152,222.5563892
Cell R21,1500,132,7086405.48,6867,8083,1216,7668.204545,255.9351758
Cell R22,1500,133,7140090.37,7298,8730,1432,7945.112782,329.063393
Cell R24,1500,133,7140090.37,1428,9733,8305,6262.834586,1423.338045
Cell R25,1500,134,7193775.26,798,8449,7651,4569.313433,2232.882544
Cell R26,1500,133,7140090.37,1838,9147,7309,7708.496241,1154.163725
Cell R27,1500,133,7140090.37,6512,8530,2018,8030.503759,530.5841528
Cell R28,1500,131,7032720.59,2052,9571,7519,6901.725191,1557.170217
Cell R29,1500,132,7086405.48,7247,8629,1382,7828.856061,308.2732488
Cell R30,1500,132,7086405.48,5843,8415,2572,7599.401515,546.706473
Cell R31,1500,132,7086405.48,5527,8653,3126,7725.484848,657.9244164
Cell R35,1500,132,7086405.48,535,7524,6989,6759.340909,866.9660424
Cell R36,1500,132,7086405.48,2194,7930,5736,7155.333333,819.6392099
Cell R37,1500,134,7193775.26,2414,8607,6193,7211.955224,1138.61186
Cell R38,1500,131,7032720.59,6392,8634,2242,8141.778626,291.4770568
Cell R39,1500,133,7140090.37,7178,8604,1426,7833.368421,272.7739011
Cell R40,1500,131,7032720.59,2206,8914,6708,6878.580153,1348.251868
Cell R46,1500,132,7086405.48,631,8665,8034,4579.159091,2026.49556
Cell R47,1500,131,7032720.59,2952,9270,6318,7322.396947,1675.50725
Cell R48,1500,131,7032720.59,4012,8456,4444,7337.648855,694.3616314
Cell R49,1500,133,7140090.37,3384,8632,5248,7571.548872,666.1577007
Cell R5,1500,135,7247460.15,-1428,8079,9507,5799.437037,1963.312223
Cell R50,1500,128,6871665.92,1978,8212,6234,6468.3125,1713.916101
Cell R51,1500,133,7140090.37,5627,8789,3162,7656.308271,700.423236
Cell R52,1500,133,7140090.37,6542,8492,1950,7557.43609,485.5043166
Cell R53,1500,133,7140090.37,4902,8419,3517,7753.413534,596.7746786
Cell R54,1500,130,6979035.7,7228,8525,1297,8135.430769,311.3161623
Cell R58,1500,133,7140090.37,557,8750,8193,6113.81203,2166.282291
Cell R59,1500,133,7140090.37,6622,8033,1411,7255.932331,314.877114
Cell R6,1500,134,7193775.26,6052,8244,2192,7845.902985,239.5281079
Cell R60,1500,133,7140090.37,5968,8503,2535,7435.541353,616.397288
Cell R61,1500,137,7354829.93,1735,9950,8215,6396.744526,2348.133323
Cell R62,1500,133,7140090.37,1284,8810,7526,6060.383459,1894.583703
Cell R63,1500,134,7193775.26,6779,8413,1634,7607.156716,309.2009889
Cell R64,1500,132,7086405.48,7431,8448,1017,8039.227273,198.4905002
Cell R65,1500,134,7193775.26,6794,8427,1633,7939.462687,348.4103272
Cell R66,1500,132,7086405.48,7483,8921,1438,8600.325758,275.6679903
Cell R69,1500,131,7032720.59,725,8776,8051,4927.923664,2476.48474
Cell R7,1500,133,7140090.37,4179,9266,5087,7392.233083,961.4363072
Cell R70,1500,131,7032720.59,2560,9597,7037,7205.183206,1510.524098
Cell R71,1500,134,7193775.26,2062,7752,5690,6630.19403,1406.437616
Cell R72,1500,133,7140090.37,1335,7969,6634,4248.24812,1779.354311
Cell R73,1500,132,7086405.48,6416,9015,2599,8057.681818,403.0117172
Cell R74,1500,133,7140090.37,5180,8819,3639,7614.413534,769.3192101
Cell R75,1500,132,7086405.48,7131,8421,1290,8080.659091,223.477537
Cell R76,1500,131,7032720.59,7600,8920,1320,8492.015267,341.6944304
Cell R77,1500,132,7086405.48,6445,8391,1946,7893.977273,286.2994159
Cell R8,1500,130,6979035.7,-1067,9038,10105,7380.515385,2165.644055
Cell R80,1500,137,7354829.93,1098,9381,8283,6237.678832,2073.490048
Cell R81,1500,132,7086405.48,3137,9496,6359,7589.939394,872.4613368
Cell R82,1500,131,7032720.59,1194,8769,7575,5446.755725,2517.168981
Cell R83,1500,132,7086405.48,2372,8644,6272,6995.681818,1459.677747
Cell R84,1500,133,7140090.37,1292,8476,7184,5691.338346,2144.464267
Cell R85,1500,130,6979035.7,4195,8783,4588,7580.469231,660.7184689
Cell R86,1500,133,7140090.37,7141,8406,1265,7901.481203,264.7816408
Cell R87,1500,133,7140090.37,7274,8414,1140,7978.323308,267.5428305
Cell R9,1500,135,7247460.15,5380,9023,3643,7457.755556,811.6631254
Cell R90,1500,131,7032720.59,6495,8356,1861,7605.549618,349.9334771
Cell R91,1500,133,7140090.37,7079,8651,1572,8142.458647,354.3643788
Cell R92,1500,132,7086405.48,1479,9904,8425,5025.234848,2617.1439
Cell R93,1500,137,7354829.93,6104,8529,2425,7454.525547,417.7942091
Cell R97,1500,131,7032720.59,2996,9135,6139,7801.938931,791.9963929
Cell R98,1500,131,7032720.59,6681,8474,1793,8007.885496,368.8204975
Cell R99,1500,131,7032720.59,7097,8535,1438,7865.274809,304.1643553
Cell S102,1500,135,7247460.15,6670,8772,2102,8141.111111,447.2249192
Cell S108,1500,132,7086405.48,6942,8845,1903,8211.977273,380.0232542
Cell S13,1500,133,7140090.37,6887,8877,1990,7907.308271,402.2836724
Cell S14,1500,131,7032720.59,6845,8575,1730,7932.29771,381.5134325
Cell S2,1500,133,7140090.37,7327,8726,1399,8237.571429,183.67384
Cell S23,1500,131,7032720.59,7481,8634,1153,8358.801527,189.8030084
Cell S32,1500,132,7086405.48,6680,8656,1976,8028.257576,451.7264461
Cell S33,1500,131,7032720.59,6876,8739,1863,7861.961832,356.83003
Cell S34,1500,133,7140090.37,7050,8963,1913,8009.894737,401.6073582
Cell S41,1500,132,7086405.48,6697,8400,1703,7765.227273,367.3375458
Cell S42,1500,135,7247460.15,7834,8920,1086,8539.807407,192.1258267
Cell S44,1500,132,7086405.48,7434,8690,1256,8032.136364,234.6813692
Cell S56,1500,134,7193775.26,6630,8740,2110,7683.432836,365.0259334
Cell S67,1500,132,7086405.48,6439,8671,2232,7802.848485,447.8280664
Cell S78,1500,132,7086405.48,6681,8955,2274,8474.772727,422.4400189
Cell S88,1500,131,7032720.59,7209,8790,1581,8136.358779,376.2977964
Cell S94,1500,131,7032720.59,7484,9085,1601,8290.78626,323.4024035
Cell S95,1500,129,6925350.81,7230,8697,1467,8109.44186,312.0109794
W287,1500,130,6979035.7,1737,8828,7091,4760.423077,1704.849512
W295,1500,133,7140090.37,2234,8128,5894,6574.233083,1394.769078
W338,1500,135,7247460.15,3137,9399,6262,6834.659259,1327.721552
W342,1500,135,7247460.15,1893,7874,5981,6510.644444,1153.633792
W345,1500,131,7032720.59,5045,7981,2936,7370.076336,361.9821306
W387,1500,133,7140090.37,2002,7579,5577,6125.015038,1246.640834
W393,1500,132,7086405.48,6877,8111,1234,7246.431818,200.9787488
W440,1500,131,7032720.59,2155,7276,5121,5536.167939,1194.861621
W441,1500,132,7086405.48,6853,8095,1242,7578.401515,244.046905
W445,1500,135,7247460.15,5638,7589,1951,7043.822222,369.0437868
W500,1500,134,7193775.26,1876,8546,6670,6584.41791,1975.31084
1,1750,182,9770649.98,6052,8350,2298,7827.741758,241.1508222
2,1750,183,9824334.87,2970,8077,5107,6599.945355,1231.977475
3,1750,179,9609595.31,7486,8320,834,7956.206704,169.6356818
4,1750,179,9609595.31,6527,8035,1508,7625.916201,238.3042718
5,1750,183,9824334.87,-1566,7617,9183,6552.786885,1411.921654
6,1750,181,9716965.09,6512,8569,2057,8171.20442,411.4401834
7,1750,182,9770649.98,5720,8722,3002,7687.324176,534.1013191
8,1750,179,9609595.31,2677,8265,5588,6289.01676,1422.765481
9,1750,181,9716965.09,6917,8584,1667,7854.165746,405.2842058
10,1750,181,9716965.09,2104,8546,6442,6540.088398,1425.573275
11,1750,179,9609595.31,2705,8456,5751,7040.329609,1118.829135
12,1750,180,9663280.2,1336,9055,7719,6393.05,1738.498302
13,1750,179,9609595.31,5195,8891,3696,7696.832402,710.7583132
14,1750,179,9609595.31,6238,8482,2244,7913.301676,491.6128723
16,1750,180,9663280.2,579,9547,8968,4662.2,2563.67539
17,1750,181,9716965.09,5968,8503,2535,7443.972376,594.7483096
18,1750,181,9716965.09,1132,9836,8704,5641.276243,2840.174088
19,1750,184,9878019.76,1224,8810,7586,5603.907609,2120.764479
20,1750,179,9609595.31,7131,8622,1491,8072.340782,228.066101
21,1750,181,9716965.09,6445,8439,1994,7876.077348,297.0491051
22,1750,181,9716965.09,-1781,9500,11281,5355.723757,2849.865429
23,1750,180,9663280.2,993,8769,7776,5494.044444,2442.286717
24,1750,180,9663280.2,6998,8651,1653,8129.888889,362.7023862
25,1750,180,9663280.2,6104,8529,2425,7444.488889,460.96496
26,1750,182,9770649.98,7274,8414,1140,7979.241758,264.6341593
27,1750,182,9770649.98,6681,8474,1793,7988.82967,371.8993994
28,1750,183,9824334.87,6341,8522,2181,7704.52459,542.048763
29,1750,179,9609595.31,7124,8718,1594,8030.687151,324.0436421
31,1750,181,9716965.09,5603,8523,2920,8012.226519,511.6911281
32,1750,183,9824334.87,5444,8394,2950,7448.136612,571.8285194
33,1750,179,9609595.31,6133,7889,1756,6915.396648,262.8113885
34,1750,180,9663280.2,5169,7943,2774,6932.755556,522.8985309
10A,1750,181,9716965.09,2952,9270,6318,7168.414365,1711.363919
10NE,1750,180,9663280.2,4040,8542,4502,7141.322222,740.0562716
10NW,1750,182,9770649.98,2194,8057,5863,7084.456044,1038.40067
10SW,1750,180,9663280.2,1342,8665,7323,5586.827778,1974.261273
11NE,1750,181,9716965.09,1915,8607,6692,7238.906077,1276.586361
11NW,1750,178,9555910.42,2688,8608,5920,7376.893258,1093.307961
11SE,1750,182,9770649.98,1916,8632,6716,7268.456044,1187.739008
17NW,1750,182,9770649.98,4360,8033,3673,7207.21978,452.5356231
17SE,1750,181,9716965.09,2062,7752,5690,6631.983425,1405.564979
17SW,1750,180,9663280.2,2164,9693,7529,6919.166667,1794.163484
22S,1750,182,9770649.98,-834,9500,10334,5109.307692,2771.617744
23S,1750,180,9663280.2,1386,7582,6196,3057.027778,1471.497953
24S,1750,182,9770649.98,6998,8719,1721,8121.197802,370.0665286
27A,1750,180,9663280.2,1628,9070,7442,6651.755556,2018.524108
2A,1750,180,9663280.2,2362,8812,6450,6749.75,1507.450072
5NE,1750,181,9716965.09,3318,9550,6232,7106.569061,1071.876025
5NW,1750,183,9824334.87,1597,9736,8139,6073.431694,1608.572583
5SE,1750,180,9663280.2,702,8787,8085,4525.95,2263.663629
6NE,1750,181,9716965.09,2615,8598,5983,7679.381215,991.2550912
6NW,1750,180,9663280.2,1838,9147,7309,7497.105556,1415.305591
6SW,1750,181,9716965.09,2188,8994,6806,7325.303867,1583.43066
Cell 1 2011/12,1750,182,9770649.98,6052,8350,2298,7827.741758,241.1508222
Cell 1 SW 2013,1750,178,9555910.42,2161,7718,5557,6478.275281,1040.042992
Cell 10 2011/12,1750,181,9716965.09,2104,8546,6442,6540.088398,1425.573275
Cell 10 NE 2011/12,1750,180,9663280.2,4040,8542,4502,7141.322222,740.0562716
Cell 10 NW 2011/12,1750,182,9770649.98,2194,8057,5863,7084.456044,1038.40067
Cell 10 SE 2013,1750,180,9663280.2,1838,9147,7309,7497.105556,1415.305591
Cell 10 SW 2011/12,1750,180,9663280.2,1342,8665,7323,5586.827778,1974.261273
Cell 10-A 2011/12,1750,181,9716965.09,2952,9270,6318,7168.414365,1711.363919
Cell 11 NE 2011/12,1750,181,9716965.09,1915,8607,6692,7238.906077,1276.586361
Cell 11 NW 2013,1750,177,9502225.53,3199,8812,5613,7018.20904,1093.933201
Cell 11 SW 2013,1750,180,9663280.2,6177,8784,2607,7902.266667,623.4636994
Cell 12 2013,1750,182,9770649.98,5720,8722,3002,7685.164835,532.6225652
Cell 13 2013,1750,180,9663280.2,2385,8265,5880,6077.55,1540.195512
Cell 14 2013,1750,178,9555910.42,7298,8730,1432,7971.157303,321.9783438
Cell 15 2013,1750,183,9824334.87,6965,8429,1464,7926.89071,314.7756059
Cell 15-A 2013,1750,181,9716965.09,6876,8739,1863,7897.546961,371.8182653
Cell 16 2013,1750,181,9716965.09,7101,8858,1757,7891.751381,351.3716439
Cell 17 NW 2011/12,1750,182,9770649.98,4360,8033,3673,7207.21978,452.5356231
Cell 17 NW 2013,1750,181,9716965.09,-1836,9736,11572,6166.546961,1908.189525
Cell 17 SE 2013,1750,182,9770649.98,2194,8057,5863,7084.456044,1038.40067
Cell 17 SW 2013,1750,179,9609595.31,-1566,7617,9183,6592.446927,1364.621285
Cell 18 2011/12,1750,181,9716965.09,1132,9836,8704,5641.276243,2840.174088
Cell 18 NE 2013,1750,179,9609595.31,2188,8828,6640,7339.234637,1539.765371
Cell 18 NW 2013,1750,180,9663280.2,702,8449,7747,4304.733333,2211.026633
Cell 18 SE 2013,1750,181,9716965.09,1915,8607,6692,7238.906077,1276.586361
Cell 18 SSE 2013,1750,182,9770649.98,2688,8608,5920,7489.346154,962.6106022
Cell 19 NW 2013,1750,181,9716965.09,6512,8594,2082,8053.685083,515.4264932
Cell 2 2011/12,1750,183,9824334.87,2970,8077,5107,6599.945355,1231.977475
Cell 2 NE 2013,1750,183,9824334.87,3500,9266,5766,7479.797814,1245.11816
Cell 2 SW 2013,1750,183,9824334.87,6052,8350,2298,7826.907104,240.7544996
Cell 20 2013,1750,177,9502225.53,7247,8665,1418,7840.661017,324.3964205
Cell 21 2013,1750,179,9609595.31,2206,8914,6708,6945.50838,1369.748406
Cell 22 2013,1750,181,9716965.09,6712,8532,1820,7945.856354,417.3032223
Cell 23 2013,1750,180,9663280.2,7834,8920,1086,8537.755556,187.4689492
Cell 24 2013,1750,181,9716965.09,6993,8963,1970,7992.176796,375.3099665
Cell 25 NE 2013,1750,181,9716965.09,2104,8546,6442,6540.088398,1425.573275
Cell 25 SE 2013,1750,180,9663280.2,1342,8665,7323,5586.827778,1974.261273
Cell 26 NE 2013,1750,179,9609595.31,2705,8456,5751,7040.329609,1118.829135
Cell 26 NNW 2013,1750,180,9663280.2,4040,8542,4502,7141.322222,740.0562716
Cell 26 NW 2013,1750,180,9663280.2,2952,9270,6318,7180.888889,1707.885037
Cell 27 NW 2013,1750,181,9716965.09,1916,8632,6716,7264.254144,1189.66576
Cell 28 2013,1750,180,9663280.2,1336,9055,7719,6393.05,1738.498302
Cell 29 2013,1750,180,9663280.2,5195,8891,3696,7700.538889,710.5138623
Cell 3 NE 2013,1750,179,9609595.31,-1067,9023,10090,7337.832402,1978.437845
Cell 3 NW 2013,1750,182,9770649.98,4179,9266,5087,7420.582418,969.2648632
Cell 30 2013,1750,180,9663280.2,6794,8463,1669,7980.177778,335.4207997
Cell 31 2013,1750,180,9663280.2,7137,8581,1444,8112.45,314.8764004
Cell 32 2013,1750,183,9824334.87,6439,8741,2302,7784.502732,489.4532231
Cell 33 NE 2013,1750,182,9770649.98,4360,8033,3673,7207.21978,452.5356231
Cell 33 SE 2013,1750,178,9555910.42,2164,9693,7529,6924.331461,1785.974812
Cell 33 SW 2013,1750,179,9609595.31,579,9547,8968,4594.284916,2507.116337
Cell 34 N 2013,1750,179,9609595.31,3233,8321,5088,7330.435754,554.0275088
Cell 34 NW 2013,1750,181,9716965.09,5968,8503,2535,7443.972376,594.7483096
Cell 34 SE 2013,1750,182,9770649.98,2062,7752,5690,6637.082418,1403.375874
Cell 35 2013,1750,179,9609595.31,1310,9950,8640,6116.899441,2474.067906
Cell 37 2013,1750,182,9770649.98,7131,8622,1491,8070.895604,227.0823181
Cell 38 2013,1750,179,9609595.31,6445,8439,1994,7886.027933,294.3338171
Cell 39 2013,1750,179,9609595.31,6681,9036,2355,8430.843575,423.3347766
Cell 4 2013,1750,182,9770649.98,7287,8386,1099,7850.082418,210.1683752
Cell 40 NE 2013,1750,180,9663280.2,1098,9561,8463,6002.366667,2287.701046
Cell 41 N 2013,1750,179,9609595.31,720,9959,9239,7785.843575,1581.097981
Cell 41 NW 2013,1750,182,9770649.98,349,9972,9623,6532.120879,2822.066351
Cell 42 NW 2013,1750,179,9609595.31,993,8769,7776,5267.888268,2581.139329
Cell 43 2013,1750,180,9663280.2,2138,8783,6645,7399.572222,1016.093664
Cell 44 2013,1750,180,9663280.2,5854,8660,2806,8004.772222,390.8596769
Cell 45 2013,1750,182,9770649.98,7274,8414,1140,7980.851648,263.0688394
Cell 47 2013,1750,179,9609595.31,6495,8374,1879,7642.055866,361.0524919
Cell 48 2013,1750,181,9716965.09,6998,8719,1721,8123.337017,369.9634926
Cell 49 2013,1750,180,9663280.2,6104,8529,2425,7444.488889,460.96496
Cell 5 2011/12 Summer,1750,179,9609595.31,-1566,7617,9183,6592.446927,1364.621285
Cell 5 2013,1750,179,9609595.31,6707,8707,2000,7957.871508,360.7254953
Cell 50 2013,1750,179,9609595.31,7124,8718,1594,8030.687151,324.0436421
Cell 51 2013,1750,180,9663280.2,7187,8869,1682,8097.844444,344.8701982
Cell 52 2013,1750,179,9609595.31,7097,8535,1438,7883.854749,290.136206
Cell 53 2013,1750,182,9770649.98,6341,8522,2181,7703.510989,543.3628879
Cell 54 2013,1750,183,9824334.87,7320,8871,1551,8273.830601,390.0205526
Cell 55 2013,1750,180,9663280.2,6942,8903,1961,8270.5,362.7491711
Cell 56 2013,1750,179,9609595.31,6133,7889,1756,6914.905028,262.3866969
Cell 57 2013,1750,183,9824334.87,5444,8394,2950,7448.136612,571.8285194
Cell 58 2013,1750,179,9609595.31,7586,8885,1299,8409.882682,264.6669514
Cell 59 2013,1750,181,9716965.09,6614,8233,1619,7274.651934,350.356165
Cell 6 2011/12,1750,181,9716965.09,6512,8569,2057,8171.20442,411.4401834
Cell 6 2013,1750,181,9716965.09,5788,8726,2938,8210.414365,271.5292067
Cell 6 NE 2011/12,1750,181,9716965.09,2615,8598,5983,7679.381215,991.2550912
Cell 6 NW 2011/12,1750,180,9663280.2,1838,9147,7309,7497.105556,1415.305591
Cell 6 SW 2011/12,1750,181,9716965.09,2188,8994,6806,7325.303867,1583.43066
Cell 60 2013,1750,178,9555910.42,5658,7978,2320,7118.870787,481.113596
Cell 61 2013,1750,181,9716965.09,6333,8549,2216,7686.519337,462.3675273
Cell 7 2013,1750,181,9716965.09,6672,8579,1907,7986.21547,401.2557815
Cell 9 NW 2013,1750,181,9716965.09,2727,8280,5553,6389.071823,1525.752915
Cell 9 SE 2013,1750,181,9716965.09,3318,9550,6232,7106.569061,1071.876025
Cell 9 SW 2013,1750,183,9824334.87,1597,9736,8139,6073.431694,1608.572583
Cell R1,1750,177,9502225.53,2024,8178,6154,6997.20904,866.8066638
Cell R10,1750,182,9770649.98,7287,8386,1099,7850.082418,210.1683752
Cell R100,1750,179,9609595.31,7124,8718,1594,8030.687151,324.0436421
Cell R101,1750,181,9716965.09,7352,8722,1370,8101.458564,281.1743619
Cell R104,1750,183,9824334.87,7490,8856,1366,8023.601093,249.1205502
Cell R105,1750,182,9770649.98,6341,8522,2181,7703.510989,543.3628879
Cell R106,1750,182,9770649.98,4805,8480,3675,7509.175824,789.0205097
Cell R107,1750,183,9824334.87,7320,8871,1551,8273.830601,390.0205526
Cell R11,1750,179,9609595.31,6707,8707,2000,7957.871508,360.7254953
Cell R111,1750,183,9824334.87,1875,8985,7110,7767.295082,1348.038421
Cell R112,1750,179,9609595.31,7422,8388,966,8049.324022,207.0015411
Cell R113,1750,183,9824334.87,5444,8394,2950,7448.136612,571.8285194
Cell R114,1750,179,9609595.31,7586,8885,1299,8409.882682,264.6669514
Cell R117,1750,180,9663280.2,5522,8166,2644,7059.133333,529.4393303
Cell R118,1750,179,9609595.31,6133,7889,1756,6914.905028,262.3866969
Cell R119,1750,182,9770649.98,3672,7835,4163,6722.291209,851.5661446
Cell R120,1750,180,9663280.2,5236,8534,3298,8057.683333,498.3796464
Cell R121,1750,182,9770649.98,6617,8745,2128,7941.241758,375.0038341
Cell R123,1750,184,9878019.76,6600,8233,1633,7487.663043,321.3282142
Cell R124,1750,178,9555910.42,6169,8017,1848,7340.926966,397.982525
Cell R125,1750,180,9663280.2,3203,8035,4832,7102.783333,952.4967149
Cell R126,1750,179,9609595.31,5588,8551,2963,7708.815642,652.5687828
Cell R15,1750,178,9555910.42,2161,7718,5557,6478.275281,1040.042992
Cell R16,1750,181,9716965.09,2727,8280,5553,6408.309392,1515.534872
Cell R17,1750,179,9609595.31,3887,8746,4859,7356.664804,868.2837238
Cell R18,1750,180,9663280.2,3199,8812,5613,7032.8,1084.455339
Cell R19,1750,180,9663280.2,7212,8475,1263,7909.538889,248.9554035
Cell R20,1750,178,9555910.42,7084,8144,1060,7707.691011,228.1210255
Cell R21,1750,178,9555910.42,6867,8186,1319,7655.764045,257.2432514
Cell R22,1750,178,9555910.42,7298,8730,1432,7971.157303,321.9783438
Cell R24,1750,181,9716965.09,-1836,9736,11572,6166.546961,1908.189525
Cell R25,1750,180,9663280.2,702,8449,7747,4304.733333,2211.026633
Cell R26,1750,183,9824334.87,1838,9147,7309,7558.409836,1302.869167
Cell R27,1750,181,9716965.09,6512,8594,2082,8053.685083,515.4264932
Cell R28,1750,183,9824334.87,2052,9571,7519,6872.874317,1570.83457
Cell R29,1750,177,9502225.53,7247,8665,1418,7840.661017,324.3964205
Cell R30,1750,181,9716965.09,5843,8415,2572,7633.911602,518.393612
Cell R31,1750,180,9663280.2,4978,8653,3675,7701.333333,638.318938
Cell R35,1750,179,9609595.31,-1566,7617,9183,6592.446927,1364.621285
Cell R36,1750,182,9770649.98,2194,8057,5863,7084.456044,1038.40067
Cell R37,1750,181,9716965.09,1915,8607,6692,7238.906077,1276.586361
Cell R38,1750,180,9663280.2,5575,8634,3059,8074.794444,399.4709932
Cell R39,1750,182,9770649.98,6901,8604,1703,7818.230769,314.5557858
Cell R40,1750,179,9609595.31,2206,8914,6708,6945.50838,1369.748406
Cell R46,1750,180,9663280.2,631,8665,8034,4523.183333,2152.68934
Cell R47,1750,181,9716965.09,2952,9270,6318,7168.414365,1711.363919
Cell R48,1750,180,9663280.2,2705,8456,5751,7047.861111,1120.257925
Cell R49,1750,182,9770649.98,1916,8632,6716,7264.428571,1186.395267
Cell R5,1750,180,9663280.2,-1428,8079,9507,5716.622222,1979.611374
Cell R50,1750,180,9663280.2,1336,9055,7719,6393.05,1738.498302
Cell R51,1750,179,9609595.31,5195,8907,3712,7686.653631,721.8770324
Cell R52,1750,179,9609595.31,6307,8492,2185,7645.536313,530.3148665
Cell R53,1750,179,9609595.31,4902,8419,3517,7733.089385,585.5060676
Cell R54,1750,179,9609595.31,7137,8581,1444,8113.03352,315.6576517
Cell R58,1750,181,9716965.09,557,8750,8193,5619.98895,2306.760877
Cell R59,1750,181,9716965.09,4360,8033,3673,7205.872928,453.4200794
Cell R6,1750,183,9824334.87,6052,8350,2298,7826.907104,240.7544996
Cell R60,1750,181,9716965.09,5968,8503,2535,7443.972376,594.7483096
Cell R61,1750,179,9609595.31,1310,9950,8640,6116.899441,2474.067906
Cell R62,1750,179,9609595.31,1284,8810,7526,5656.201117,2075.576095
Cell R63,1750,180,9663280.2,6367,8413,2046,7603.172222,349.9935211
Cell R64,1750,182,9770649.98,7431,8448,1017,8047.423077,201.3065895
Cell R65,1750,181,9716965.09,6794,8463,1669,7982.254144,335.6509492
Cell R66,1750,180,9663280.2,7219,8921,1702,8564.488889,315.5085223
Cell R69,1750,179,9609595.31,579,9547,8968,4594.284916,2507.116337
Cell R7,1750,182,9770649.98,4179,9266,5087,7420.582418,969.2648632
Cell R70,1750,178,9555910.42,2164,9693,7529,6924.331461,1785.974812
Cell R71,1750,182,9770649.98,2062,7752,5690,6637.082418,1403.375874
Cell R72,1750,179,9609595.31,911,7969,7058,4054.312849,1848.819319
Cell R73,1750,180,9663280.2,5396,9015,3619,7949.905556,532.1743626
Cell R74,1750,181,9716965.09,5061,9047,3986,7556.767956,861.8676247
Cell R75,1750,182,9770649.98,7131,8622,1491,8070.895604,227.0823181
Cell R76,1750,180,9663280.2,7343,8920,1577,8480.761111,333.7138555
Cell R77,1750,179,9609595.31,6445,8439,1994,7886.027933,294.3338171
Cell R8,1750,182,9770649.98,-1067,9038,10105,7360.247253,2181.435808
Cell R80,1750,180,9663280.2,1098,9561,8463,6002.366667,2287.701046
Cell R81,1750,182,9770649.98,3137,9496,6359,7586.197802,881.7848934
Cell R82,1750,179,9609595.31,993,8769,7776,5267.888268,2581.139329
Cell R83,1750,180,9663280.2,1407,8644,7237,6604.777778,1864.068038
Cell R84,1750,181,9716965.09,1292,8689,7397,5557.381215,2095.515041
Cell R85,1750,179,9609595.31,2138,8783,6645,7403.972067,1017.216612
Cell R86,1750,182,9770649.98,6656,8406,1750,7871.318681,280.8546368
Cell R87,1750,181,9716965.09,7274,8414,1140,7981.464088,263.6651256
Cell R9,1750,181,9716965.09,5265,9023,3758,7441.729282,804.8716233
Cell R90,1750,180,9663280.2,6495,8374,1879,7645.361111,362.7536318
Cell R91,1750,181,9716965.09,6998,8719,1721,8123.337017,369.9634926
Cell R92,1750,179,9609595.31,1436,9904,8468,4581.385475,2662.761464
Cell R93,1750,180,9663280.2,6104,8529,2425,7444.488889,460.96496
Cell R97,1750,180,9663280.2,2637,9135,6498,7610.522222,1138.008467
Cell R98,1750,182,9770649.98,6681,8474,1793,7988.82967,371.8993994
Cell R99,1750,179,9609595.31,7097,8535,1438,7883.854749,290.136206
Cell S102,1750,183,9824334.87,6670,8782,2112,8142.857923,459.2966725
Cell S108,1750,180,9663280.2,6942,8903,1961,8270.5,362.7491711
Cell S13,1750,177,9502225.53,6887,8877,1990,7943.757062,408.0923275
Cell S14,1750,181,9716965.09,6672,8579,1907,7986.21547,401.2557815
Cell S2,1750,181,9716965.09,5788,8726,2938,8210.414365,271.5292067
Cell S23,1750,183,9824334.87,7481,8634,1153,8339.076503,184.0629337
Cell S32,1750,178,9555910.42,5982,8656,2674,7992.140449,515.8849247
Cell S33,1750,181,9716965.09,6876,8739,1863,7897.546961,371.8182653
Cell S34,1750,181,9716965.09,6993,8963,1970,7992.176796,375.3099665
Cell S41,1750,178,9555910.42,6697,8400,1703,7778.185393,335.4106897
Cell S42,1750,180,9663280.2,7834,8920,1086,8537.755556,187.4689492
Cell S44,1750,180,9663280.2,7434,8977,1543,8047.461111,265.2464968
Cell S56,1750,179,9609595.31,6630,8740,2110,7720.145251,386.1515769
Cell S67,1750,183,9824334.87,6439,8741,2302,7784.502732,489.4532231
Cell S78,1750,179,9609595.31,6681,9036,2355,8430.843575,423.3347766
Cell S88,1750,182,9770649.98,7209,8790,1581,8173.521978,373.8502625
Cell S94,1750,182,9770649.98,7126,9085,1959,8263.549451,353.9098806
Cell S95,1750,180,9663280.2,7187,8869,1682,8097.844444,344.8701982
W287,1750,178,9555910.42,1580,8828,7248,4582.303371,1785.364328
W295,1750,181,9716965.09,2234,8128,5894,6683.906077,1378.929037
W338,1750,180,9663280.2,3093,9399,6306,6839.983333,1409.62308
W342,1750,181,9716965.09,1668,7874,6206,6355.524862,1414.87097
W345,1750,183,9824334.87,5045,8372,3327,7358.016393,417.9650216
W387,1750,181,9716965.09,2002,7579,5577,5899.414365,1487.297817
W393,1750,181,9716965.09,6855,8560,1705,7276.635359,262.9581394
W440,1750,180,9663280.2,2155,7276,5121,5405.788889,1291.341959
W441,1750,181,9716965.09,6853,8095,1242,7558.895028,246.5650095
W445,1750,180,9663280.2,5638,7589,1951,7027.105556,400.2878755
W500,1750,180,9663280.2,1876,8546,6670,6287.894444,2109.121983
1,2000,235,12615949.15,6052,8350,2298,7817.859574,276.1129461
2,2000,234,12562264.26,1796,8134,6338,6520.401709,1291.938698
3,2000,236,12669634.04,7340,8384,1044,7954.661017,184.5127445
4,2000,238,12777003.82,6156,8109,1953,7614.205882,312.4094014
5,2000,236,12669634.04,-1566,7617,9183,6484.483051,1520.035803
6,2000,234,12562264.26,6089,8594,2505,8100.935897,495.4720534
7,2000,235,12615949.15,5720,8722,3002,7719.357447,519.0773565
8,2000,237,12723318.93,2385,8325,5940,6356.046414,1467.929902
9,2000,236,12669634.04,6712,8590,1878,7882.080508,410.948363
10,2000,233,12508579.37,2055,8546,6491,6517.184549,1477.011341
11,2000,238,12777003.82,1923,8628,6705,6825.87395,1427.59687
12,2000,239,12830688.71,1336,9055,7719,6219.732218,1802.416461
13,2000,236,12669634.04,4961,8907,3946,7687.177966,739.0920693
14,2000,237,12723318.93,6238,8553,2315,7962.316456,456.0756621
16,2000,238,12777003.82,579,9547,8968,4357.836134,2498.860183
17,2000,236,12669634.04,5774,8503,2729,7429.813559,584.8472196
18,2000,236,12669634.04,1132,9931,8799,5264.733051,2917.853027
19,2000,234,12562264.26,1224,8810,7586,5272.5,2188.521882
20,2000,236,12669634.04,7131,8622,1491,8085.233051,225.322332
21,2000,234,12562264.26,6445,8439,1994,7879.230769,299.9702944
22,2000,233,12508579.37,-1781,9500,11281,5100.060086,2892.46489
23,2000,239,12830688.71,993,8769,7776,5349.108787,2489.039751
24,2000,238,12777003.82,6896,8719,1823,8114.239496,383.6030717
25,2000,238,12777003.82,6104,8530,2426,7488.554622,479.0833807
26,2000,233,12508579.37,7274,8420,1146,7972.630901,272.5210096
27,2000,236,12669634.04,6681,8474,1793,7978.487288,367.5580143
28,2000,235,12615949.15,6341,8522,2181,7739.621277,537.2946705
29,2000,235,12615949.15,6574,8718,2144,7964.493617,371.8033725
31,2000,234,12562264.26,5603,8523,2920,7962.076923,582.4151478
32,2000,236,12669634.04,5444,8394,2950,7458.983051,570.1070295
33,2000,236,12669634.04,6133,8114,1981,6936.775424,316.5736125
34,2000,234,12562264.26,5169,7943,2774,7008.226496,538.6902643
10A,2000,237,12723318.93,2616,9270,6654,7159.451477,1677.982442
10NE,2000,237,12723318.93,2952,9189,6237,7190.308017,920.483336
10NW,2000,236,12669634.04,2194,8183,5989,7055.033898,1062.465772
10SW,2000,238,12777003.82,835,8665,7830,5395.806723,2058.253117
11NE,2000,235,12615949.15,1850,8607,6757,7232.829787,1368.223758
11NW,2000,237,12723318.93,1345,8608,7263,7179.822785,1432.581192
11SE,2000,234,12562264.26,1916,8632,6716,7067.017094,1353.904338
17NW,2000,234,12562264.26,4252,8633,4381,7211.606838,556.2456485
17SE,2000,235,12615949.15,2062,8232,6170,6690.217021,1384.007293
17SW,2000,238,12777003.82,1933,9693,7760,6689.672269,1961.089911
22S,2000,236,12669634.04,-1781,9500,11281,4881.90678,2878.441582
23S,2000,240,12884373.6,1386,7582,6196,3089.954167,1420.488262
24S,2000,235,12615949.15,6896,8719,1823,8113.982979,384.4027804
27A,2000,237,12723318.93,1628,9135,7507,6483.666667,2175.396685
2A,2000,237,12723318.93,2362,8812,6450,6646.004219,1579.053179
5NE,2000,234,12562264.26,2485,9550,7065,6979.346154,1157.522895
5NW,2000,234,12562264.26,1597,9736,8139,5990.854701,1658.344173
5SE,2000,237,12723318.93,702,9804,9102,4406.578059,2368.837948
6NE,2000,236,12669634.04,2615,8598,5983,7496.368644,1219.129296
6NW,2000,237,12723318.93,1838,9147,7309,7338.953586,1584.479279
6SW,2000,235,12615949.15,2188,8994,6806,7278.548936,1562.582198
Cell 1 2011/12,2000,235,12615949.15,6052,8350,2298,7817.859574,276.1129461
Cell 1 SW 2013,2000,236,12669634.04,561,7718,7157,6253.04661,1306.650898
Cell 10 2011/12,2000,233,12508579.37,2055,8546,6491,6517.184549,1477.011341
Cell 10 NE 2011/12,2000,237,12723318.93,2952,9189,6237,7190.308017,920.483336
Cell 10 NW 2011/12,2000,236,12669634.04,2194,8183,5989,7055.033898,1062.465772
Cell 10 SE 2013,2000,237,12723318.93,1838,9147,7309,7338.953586,1584.479279
Cell 10 SW 2011/12,2000,238,12777003.82,835,8665,7830,5395.806723,2058.253117
Cell 10-A 2011/12,2000,237,12723318.93,2616,9270,6654,7159.451477,1677.982442
Cell 11 NE 2011/12,2000,235,12615949.15,1850,8607,6757,7232.829787,1368.223758
Cell 11 NW 2013,2000,238,12777003.82,2970,8812,5842,6876.957983,1257.832836
Cell 11 SW 2013,2000,237,12723318.93,6044,8796,2752,7959.675105,635.3626095
Cell 12 2013,2000,234,12562264.26,5720,8722,3002,7719.504274,520.1804441
Cell 13 2013,2000,236,12669634.04,2239,8265,6026,6128.338983,1576.270941
Cell 14 2013,2000,237,12723318.93,7298,8733,1435,7986.919831,322.349677
Cell 15 2013,2000,236,12669634.04,6900,8561,1661,7956.317797,328.6518763
Cell 15-A 2013,2000,237,12723318.93,6876,8739,1863,7910.696203,366.987647
Cell 16 2013,2000,234,12562264.26,7101,8858,1757,7907.799145,337.9428943
Cell 17 NW 2011/12,2000,234,12562264.26,4252,8633,4381,7211.606838,556.2456485
Cell 17 NW 2013,2000,235,12615949.15,-1836,9736,11572,6202.92766,1871.061069
Cell 17 SE 2013,2000,236,12669634.04,2194,8183,5989,7055.033898,1062.465772
Cell 17 SW 2013,2000,236,12669634.04,-1566,7617,9183,6507.411017,1509.460167
Cell 18 2011/12,2000,236,12669634.04,1132,9931,8799,5264.733051,2917.853027
Cell 18 NE 2013,2000,235,12615949.15,2188,8994,6806,7243.374468,1605.727887
Cell 18 NW 2013,2000,235,12615949.15,702,8787,8085,4074.46383,2254.337663
Cell 18 SE 2013,2000,235,12615949.15,1850,8607,6757,7232.829787,1368.223758
Cell 18 SSE 2013,2000,235,12615949.15,2688,8608,5920,7345.812766,1206.754938
Cell 19 NW 2013,2000,235,12615949.15,6512,8633,2121,8086.519149,489.6616664
Cell 2 2011/12,2000,234,12562264.26,1796,8134,6338,6520.401709,1291.938698
Cell 2 NE 2013,2000,234,12562264.26,-1671,9266,10937,7240.064103,1492.631703
Cell 2 SW 2013,2000,235,12615949.15,6052,8350,2298,7818.251064,275.9497656
Cell 20 2013,2000,236,12669634.04,7139,8769,1630,7839.131356,340.8319267
Cell 21 2013,2000,237,12723318.93,2206,8914,6708,7022.540084,1423.217794
Cell 22 2013,2000,237,12723318.93,6712,8584,1872,7972.004219,406.7589558
Cell 23 2013,2000,239,12830688.71,7834,8920,1086,8516.995816,193.9552098
Cell 24 2013,2000,233,12508579.37,6891,8963,2072,7982.030043,363.0705532
Cell 25 NE 2013,2000,233,12508579.37,2055,8546,6491,6517.184549,1477.011341
Cell 25 SE 2013,2000,238,12777003.82,835,8665,7830,5395.806723,2058.253117
Cell 26 NE 2013,2000,238,12777003.82,1923,8628,6705,6825.87395,1427.59687
Cell 26 NNW 2013,2000,237,12723318.93,2952,9189,6237,7190.308017,920.483336
Cell 26 NW 2013,2000,237,12723318.93,2616,9270,6654,7159.451477,1677.982442
Cell 27 NW 2013,2000,233,12508579.37,1916,8632,6716,7069.974249,1356.052314
Cell 28 2013,2000,239,12830688.71,1336,9055,7719,6219.732218,1802.416461
Cell 29 2013,2000,238,12777003.82,4961,8907,3946,7674.042017,750.066937
Cell 3 NE 2013,2000,236,12669634.04,-1067,9038,10105,7293.576271,1949.472027
Cell 3 NW 2013,2000,236,12669634.04,4179,9266,5087,7394.330508,953.2502477
Cell 30 2013,2000,234,12562264.26,6794,8672,1878,8006.264957,323.9546078
Cell 31 2013,2000,236,12669634.04,6238,8583,2345,8081.970339,352.2428428
Cell 32 2013,2000,236,12669634.04,6371,8741,2370,7764.690678,503.791945
Cell 33 NE 2013,2000,234,12562264.26,4252,8633,4381,7211.606838,556.2456485
Cell 33 SE 2013,2000,238,12777003.82,1933,9693,7760,6689.672269,1961.089911
Cell 33 SW 2013,2000,237,12723318.93,579,9547,8968,4266.324895,2496.002001
Cell 34 N 2013,2000,237,12723318.93,2218,8321,6103,7139.767932,986.4394871
Cell 34 NW 2013,2000,236,12669634.04,5774,8503,2729,7429.813559,584.8472196
Cell 34 SE 2013,2000,236,12669634.04,2062,8232,6170,6682.114407,1386.646338
Cell 35 2013,2000,239,12830688.71,1132,9950,8818,5691.062762,2706.68852
Cell 37 2013,2000,233,12508579.37,7131,8622,1491,8076.922747,225.2562166
Cell 38 2013,2000,235,12615949.15,6445,8571,2126,7882.646809,302.3427369
Cell 39 2013,2000,238,12777003.82,6681,9036,2355,8413.42437,414.1920968
Cell 4 2013,2000,235,12615949.15,7206,8386,1180,7837.629787,211.6461398
Cell 40 NE 2013,2000,238,12777003.82,-834,9597,10431,5681.436975,2482.366102
Cell 41 N 2013,2000,236,12669634.04,720,9959,9239,7649.567797,1614.644572
Cell 41 NW 2013,2000,235,12615949.15,-1781,9972,11753,6622.259574,2853.766746
Cell 42 NW 2013,2000,235,12615949.15,881,8769,7888,5087.902128,2595.785918
Cell 43 2013,2000,237,12723318.93,1847,8783,6936,7274.945148,1168.151207
Cell 44 2013,2000,239,12830688.71,5854,8660,2806,7987.949791,386.5915936
Cell 45 2013,2000,235,12615949.15,7274,8420,1146,7970.370213,272.4549917
Cell 47 2013,2000,237,12723318.93,6495,8446,1951,7665.974684,384.8127489
Cell 48 2013,2000,234,12562264.26,6896,8719,1823,8112.700855,384.7215502
Cell 49 2013,2000,239,12830688.71,6104,8530,2426,7488.301255,478.0960422
Cell 5 2011/12 Summer,2000,235,12615949.15,-1566,7617,9183,6505.187234,1512.282561
Cell 5 2013,2000,236,12669634.04,6707,8707,2000,7948.245763,335.0827987
Cell 50 2013,2000,235,12615949.15,6574,8718,2144,7964.493617,371.8033725
Cell 51 2013,2000,239,12830688.71,7187,8869,1682,8106.439331,354.7557995
Cell 52 2013,2000,236,12669634.04,7097,8535,1438,7895.402542,289.3289779
Cell 53 2013,2000,235,12615949.15,6341,8522,2181,7739.621277,537.2946705
Cell 54 2013,2000,235,12615949.15,6277,8897,2620,8253.970213,434.2578349
Cell 55 2013,2000,237,12723318.93,6942,8903,1961,8295.531646,356.3358832
Cell 56 2013,2000,236,12669634.04,6133,8114,1981,6938.389831,316.0349968
Cell 57 2013,2000,234,12562264.26,5444,8394,2950,7455.846154,571.2809585
Cell 58 2013,2000,237,12723318.93,7586,8885,1299,8429.088608,247.6769975
Cell 59 2013,2000,237,12723318.93,6413,8233,1820,7268.320675,380.5732387
Cell 6 2011/12,2000,234,12562264.26,6089,8594,2505,8100.935897,495.4720534
Cell 6 2013,2000,233,12508579.37,5788,8726,2938,8162.484979,337.4365634
Cell 6 NE 2011/12,2000,236,12669634.04,2615,8598,5983,7496.368644,1219.129296
Cell 6 NW 2011/12,2000,237,12723318.93,1838,9147,7309,7338.953586,1584.479279
Cell 6 SW 2011/12,2000,235,12615949.15,2188,8994,6806,7278.548936,1562.582198
Cell 60 2013,2000,236,12669634.04,5658,7978,2320,7145.601695,480.3881489
Cell 61 2013,2000,233,12508579.37,5774,8549,2775,7668.733906,514.2705551
Cell 7 2013,2000,237,12723318.93,6034,8640,2606,8016.337553,420.7729726
Cell 9 NW 2013,2000,233,12508579.37,2164,8773,6609,6305.738197,1587.336605
Cell 9 SE 2013,2000,235,12615949.15,2485,9550,7065,6970.846809,1162.351762
Cell 9 SW 2013,2000,236,12669634.04,1597,9736,8139,6001.199153,1655.299046
Cell R1,2000,241,12938058.49,2024,8178,6154,6794.112033,1189.875673
Cell R10,2000,235,12615949.15,7206,8386,1180,7837.629787,211.6461398
Cell R100,2000,235,12615949.15,6574,8718,2144,7964.493617,371.8033725
Cell R101,2000,234,12562264.26,7160,8722,1562,8083.051282,279.1442156
Cell R104,2000,234,12562264.26,7309,8856,1547,8043.038462,267.6242315
Cell R105,2000,235,12615949.15,6341,8522,2181,7739.621277,537.2946705
Cell R106,2000,235,12615949.15,3075,8480,5405,7434.510638,923.8146879
Cell R107,2000,235,12615949.15,6277,8897,2620,8253.970213,434.2578349
Cell R11,2000,236,12669634.04,6707,8707,2000,7948.245763,335.0827987
Cell R111,2000,236,12669634.04,1736,8985,7249,7656.432203,1592.314965
Cell R112,2000,237,12723318.93,7098,8486,1388,8026.261603,246.1153873
Cell R113,2000,234,12562264.26,5444,8394,2950,7455.846154,571.2809585
Cell R114,2000,237,12723318.93,7586,8885,1299,8429.088608,247.6769975
Cell R117,2000,235,12615949.15,5522,8166,2644,7080.323404,517.6092399
Cell R118,2000,236,12669634.04,6133,8114,1981,6938.389831,316.0349968
Cell R119,2000,235,12615949.15,3672,7835,4163,6796.821277,812.4766353
Cell R120,2000,241,12938058.49,5236,8534,3298,7976.66805,590.1483654
Cell R121,2000,236,12669634.04,6617,8746,2129,7976.288136,367.4089326
Cell R123,2000,236,12669634.04,6600,8233,1633,7462.45339,333.757984
Cell R124,2000,237,12723318.93,5658,8020,2362,7339.059072,448.0830298
Cell R125,2000,238,12777003.82,3203,8272,5069,7036.109244,1066.976875
Cell R126,2000,236,12669634.04,5439,8551,3112,7551.457627,754.982839
Cell R15,2000,236,12669634.04,561,7718,7157,6253.04661,1306.650898
Cell R16,2000,234,12562264.26,2164,8773,6609,6322.991453,1566.516567
Cell R17,2000,235,12615949.15,3183,8746,5563,7253.66383,992.4611798
Cell R18,2000,240,12884373.6,2970,8812,5842,6836.55,1286.435912
Cell R19,2000,233,12508579.37,7212,8961,1749,7900.150215,262.9506207
Cell R20,2000,236,12669634.04,6763,8144,1381,7707.288136,238.8030392
Cell R21,2000,237,12723318.93,6867,8366,1499,7660.443038,263.6835983
Cell R22,2000,237,12723318.93,7298,8733,1435,7986.919831,322.349677
Cell R24,2000,235,12615949.15,-1836,9736,11572,6202.92766,1871.061069
Cell R25,2000,235,12615949.15,702,8787,8085,4074.46383,2254.337663
Cell R26,2000,236,12669634.04,1838,9147,7309,7367.5,1508.818531
Cell R27,2000,235,12615949.15,6512,8633,2121,8086.519149,489.6616664
Cell R28,2000,235,12615949.15,2052,9571,7519,6832.855319,1696.555686
Cell R29,2000,236,12669634.04,7139,8769,1630,7839.131356,340.8319267
Cell R30,2000,236,12669634.04,5843,8415,2572,7610.529661,539.2975531
Cell R31,2000,236,12669634.04,4978,8653,3675,7686.987288,599.758394
Cell R35,2000,235,12615949.15,-1566,7617,9183,6505.187234,1512.282561
Cell R36,2000,236,12669634.04,2194,8183,5989,7055.033898,1062.465772
Cell R37,2000,235,12615949.15,1850,8607,6757,7232.829787,1368.223758
Cell R38,2000,238,12777003.82,5575,8634,3059,7973.344538,544.9224513
Cell R39,2000,234,12562264.26,6598,8635,2037,7815.226496,363.5316737
Cell R40,2000,237,12723318.93,2206,8914,6708,7022.540084,1423.217794
Cell R46,2000,238,12777003.82,631,8665,8034,4509.911765,2262.63597
Cell R47,2000,237,12723318.93,2616,9270,6654,7159.451477,1677.982442
Cell R48,2000,238,12777003.82,1923,8628,6705,6825.87395,1427.59687
Cell R49,2000,233,12508579.37,1916,8632,6716,7069.974249,1356.052314
Cell R5,2000,237,12723318.93,-1428,8079,9507,5680.767932,2009.369194
Cell R50,2000,240,12884373.6,1336,9055,7719,6223.795833,1799.754269
Cell R51,2000,236,12669634.04,4961,8907,3946,7653.817797,769.8570447
Cell R52,2000,235,12615949.15,6307,8495,2188,7699.991489,533.1668933
Cell R53,2000,236,12669634.04,4412,8419,4007,7695.29661,608.0119913
Cell R54,2000,235,12615949.15,6238,8583,2345,8081.187234,352.7864387
Cell R58,2000,236,12669634.04,557,8750,8193,5299.792373,2316.581675
Cell R59,2000,234,12562264.26,4252,8633,4381,7211.606838,556.2456485
Cell R6,2000,235,12615949.15,6052,8350,2298,7818.251064,275.9497656
Cell R60,2000,236,12669634.04,5774,8503,2729,7429.813559,584.8472196
Cell R61,2000,239,12830688.71,1132,9950,8818,5691.062762,2706.68852
Cell R62,2000,236,12669634.04,1224,8810,7586,5220.665254,2208.367908
Cell R63,2000,236,12669634.04,1847,8413,6566,7539.322034,600.8467666
Cell R64,2000,237,12723318.93,6464,8472,2008,8025.675105,278.7293803
Cell R65,2000,234,12562264.26,6794,8672,1878,8006.264957,323.9546078
Cell R66,2000,239,12830688.71,7219,8921,1702,8545.514644,320.3479652
Cell R69,2000,237,12723318.93,579,9547,8968,4266.324895,2496.002001
Cell R7,2000,236,12669634.04,4179,9266,5087,7394.330508,953.2502477
Cell R70,2000,238,12777003.82,1933,9693,7760,6689.672269,1961.089911
Cell R71,2000,235,12615949.15,2062,8232,6170,6682.302128,1389.590525
Cell R72,2000,236,12669634.04,911,7969,7058,3940.5,1876.358492
Cell R73,2000,235,12615949.15,3337,9015,5678,7786.306383,747.1117207
Cell R74,2000,235,12615949.15,5061,9047,3986,7531.770213,888.6871876
Cell R75,2000,233,12508579.37,7131,8622,1491,8076.922747,225.2562166
Cell R76,2000,240,12884373.6,7064,8920,1856,8453.841667,332.8513181
Cell R77,2000,235,12615949.15,6445,8571,2126,7882.646809,302.3427369
Cell R8,2000,236,12669634.04,-1067,9038,10105,7356.15678,2154.446269
Cell R80,2000,238,12777003.82,-834,9597,10431,5681.436975,2482.366102
Cell R81,2000,234,12562264.26,3137,9496,6359,7566.487179,869.5297984
Cell R82,2000,235,12615949.15,881,8769,7888,5087.902128,2595.785918
Cell R83,2000,238,12777003.82,853,8689,7836,6407.063025,2105.104311
Cell R84,2000,235,12615949.15,1292,8783,7491,5270.374468,2245.087175
Cell R85,2000,238,12777003.82,1384,8783,7399,7250.193277,1226.3943
Cell R86,2000,236,12669634.04,6656,8671,2015,7825.79661,315.9176722
Cell R87,2000,234,12562264.26,7274,8420,1146,7971.534188,272.4528676
Cell R9,2000,239,12830688.71,1025,9023,7998,7451.117155,890.1180419
Cell R90,2000,237,12723318.93,6495,8446,1951,7665.974684,384.8127489
Cell R91,2000,234,12562264.26,6896,8719,1823,8112.700855,384.7215502
Cell R92,2000,238,12777003.82,1436,9904,8468,4252.878151,2622.204536
Cell R93,2000,239,12830688.71,6104,8530,2426,7488.301255,478.0960422
Cell R97,2000,236,12669634.04,2341,9135,6794,7462.65678,1277.059187
Cell R98,2000,235,12615949.15,6681,8474,1793,7980.974468,366.3521143
Cell R99,2000,236,12669634.04,7097,8535,1438,7895.402542,289.3289779
Cell S102,2000,235,12615949.15,6670,8869,2199,8159.544681,457.5337322
Cell S108,2000,237,12723318.93,6942,8903,1961,8295.531646,356.3358832
Cell S13,2000,236,12669634.04,6589,8877,2288,7957.711864,414.3095359
Cell S14,2000,236,12669634.04,6034,8640,2606,8013.830508,419.8934349
Cell S2,2000,233,12508579.37,5788,8726,2938,8162.484979,337.4365634
Cell S23,2000,236,12669634.04,7481,8741,1260,8310.944915,194.3870231
Cell S32,2000,238,12777003.82,5982,8726,2744,8009.52521,505.5939071
Cell S33,2000,236,12669634.04,6876,8739,1863,7912.101695,367.1272788
Cell S34,2000,233,12508579.37,6891,8963,2072,7982.030043,363.0705532
Cell S41,2000,237,12723318.93,6697,8400,1703,7813.751055,325.0728079
Cell S42,2000,239,12830688.71,7834,8920,1086,8516.995816,193.9552098
Cell S44,2000,239,12830688.71,7220,8977,1757,8055.757322,299.2035867
Cell S56,2000,235,12615949.15,6630,8938,2308,7741.442553,386.6894074
Cell S67,2000,237,12723318.93,6371,8741,2370,7767.28692,504.3076069
Cell S78,2000,237,12723318.93,6681,9036,2355,8415.616034,413.6855655
Cell S88,2000,236,12669634.04,7209,8828,1619,8203.779661,366.9359071
Cell S94,2000,236,12669634.04,7126,9085,1959,8273.860169,362.4857121
Cell S95,2000,240,12884373.6,7187,8869,1682,8105.108333,354.6134467
W287,2000,236,12669634.04,1306,8828,7522,4496.330508,1802.247691
W295,2000,234,12562264.26,2234,8246,6012,6758.034188,1338.69571
W338,2000,237,12723318.93,1712,9399,7687,6748.409283,1508.043776
W342,2000,239,12830688.71,1668,8099,6431,6212.90795,1638.68932
W345,2000,235,12615949.15,4538,8372,3834,7348.068085,487.2230251
W387,2000,234,12562264.26,1565,7634,6069,5705.957265,1677.975576
W393,2000,234,12562264.26,5585,8560,2975,7297.961538,328.6569839
W440,2000,237,12723318.93,1621,7276,5655,5306.468354,1345.004075
W441,2000,235,12615949.15,5026,8095,3069,7524.357447,307.8725349
W445,2000,237,12723318.93,5638,7589,1951,7010.109705,419.6499704
W500,2000,237,12723318.93,1720,8546,6826,6116.168776,2187.549056
1,2250,295,15837042.55,5235,8444,3209,7790.633898,359.7490861
2,2250,298,15998097.22,1796,8812,7016,6537.711409,1295.807166
3,2250,297,15944412.33,7048,8384,1336,7948.367003,216.3578607
4,2250,298,15998097.22,5604,8109,2505,7602.949664,366.789034
5,2250,299,16051782.11,-1566,7617,9183,6473.48495,1428.433671
6,2250,298,15998097.22,4815,8594,3779,8046.45302,568.1713155
7,2250,299,16051782.11,4510,9571,5061,7717.692308,598.6621978
8,2250,298,15998097.22,2239,8325,6086,6391.436242,1475.173182
9,2250,299,16051782.11,6583,8590,2007,7904.050167,412.2943077
10,2250,298,15998097.22,1771,8859,7088,6500.11745,1581.094181
11,2250,302,16212836.78,1503,8628,7125,6620.771523,1684.892328
12,2250,300,16105467,1336,9055,7719,6110.536667,1854.283958
13,2250,300,16105467,4688,8907,4219,7605.426667,816.9332029
14,2250,299,16051782.11,6238,8553,2315,7987.287625,431.0619665
16,2250,301,16159151.89,542,9547,9005,4146.189369,2478.338751
17,2250,297,15944412.33,5774,8503,2729,7412.323232,564.0723948
18,2250,296,15890727.44,1132,9950,8818,4850.912162,2947.994362
19,2250,304,16320206.56,1206,8810,7604,5032.296053,2260.836813
20,2250,298,15998097.22,6689,8622,1933,8083.97651,244.5943693
21,2250,297,15944412.33,6445,8571,2126,7879.286195,328.1400327
22,2250,296,15890727.44,-1781,9500,11281,4874.675676,2909.204184
23,2250,293,15729672.77,881,8769,7888,5163.430034,2552.311449
24,2250,300,16105467,6226,8719,2493,8094.366667,423.5705831
25,2250,293,15729672.77,6104,8530,2426,7522.460751,491.2266905
26,2250,300,16105467,7216,8658,1442,7975.37,292.926384
27,2250,300,16105467,6681,8533,1852,7979.63,354.8107004
28,2250,301,16159151.89,6341,8522,2181,7791.07309,515.7976965
29,2250,298,15998097.22,6311,8718,2407,7907.352349,408.0626761
31,2250,299,16051782.11,5576,8523,2947,7917.856187,622.2781181
32,2250,298,15998097.22,5143,8394,3251,7457.674497,566.9018576
33,2250,299,16051782.11,5522,8114,2592,6971.287625,369.6032459
34,2250,297,15944412.33,5169,8083,2914,7069.814815,545.788383
10A,2250,300,16105467,2616,9270,6654,7132.486667,1652.829861
10NE,2250,298,15998097.22,1690,9189,7499,7094.600671,1218.877877
10NW,2250,301,16159151.89,2194,8183,5989,7008.55814,1056.489225
10SW,2250,302,16212836.78,835,8665,7830,5185.039735,2171.32497
11NE,2250,295,15837042.55,1850,8607,6757,7180.240678,1465.229374
11NW,2250,297,15944412.33,1262,8608,7346,7037.117845,1646.724582
11SE,2250,299,16051782.11,1916,8632,6716,6930.849498,1406.245161
17NW,2250,298,15998097.22,4034,9237,5203,7222.365772,691.9011576
17SE,2250,299,16051782.11,2062,8232,6170,6759.053512,1359.470902
17SW,2250,302,16212836.78,1933,9693,7760,6517.13245,1948.846112
22S,2250,301,16159151.89,-1781,9500,11281,4815.156146,2884.60358
23S,2250,300,16105467,1386,7582,6196,3156.45,1422.867802
24S,2250,302,16212836.78,6226,8719,2493,8079.754967,444.7951157
27A,2250,298,15998097.22,1572,9135,7563,6449.543624,2189.696453
2A,2250,297,15944412.33,2318,8812,6494,6555.885522,1629.107835
5NE,2250,299,16051782.11,2197,9550,7353,6759.759197,1336.824964
5NW,2250,297,15944412.33,1111,9736,8625,5899.360269,1750.478921
5SE,2250,298,15998097.22,702,9804,9102,4235.879195,2399.555
6NE,2250,295,15837042.55,2463,8598,6135,7348.413559,1376.450832
6NW,2250,294,15783357.66,1835,9147,7312,7198.312925,1741.287384
6SW,2250,301,16159151.89,1604,8994,7390,7210.159468,1656.71726
Cell 1 2011/12,2250,295,15837042.55,5235,8444,3209,7790.633898,359.7490861
Cell 1 SW 2013,2250,300,16105467,-128,7718,7846,6006.083333,1510.162562
Cell 10 2011/12,2250,298,15998097.22,1771,8859,7088,6500.11745,1581.094181
Cell 10 NE 2011/12,2250,298,15998097.22,1690,9189,7499,7094.600671,1218.877877
Cell 10 NW 2011/12,2250,301,16159151.89,2194,8183,5989,7008.55814,1056.489225
Cell 10 SE 2013,2250,294,15783357.66,1835,9147,7312,7198.312925,1741.287384
Cell 10 SW 2011/12,2250,302,16212836.78,835,8665,7830,5185.039735,2171.32497
Cell 10-A 2011/12,2250,300,16105467,2616,9270,6654,7132.486667,1652.829861
Cell 11 NE 2011/12,2250,295,15837042.55,1850,8607,6757,7180.240678,1465.229374
Cell 11 NW 2013,2250,297,15944412.33,2459,8812,6353,6756.010101,1364.942372
Cell 11 SW 2013,2250,299,16051782.11,6044,8842,2798,8018.016722,619.3428088
Cell 12 2013,2250,299,16051782.11,4510,9571,5061,7713.023411,594.984373
Cell 13 2013,2250,299,16051782.11,2239,8265,6026,6199.749164,1581.90787
Cell 14 2013,2250,297,15944412.33,7298,8733,1435,7992.232323,320.6127077
Cell 15 2013,2250,297,15944412.33,6876,8561,1685,7976.6633,332.629744
Cell 15-A 2013,2250,299,16051782.11,6876,8739,1863,7901.183946,365.2738693
Cell 16 2013,2250,299,16051782.11,6740,8963,2223,7918.367893,368.1564827
Cell 17 NW 2011/12,2250,298,15998097.22,4034,9237,5203,7222.365772,691.9011576
Cell 17 NW 2013,2250,295,15837042.55,-1836,9736,11572,6231.755932,1814.287472
Cell 17 SE 2013,2250,301,16159151.89,2194,8183,5989,7008.55814,1056.489225
Cell 17 SW 2013,2250,300,16105467,-1566,7617,9183,6465.863333,1440.197618
Cell 18 2011/12,2250,296,15890727.44,1132,9950,8818,4850.912162,2947.994362
Cell 18 NE 2013,2250,298,15998097.22,2188,8994,6806,7140.724832,1696.684067
Cell 18 NW 2013,2250,297,15944412.33,702,9804,9102,4054.222222,2356.634
Cell 18 SE 2013,2250,295,15837042.55,1850,8607,6757,7180.240678,1465.229374
Cell 18 SSE 2013,2250,299,16051782.11,1345,8608,7263,7189.190635,1414.782645
Cell 19 NW 2013,2250,299,16051782.11,6117,9253,3136,8106.545151,498.6456512
Cell 2 2011/12,2250,298,15998097.22,1796,8812,7016,6537.711409,1295.807166
Cell 2 NE 2013,2250,300,16105467,-1851,9266,11117,6941.846667,1773.318825
Cell 2 SW 2013,2250,298,15998097.22,5235,8444,3209,7788.557047,359.1136438
Cell 20 2013,2250,297,15944412.33,5970,8769,2799,7805.962963,384.1578248
Cell 21 2013,2250,299,16051782.11,2206,8914,6708,7094.26087,1376.989302
Cell 22 2013,2250,301,16159151.89,6712,8584,1872,7985.199336,412.5267334
Cell 23 2013,2250,294,15783357.66,7481,8920,1439,8490.632653,223.032763
Cell 24 2013,2250,297,15944412.33,6891,8963,2072,7983.703704,342.1346828
Cell 25 NE 2013,2250,297,15944412.33,1771,8859,7088,6515.895623,1560.156568
Cell 25 SE 2013,2250,302,16212836.78,835,8665,7830,5185.039735,2171.32497
Cell 26 NE 2013,2250,302,16212836.78,1503,8628,7125,6620.771523,1684.892328
Cell 26 NNW 2013,2250,298,15998097.22,1690,9189,7499,7094.600671,1218.877877
Cell 26 NW 2013,2250,298,15998097.22,2616,9270,6654,7125.493289,1655.685797
Cell 27 NW 2013,2250,299,16051782.11,1916,8632,6716,6930.849498,1406.245161
Cell 28 2013,2250,300,16105467,1336,9055,7719,6110.536667,1854.283958
Cell 29 2013,2250,298,15998097.22,4688,8907,4219,7606.59396,819.5255418
Cell 3 NE 2013,2250,297,15944412.33,-1067,9038,10105,7236.781145,1937.50267
Cell 3 NW 2013,2250,297,15944412.33,4179,9266,5087,7366.478114,973.4147989
Cell 30 2013,2250,297,15944412.33,6794,8673,1879,8026.006734,325.1498385
Cell 31 2013,2250,300,16105467,6238,8584,2346,8034.24,398.1759691
Cell 32 2013,2250,301,16159151.89,5860,8870,3010,7774.405316,533.4026128
Cell 33 NE 2013,2250,299,16051782.11,4034,9237,5203,7223.819398,691.1988138
Cell 33 SE 2013,2250,302,16212836.78,1933,9693,7760,6517.13245,1948.846112
Cell 33 SW 2013,2250,299,16051782.11,542,9547,9005,4010.622074,2463.934083
Cell 34 N 2013,2250,299,16051782.11,2218,8321,6103,7042.070234,1165.750697
Cell 34 NW 2013,2250,297,15944412.33,5774,8503,2729,7412.323232,564.0723948
Cell 34 SE 2013,2250,296,15890727.44,2062,8232,6170,6752.006757,1363.864365
Cell 35 2013,2250,293,15729672.77,1132,9950,8818,5432.21843,2811.190619
Cell 37 2013,2250,297,15944412.33,7131,8622,1491,8090.771044,229.7229662
Cell 38 2013,2250,301,16159151.89,6445,8571,2126,7887.348837,324.0742418
Cell 39 2013,2250,299,16051782.11,6681,9036,2355,8406.401338,388.4791797
Cell 4 2013,2250,301,16159151.89,7024,8386,1362,7820.255814,230.0927973
Cell 40 NE 2013,2250,293,15729672.77,-834,9597,10431,5502.931741,2620.477701
Cell 41 N 2013,2250,300,16105467,720,9972,9252,7501.72,1706.424985
Cell 41 NW 2013,2250,295,15837042.55,-1781,9972,11753,6676.813559,2815.92211
Cell 42 NW 2013,2250,301,16159151.89,418,8769,8351,4916.026578,2623.349977
Cell 43 2013,2250,301,16159151.89,1384,8783,7399,7121.524917,1468.490448
Cell 44 2013,2250,301,16159151.89,5854,8660,2806,7981.478405,392.3003083
Cell 45 2013,2250,300,16105467,7216,8658,1442,7975.416667,292.9086372
Cell 47 2013,2250,299,16051782.11,4828,8666,3838,7651.662207,502.5118607
Cell 48 2013,2250,300,16105467,6226,8719,2493,8078.36,445.885423
Cell 49 2013,2250,293,15729672.77,6104,8530,2426,7522.460751,491.2266905
Cell 5 2011/12 Summer,2250,300,16105467,-1566,7617,9183,6465.863333,1440.197618
Cell 5 2013,2250,298,15998097.22,6707,8707,2000,7940.939597,325.7076906
Cell 50 2013,2250,298,15998097.22,6311,8718,2407,7907.352349,408.0626761
Cell 51 2013,2250,300,16105467,7187,8869,1682,8120.08,360.7637827
Cell 52 2013,2250,299,16051782.11,7047,8535,1488,7914.936455,287.5014137
Cell 53 2013,2250,301,16159151.89,6341,8522,2181,7791.07309,515.7976965
Cell 54 2013,2250,299,16051782.11,6277,8970,2693,8225.685619,468.3176124
Cell 55 2013,2250,298,15998097.22,6942,8903,1961,8300.879195,365.7220295
Cell 56 2013,2250,300,16105467,5522,8114,2592,6967.176667,365.1942572
Cell 57 2013,2250,299,16051782.11,5143,8394,3251,7454.551839,568.5144402
Cell 58 2013,2250,299,16051782.11,7586,8885,1299,8439.237458,232.242479
Cell 59 2013,2250,296,15890727.44,6413,8233,1820,7266.25,388.8735877
Cell 6 2011/12,2250,298,15998097.22,4815,8594,3779,8046.45302,568.1713155
Cell 6 2013,2250,299,16051782.11,5788,8726,2938,8102.244147,391.1109004
Cell 6 NE 2011/12,2250,295,15837042.55,2463,8598,6135,7348.413559,1376.450832
Cell 6 NW 2011/12,2250,294,15783357.66,1835,9147,7312,7198.312925,1741.287384
Cell 6 SW 2011/12,2250,301,16159151.89,1604,8994,7390,7210.159468,1656.71726
Cell 60 2013,2250,301,16159151.89,5169,8083,2914,7147.671096,527.9018472
Cell 61 2013,2250,299,16051782.11,5774,8549,2775,7680.056856,542.5580315
Cell 7 2013,2250,300,16105467,6034,8640,2606,8021.826667,433.6347041
Cell 9 NW 2013,2250,299,16051782.11,1578,9285,7707,6206.602007,1698.160391
Cell 9 SE 2013,2250,299,16051782.11,2197,9550,7353,6759.759197,1336.824964
Cell 9 SW 2013,2250,296,15890727.44,1111,9736,8625,5894.834459,1751.697737
Cell R1,2250,293,15729672.77,1976,8197,6221,6619.327645,1361.911804
Cell R10,2250,301,16159151.89,7024,8386,1362,7820.255814,230.0927973
Cell R100,2250,297,15944412.33,6311,8718,2407,7906.804714,408.6397353
Cell R101,2250,299,16051782.11,6613,8722,2109,8050.548495,310.7650827
Cell R104,2250,300,16105467,7256,8996,1740,8050.266667,291.2560882
Cell R105,2250,302,16212836.78,6341,8522,2181,7791.652318,515.041066
Cell R106,2250,299,16051782.11,1784,8480,6696,7304.772575,1111.471125
Cell R107,2250,299,16051782.11,6277,8970,2693,8225.685619,468.3176124
Cell R11,2250,298,15998097.22,6707,8707,2000,7940.939597,325.7076906
Cell R111,2250,301,16159151.89,1736,8985,7249,7538.66113,1792.946269
Cell R112,2250,298,15998097.22,7098,8514,1416,8023.298658,268.9394309
Cell R113,2250,299,16051782.11,5143,8394,3251,7454.551839,568.5144402
Cell R114,2250,299,16051782.11,7586,8885,1299,8439.237458,232.242479
Cell R117,2250,297,15944412.33,5522,8166,2644,7102.292929,515.8593742
Cell R118,2250,300,16105467,5522,8114,2592,6967.176667,365.1942572
Cell R119,2250,301,16159151.89,3672,8005,4333,6851.757475,816.4647219
Cell R120,2250,293,15729672.77,5236,8534,3298,7927.62116,628.9968473
Cell R121,2250,301,16159151.89,6617,8746,2129,8011.405316,369.7713694
Cell R123,2250,302,16212836.78,6600,8233,1633,7466.68543,356.6325168
Cell R124,2250,297,15944412.33,5658,8083,2425,7347.670034,463.6892959
Cell R125,2250,302,16212836.78,3203,8555,5352,6979.854305,1124.193744
Cell R126,2250,299,16051782.11,4487,8551,4064,7482.826087,783.2877476
Cell R15,2250,300,16105467,-128,7718,7846,6006.083333,1510.162562
Cell R16,2250,297,15944412.33,1578,9285,7707,6249.282828,1643.486622
Cell R17,2250,297,15944412.33,2565,8746,6181,7174.582492,1152.882977
Cell R18,2250,300,16105467,2422,8812,6390,6739.813333,1396.042274
Cell R19,2250,297,15944412.33,5514,8969,3455,7883.037037,313.2028989
Cell R20,2250,297,15944412.33,6527,8308,1781,7682.343434,268.5097229
Cell R21,2250,299,16051782.11,6867,8366,1499,7657.301003,272.8108298
Cell R22,2250,297,15944412.33,7298,8733,1435,7992.232323,320.6127077
Cell R24,2250,295,15837042.55,-1836,9736,11572,6231.755932,1814.287472
Cell R25,2250,297,15944412.33,702,9804,9102,4054.222222,2356.634
Cell R26,2250,300,16105467,1838,9147,7309,7218.57,1696.92639
Cell R27,2250,298,15998097.22,6512,9253,2741,8113.221477,485.9572487
Cell R28,2250,301,16159151.89,2052,9571,7519,6766.538206,1813.269862
Cell R29,2250,297,15944412.33,5970,8769,2799,7805.962963,384.1578248
Cell R30,2250,300,16105467,5843,8415,2572,7589.83,541.0238144
Cell R31,2250,299,16051782.11,4978,8653,3675,7699.384615,565.5367142
Cell R35,2250,300,16105467,-1566,7617,9183,6465.863333,1440.197618
Cell R36,2250,301,16159151.89,2194,8183,5989,7008.55814,1056.489225
Cell R37,2250,295,15837042.55,1850,8607,6757,7180.240678,1465.229374
Cell R38,2250,301,16159151.89,4054,9787,5733,7842.159468,778.8287534
Cell R39,2250,299,16051782.11,6368,8773,2405,7795.571906,413.4516233
Cell R40,2250,299,16051782.11,2206,8914,6708,7094.26087,1376.989302
Cell R46,2250,298,15998097.22,631,8665,8034,4554.557047,2302.135695
Cell R47,2250,300,16105467,2616,9270,6654,7132.486667,1652.829861
Cell R48,2250,302,16212836.78,1503,8628,7125,6620.771523,1684.892328
Cell R49,2250,298,15998097.22,1916,8632,6716,6928.308725,1407.917341
Cell R5,2250,294,15783357.66,-1428,8079,9507,5629.329932,1977.154057
Cell R50,2250,300,16105467,1336,9055,7719,6110.536667,1854.283958
Cell R51,2250,299,16051782.11,3928,8907,4979,7587.304348,854.4353635
Cell R52,2250,300,16105467,5335,8584,3249,7726.256667,572.4082728
Cell R53,2250,299,16051782.11,4412,8490,4078,7703.856187,595.4391618
Cell R54,2250,300,16105467,6238,8584,2346,8034.24,398.1759691
Cell R58,2250,298,15998097.22,390,8907,8517,5023.013423,2348.401298
Cell R59,2250,299,16051782.11,4034,9237,5203,7224.468227,691.6960118
Cell R6,2250,298,15998097.22,5235,8444,3209,7788.557047,359.1136438
Cell R60,2250,298,15998097.22,5774,8503,2729,7413.234899,563.3443031
Cell R61,2250,293,15729672.77,1132,9950,8818,5432.21843,2811.190619
Cell R62,2250,297,15944412.33,1206,8810,7604,4965.393939,2248.628469
Cell R63,2250,297,15944412.33,1847,8632,6785,7478.13468,785.2231719
Cell R64,2250,300,16105467,4051,8585,4534,8021.406667,375.2716633
Cell R65,2250,297,15944412.33,6794,8673,1879,8026.006734,325.1498385
Cell R66,2250,302,16212836.78,7219,8921,1702,8519.877483,333.2774855
Cell R69,2250,299,16051782.11,542,9547,9005,4010.622074,2463.934083
Cell R7,2250,297,15944412.33,4179,9266,5087,7366.478114,973.4147989
Cell R70,2250,302,16212836.78,1933,9693,7760,6517.13245,1948.846112
Cell R71,2250,296,15890727.44,2062,8232,6170,6752.006757,1363.864365
Cell R72,2250,297,15944412.33,662,7976,7314,3996.713805,1919.434308
Cell R73,2250,299,16051782.11,1873,9015,7142,7582.210702,1105.606811
Cell R74,2250,299,16051782.11,2662,9400,6738,7455.816054,997.0573072
Cell R75,2250,298,15998097.22,7131,8622,1491,8090.42953,229.4127096
Cell R76,2250,302,16212836.78,7064,8929,1865,8443.937086,328.8805405
Cell R77,2250,300,16105467,6445,8571,2126,7885.49,323.0079822
Cell R8,2250,300,16105467,-1958,9038,10996,7321.876667,2076.207854
Cell R80,2250,293,15729672.77,-834,9597,10431,5502.931741,2620.477701
Cell R81,2250,299,16051782.11,3137,9496,6359,7510.913043,875.2744161
Cell R82,2250,300,16105467,418,8769,8351,4925.61,2622.453155
Cell R83,2250,298,15998097.22,853,8689,7836,6222.510067,2340.290981
Cell R84,2250,299,16051782.11,1292,8783,7491,5126.043478,2292.625205
Cell R85,2250,300,16105467,1384,8783,7399,7118.203333,1469.806621
Cell R86,2250,299,16051782.11,6656,8671,2015,7805.87291,325.7237641
Cell R87,2250,300,16105467,7216,8658,1442,7975.416667,292.9086372
Cell R9,2250,293,15729672.77,-959,9023,9982,7416.716724,1050.582695
Cell R90,2250,299,16051782.11,4828,8666,3838,7651.662207,502.5118607
Cell R91,2250,300,16105467,6226,8719,2493,8078.36,445.885423
Cell R92,2250,298,15998097.22,1436,9904,8468,3999.540268,2540.313839
Cell R93,2250,293,15729672.77,6104,8530,2426,7522.460751,491.2266905
Cell R97,2250,300,16105467,1617,9135,7518,7252.513333,1513.895506
Cell R98,2250,300,16105467,6681,8533,1852,7979.63,354.8107004
Cell R99,2250,299,16051782.11,7047,8535,1488,7916.735786,288.2961718
Cell S102,2250,296,15890727.44,6670,8869,2199,8168.672297,459.1917224
Cell S108,2250,298,15998097.22,6942,8903,1961,8300.879195,365.7220295
Cell S13,2250,297,15944412.33,6589,8877,2288,7967.070707,400.025721
Cell S14,2250,300,16105467,6034,8640,2606,8021.826667,433.6347041
Cell S2,2250,298,15998097.22,5788,8726,2938,8102.936242,391.5837478
Cell S23,2250,299,16051782.11,7455,8741,1286,8266.949833,231.1035055
Cell S32,2250,298,15998097.22,5982,8740,2758,8017.305369,499.9034108
Cell S33,2250,299,16051782.11,6876,8739,1863,7901.183946,365.2738693
Cell S34,2250,297,15944412.33,6891,8963,2072,7983.703704,342.1346828
Cell S41,2250,299,16051782.11,6697,8618,1921,7850.508361,323.1573166
Cell S42,2250,295,15837042.55,7481,8920,1439,8491.755932,223.4858994
Cell S44,2250,300,16105467,6954,8977,2023,8036.633333,326.9969096
Cell S56,2250,299,16051782.11,6630,8938,2308,7756.792642,382.3912753
Cell S67,2250,301,16159151.89,5860,8870,3010,7774.405316,533.4026128
Cell S78,2250,299,16051782.11,6681,9036,2355,8406.401338,388.4791797
Cell S88,2250,301,16159151.89,6869,8828,1959,8214.767442,368.5632413
Cell S94,2250,301,16159151.89,7126,9085,1959,8278.624585,365.7104431
Cell S95,2250,300,16105467,7187,8869,1682,8120.08,360.7637827
W287,2250,297,15944412.33,1306,8828,7522,4365.750842,1751.270236
W295,2250,299,16051782.11,2234,8312,6078,6775.086957,1316.999579
W338,2250,294,15783357.66,1469,9399,7930,6586.758503,1709.735302
W342,2250,295,15837042.55,1668,8283,6615,6108.311864,1763.449731
W345,2250,301,16159151.89,3500,8372,4872,7340.923588,527.7097361
W387,2250,298,15998097.22,1438,7851,6413,5556.362416,1853.404883
W393,2250,297,15944412.33,3049,8560,5511,7254.585859,529.8712062
W440,2250,298,15998097.22,1609,7276,5667,5270.969799,1350.112723
W441,2250,300,16105467,4985,8095,3110,7465.423333,419.2900159
W445,2250,294,15783357.66,5262,7719,2457,6960.054422,469.2465053
W500,2250,297,15944412.33,1353,8546,7193,5979.3367,2249.537014
1,2500,368,19756039.52,4379,8504,4125,7734.13587,509.3119752
2,2500,364,19541299.96,1796,8812,7016,6552.510989,1284.887286
3,2500,369,19809724.41,6761,8520,1759,7944.921409,256.462017
4,2500,371,19917094.19,4416,8419,4003,7595.687332,427.2118904
5,2500,366,19648669.74,-1566,8055,9621,6366.439891,1503.008886
6,2500,367,19702354.63,3702,8664,4962,7990.138965,681.9459293
7,2500,367,19702354.63,4394,9571,5177,7711.310627,644.6211117
8,2500,368,19756039.52,2239,8325,6086,6436.244565,1487.29944
9,2500,368,19756039.52,5982,8590,2608,7915.570652,431.9655537
10,2500,366,19648669.74,1073,8859,7786,6425.606557,1699.3395
11,2500,372,19970779.08,1503,8628,7125,6480.104839,1825.61588
12,2500,376,20185518.64,1336,9055,7719,5953.952128,1890.810493
13,2500,373,20024463.97,3128,8907,5779,7511.994638,935.3068227
14,2500,368,19756039.52,6238,8581,2343,8010.720109,412.5808293
16,2500,371,19917094.19,542,9547,9005,4069.25876,2425.583543
17,2500,371,19917094.19,5774,8503,2729,7395.981132,541.1309283
18,2500,366,19648669.74,1132,9950,8818,4551.196721,2890.073084
19,2500,366,19648669.74,1172,8810,7638,4886.423497,2325.680434
20,2500,370,19863409.3,6689,8622,1933,8072.140541,291.3735723
21,2500,369,19809724.41,6445,8675,2230,7898.319783,352.4204662
22,2500,367,19702354.63,-1781,9500,11281,4829.098093,2872.837122
23,2500,369,19809724.41,418,8941,8523,4916.252033,2640.875094
24,2500,372,19970779.08,5605,8719,3114,8032.438172,498.0071889
25,2500,367,19702354.63,4988,8554,3566,7520.002725,529.2777584
26,2500,367,19702354.63,7216,8658,1442,7991.016349,299.6132562
27,2500,366,19648669.74,6681,8533,1852,8000.150273,341.6653715
28,2500,366,19648669.74,5761,8522,2761,7820.374317,511.801062
29,2500,372,19970779.08,6311,8718,2407,7841.932796,453.2429246
31,2500,367,19702354.63,5576,8523,2947,7890.256131,652.367706
32,2500,367,19702354.63,4628,8394,3766,7406.792916,638.4326394
33,2500,372,19970779.08,5522,8218,2696,7009.263441,403.8323011
34,2500,367,19702354.63,5169,8454,3285,7144.035422,564.1286801
10A,2500,372,19970779.08,1879,9882,8003,7091.212366,1638.47613
10NE,2500,371,19917094.19,1278,9270,7992,7002.743935,1452.51358
10NW,2500,366,19648669.74,2194,8316,6122,6956.672131,1096.613858
10SW,2500,373,20024463.97,713,8859,8146,5056.190349,2266.247093
11NE,2500,366,19648669.74,1850,8607,6757,7086.18306,1525.744715
11NW,2500,370,19863409.3,264,8616,8352,6888.048649,1848.783067
11SE,2500,366,19648669.74,1916,8632,6716,6785.644809,1486.309091
17NW,2500,367,19702354.63,4034,9271,5237,7236.354223,756.3823297
17SE,2500,367,19702354.63,2062,8477,6415,6792.547684,1377.471252
17SW,2500,372,19970779.08,1395,9693,8298,6268.150538,2051.799249
22S,2500,366,19648669.74,-1781,9500,11281,4710.540984,2925.529591
23S,2500,376,20185518.64,1386,7582,6196,3334.417553,1522.131297
24S,2500,367,19702354.63,5605,8719,3114,8030.632153,508.7084821
27A,2500,372,19970779.08,1572,9135,7563,6427.965054,2157.320728
2A,2500,370,19863409.3,2318,9292,6974,6539.635135,1660.22215
5NE,2500,368,19756039.52,2131,9550,7419,6530.690217,1543.226832
5NW,2500,364,19541299.96,1111,9736,8625,5835.733516,1848.96353
5SE,2500,372,19970779.08,702,9804,9102,4037.365591,2404.957198
6NE,2500,367,19702354.63,1796,8598,6802,7221.877384,1516.620709
6NW,2500,366,19648669.74,1835,9147,7312,7086.885246,1851.078765
6SW,2500,366,19648669.74,1604,8994,7390,7135.221311,1761.161354
Cell 1 2011/12,2500,368,19756039.52,4379,8504,4125,7734.13587,509.3119752
Cell 1 SW 2013,2500,372,19970779.08,-1428,7718,9146,5798.231183,1740.55646
Cell 10 2011/12,2500,366,19648669.74,1073,8859,7786,6425.606557,1699.3395
Cell 10 NE 2011/12,2500,371,19917094.19,1278,9270,7992,7002.743935,1452.51358
Cell 10 NW 2011/12,2500,366,19648669.74,2194,8316,6122,6956.672131,1096.613858
Cell 10 SE 2013,2500,366,19648669.74,1835,9147,7312,7086.885246,1851.078765
Cell 10 SW 2011/12,2500,373,20024463.97,713,8859,8146,5056.190349,2266.247093
Cell 10-A 2011/12,2500,372,19970779.08,1879,9882,8003,7091.212366,1638.47613
Cell 11 NE 2011/12,2500,366,19648669.74,1850,8607,6757,7086.18306,1525.744715
Cell 11 NW 2013,2500,371,19917094.19,2362,8812,6450,6654.587601,1489.535091
Cell 11 SW 2013,2500,370,19863409.3,6044,8842,2798,8041.3,613.1229313
Cell 12 2013,2500,367,19702354.63,4394,9571,5177,7711.310627,644.6211117
Cell 13 2013,2500,371,19917094.19,2239,8325,6086,6270.778976,1575.150718
Cell 14 2013,2500,370,19863409.3,7289,8733,1444,7985.383784,318.4554171
Cell 15 2013,2500,368,19756039.52,6876,8561,1685,7983.75,329.8295055
Cell 15-A 2013,2500,366,19648669.74,6876,8739,1863,7889.04918,364.8758046
Cell 16 2013,2500,365,19594984.85,6740,8963,2223,7921.816438,380.6636336
Cell 17 NW 2011/12,2500,367,19702354.63,4034,9271,5237,7236.354223,756.3823297
Cell 17 NW 2013,2500,366,19648669.74,-1836,9736,11572,6204.674863,1780.793042
Cell 17 SE 2013,2500,366,19648669.74,2194,8316,6122,6956.672131,1096.613858
Cell 17 SW 2013,2500,371,19917094.19,-1566,8161,9727,6387.183288,1485.606661
Cell 18 2011/12,2500,366,19648669.74,1132,9950,8818,4551.196721,2890.073084
Cell 18 NE 2013,2500,371,19917094.19,1604,8994,7390,7020.03504,1839.626102
Cell 18 NW 2013,2500,366,19648669.74,702,9804,9102,3880.191257,2375.75105
Cell 18 SE 2013,2500,366,19648669.74,1850,8607,6757,7086.18306,1525.744715
Cell 18 SSE 2013,2500,367,19702354.63,821,8628,7807,6924.220708,1722.1807
Cell 19 NW 2013,2500,367,19702354.63,6117,9287,3170,8120.817439,510.2559351
Cell 2 2011/12,2500,364,19541299.96,1796,8812,7016,6552.510989,1284.887286
Cell 2 NE 2013,2500,366,19648669.74,-1851,9266,11117,6763.377049,1876.930563
Cell 2 SW 2013,2500,367,19702354.63,4379,8504,4125,7733.604905,509.9036659
Cell 20 2013,2500,372,19970779.08,5970,9487,3517,7778.91129,430.7906524
Cell 21 2013,2500,371,19917094.19,2206,8914,6708,7145.768194,1335.272176
Cell 22 2013,2500,366,19648669.74,6712,8590,1878,7975.92623,414.9630868
Cell 23 2013,2500,367,19702354.63,7298,8920,1622,8451.967302,260.2867713
Cell 24 2013,2500,367,19702354.63,6891,8963,2072,7983.93188,335.4095276
Cell 25 NE 2013,2500,368,19756039.52,1073,8859,7786,6421.945652,1699.055693
Cell 25 SE 2013,2500,373,20024463.97,713,8859,8146,5056.190349,2266.247093
Cell 26 NE 2013,2500,372,19970779.08,1503,8628,7125,6480.104839,1825.61588
Cell 26 NNW 2013,2500,370,19863409.3,1278,9270,7992,6999.916216,1453.454965
Cell 26 NW 2013,2500,372,19970779.08,1879,9882,8003,7091.212366,1638.47613
Cell 27 NW 2013,2500,366,19648669.74,1916,8632,6716,6785.644809,1486.309091
Cell 28 2013,2500,376,20185518.64,1336,9055,7719,5953.952128,1890.810493
Cell 29 2013,2500,372,19970779.08,3128,8907,5779,7510.475806,936.2151623
Cell 3 NE 2013,2500,368,19756039.52,-1958,9038,10996,7203.195652,1907.993968
Cell 3 NW 2013,2500,368,19756039.52,3063,9266,6203,7294.203804,1041.75113
Cell 30 2013,2500,367,19702354.63,6794,8777,1983,8038.553134,327.0704359
Cell 31 2013,2500,372,19970779.08,6238,8584,2346,8013.346774,413.6117416
Cell 32 2013,2500,366,19648669.74,5623,8875,3252,7795.087432,552.9188549
Cell 33 NE 2013,2500,367,19702354.63,4034,9271,5237,7236.354223,756.3823297
Cell 33 SE 2013,2500,372,19970779.08,1395,9693,8298,6268.150538,2051.799249
Cell 33 SW 2013,2500,371,19917094.19,542,9547,9005,3851.795148,2388.182434
Cell 34 N 2013,2500,371,19917094.19,2088,8553,6465,7042.016173,1209.440716
Cell 34 NW 2013,2500,370,19863409.3,5774,8503,2729,7395.913514,541.8601276
Cell 34 SE 2013,2500,368,19756039.52,2062,8477,6415,6789.059783,1372.836702
Cell 35 2013,2500,367,19702354.63,1132,9950,8818,5154.585831,2908.483876
Cell 37 2013,2500,367,19702354.63,6689,8622,1933,8082.384196,277.4215692
Cell 38 2013,2500,372,19970779.08,6445,8675,2230,7903.319892,349.2763754
Cell 39 2013,2500,371,19917094.19,6681,9036,2355,8402.504043,367.8340946
Cell 4 2013,2500,367,19702354.63,7024,8386,1362,7810.667575,245.2766744
Cell 40 NE 2013,2500,367,19702354.63,-834,9597,10431,5348.307902,2714.106266
Cell 41 N 2013,2500,371,19917094.19,720,9972,9252,7394.757412,1752.870264
Cell 41 NW 2013,2500,368,19756039.52,-1781,9972,11753,6633.777174,2761.968539
Cell 42 NW 2013,2500,372,19970779.08,418,8941,8523,4769.314516,2690.542321
Cell 43 2013,2500,373,20024463.97,1384,8783,7399,7071.737265,1524.28188
Cell 44 2013,2500,372,19970779.08,5854,8660,2806,7960.97043,396.6240422
Cell 45 2013,2500,365,19594984.85,7216,8658,1442,7990.49589,300.0611045
Cell 47 2013,2500,371,19917094.19,2853,8698,5845,7541.385445,805.3992027
Cell 48 2013,2500,368,19756039.52,5605,8719,3114,8030.103261,507.3354094
Cell 49 2013,2500,367,19702354.63,4988,8554,3566,7520.002725,529.2777584
Cell 5 2011/12 Summer,2500,370,19863409.3,-1566,8161,9727,6382.389189,1484.744171
Cell 5 2013,2500,369,19809724.41,6707,8707,2000,7925.97019,333.1885241
Cell 50 2013,2500,372,19970779.08,6311,8718,2407,7841.932796,453.2429246
Cell 51 2013,2500,376,20185518.64,7187,8980,1793,8137.034574,372.9533246
Cell 52 2013,2500,371,19917094.19,7047,8535,1488,7927.026954,300.2629204
Cell 53 2013,2500,366,19648669.74,5761,8522,2761,7820.374317,511.801062
Cell 54 2013,2500,367,19702354.63,6277,8970,2693,8215.73297,480.1283656
Cell 55 2013,2500,368,19756039.52,6942,8903,1961,8296.769022,381.0391804
Cell 56 2013,2500,372,19970779.08,5522,8218,2696,7009.263441,403.8323011
Cell 57 2013,2500,365,19594984.85,4628,8394,3766,7405.852055,640.0428411
Cell 58 2013,2500,368,19756039.52,7586,8885,1299,8437.508152,228.4535914
Cell 59 2013,2500,365,19594984.85,6373,8233,1860,7280.00274,392.7121187
Cell 6 2011/12,2500,367,19702354.63,3702,8664,4962,7990.138965,681.9459293
Cell 6 2013,2500,367,19702354.63,5788,8726,2938,8055.904632,401.6387605
Cell 6 NE 2011/12,2500,367,19702354.63,1796,8598,6802,7221.877384,1516.620709
Cell 6 NW 2011/12,2500,366,19648669.74,1835,9147,7312,7086.885246,1851.078765
Cell 6 SW 2011/12,2500,366,19648669.74,1604,8994,7390,7135.221311,1761.161354
Cell 60 2013,2500,372,19970779.08,5169,8221,3052,7193.379032,535.158894
Cell 61 2013,2500,367,19702354.63,5774,8551,2777,7688.373297,559.5529012
Cell 7 2013,2500,373,20024463.97,6034,8640,2606,8031.742627,426.8967744
Cell 9 NW 2013,2500,365,19594984.85,1268,9285,8017,6147.90137,1784.875618
Cell 9 SE 2013,2500,369,19809724.41,2131,9550,7419,6528.840108,1541.542936
Cell 9 SW 2013,2500,363,19487615.07,1111,9736,8625,5832.082645,1850.197892
Cell R1,2500,369,19809724.41,1661,8197,6536,6442.685637,1562.193515
Cell R10,2500,366,19648669.74,7024,8386,1362,7811.300546,245.3120069
Cell R100,2500,372,19970779.08,6311,8718,2407,7841.932796,453.2429246
Cell R101,2500,367,19702354.63,6574,8722,2148,8028.961853,340.5105938
Cell R104,2500,367,19702354.63,7149,9360,2211,8054.618529,315.2447369
Cell R105,2500,366,19648669.74,5761,8522,2761,7820.374317,511.801062
Cell R106,2500,367,19702354.63,1784,8480,6696,7183.929155,1298.5205
Cell R107,2500,367,19702354.63,6277,8970,2693,8215.73297,480.1283656
Cell R11,2500,369,19809724.41,6707,8707,2000,7925.97019,333.1885241
Cell R111,2500,366,19648669.74,1562,8985,7423,7431.904372,1919.278238
Cell R112,2500,368,19756039.52,6819,8555,1736,8029.788043,285.9951042
Cell R113,2500,366,19648669.74,4628,8394,3766,7406.453552,639.2711627
Cell R114,2500,368,19756039.52,7586,8885,1299,8437.508152,228.4535914
Cell R117,2500,366,19648669.74,5522,8600,3078,7153.412568,553.7324784
Cell R118,2500,371,19917094.19,5522,8218,2696,7008.291105,403.9410787
Cell R119,2500,366,19648669.74,3672,8005,4333,6883.833333,805.2181777
Cell R120,2500,369,19809724.41,5097,8655,3558,7867.140921,685.8403163
Cell R121,2500,366,19648669.74,6617,8760,2143,8036.442623,367.2960729
Cell R123,2500,366,19648669.74,6600,8331,1731,7481.762295,374.0784243
Cell R124,2500,371,19917094.19,5658,8113,2455,7361.93531,462.3767453
Cell R125,2500,372,19970779.08,2179,8555,6376,6920.319892,1202.99203
Cell R126,2500,371,19917094.19,3582,8551,4969,7434.927224,822.4322141
Cell R15,2500,372,19970779.08,-1428,7718,9146,5798.231183,1740.55646
Cell R16,2500,368,19756039.52,1268,9285,8017,6153.480978,1779.431929
Cell R17,2500,369,19809724.41,2565,8746,6181,7176.98916,1206.413565
Cell R18,2500,376,20185518.64,2362,8812,6450,6620.68617,1518.628457
Cell R19,2500,367,19702354.63,5514,8969,3455,7863.40327,370.0832085
Cell R20,2500,370,19863409.3,5604,8399,2795,7661.362162,353.154998
Cell R21,2500,370,19863409.3,6867,8366,1499,7653.054054,275.32188
Cell R22,2500,370,19863409.3,7289,8733,1444,7985.383784,318.4554171
Cell R24,2500,365,19594984.85,-1836,9736,11572,6199.257534,1780.216553
Cell R25,2500,366,19648669.74,702,9804,9102,3880.191257,2375.75105
Cell R26,2500,366,19648669.74,1835,9147,7312,7108.336066,1791.572698
Cell R27,2500,367,19702354.63,6117,9287,3170,8120.817439,510.2559351
Cell R28,2500,366,19648669.74,1880,9571,7691,6659.439891,1905.279106
Cell R29,2500,372,19970779.08,5970,9487,3517,7778.91129,430.7906524
Cell R30,2500,366,19648669.74,5843,8415,2572,7572.161202,545.8667983
Cell R31,2500,372,19970779.08,4978,8653,3675,7719.83871,540.0431243
Cell R35,2500,370,19863409.3,-1566,8161,9727,6382.389189,1484.744171
Cell R36,2500,366,19648669.74,2194,8316,6122,6956.672131,1096.613858
Cell R37,2500,366,19648669.74,1850,8607,6757,7086.18306,1525.744715
Cell R38,2500,372,19970779.08,2299,9787,7488,7646.341398,1126.428736
Cell R39,2500,367,19702354.63,3552,8970,5418,7689.550409,649.7846695
Cell R40,2500,371,19917094.19,2206,8914,6708,7145.768194,1335.272176
Cell R46,2500,371,19917094.19,631,8665,8034,4652.722372,2314.48163
Cell R47,2500,372,19970779.08,1879,9882,8003,7091.212366,1638.47613
Cell R48,2500,372,19970779.08,1503,8628,7125,6480.104839,1825.61588
Cell R49,2500,366,19648669.74,1916,8632,6716,6785.644809,1486.309091
Cell R5,2500,366,19648669.74,-1428,8079,9507,5610.579235,1934.208074
Cell R50,2500,376,20185518.64,1336,9055,7719,5953.952128,1890.810493
Cell R51,2500,370,19863409.3,3157,8907,5750,7510.824324,916.6405638
Cell R52,2500,371,19917094.19,3451,8779,5328,7732.237197,636.1969027
Cell R53,2500,369,19809724.41,4412,8634,4222,7713.777778,575.3465876
Cell R54,2500,372,19970779.08,6238,8584,2346,8013.346774,413.6117416
Cell R58,2500,367,19702354.63,22,8907,8885,4791.081744,2368.010292
Cell R59,2500,367,19702354.63,4034,9271,5237,7236.354223,756.3823297
Cell R6,2500,366,19648669.74,4379,8504,4125,7735.882514,508.7320732
Cell R60,2500,370,19863409.3,5774,8503,2729,7395.913514,541.8601276
Cell R61,2500,367,19702354.63,1132,9950,8818,5154.585831,2908.483876
Cell R62,2500,371,19917094.19,1104,8810,7706,4739.301887,2330.176606
Cell R63,2500,369,19809724.41,1224,8715,7491,7303.761518,1265.875807
Cell R64,2500,368,19756039.52,4051,8585,4534,8000.88587,455.3225064
Cell R65,2500,367,19702354.63,6794,8777,1983,8038.553134,327.0704359
Cell R66,2500,373,20024463.97,7219,8921,1702,8494.922252,346.1619464
Cell R69,2500,371,19917094.19,542,9547,9005,3851.795148,2388.182434
Cell R7,2500,368,19756039.52,3063,9266,6203,7294.203804,1041.75113
Cell R70,2500,372,19970779.08,1395,9693,8298,6268.150538,2051.799249
Cell R71,2500,369,19809724.41,2062,8477,6415,6790.95664,1371.458043
Cell R72,2500,368,19756039.52,546,8012,7466,4183.877717,2056.616997
Cell R73,2500,372,19970779.08,1699,9015,7316,7374.435484,1389.880514
Cell R74,2500,367,19702354.63,1721,9400,7679,7356.882834,1229.944885
Cell R75,2500,367,19702354.63,6689,8622,1933,8082.384196,277.4215692
Cell R76,2500,373,20024463.97,7064,8929,1865,8419.257373,337.9429386
Cell R77,2500,373,20024463.97,6445,8675,2230,7902.27882,349.3853316
Cell R8,2500,366,19648669.74,-1958,9038,10996,7317.702186,1937.781108
Cell R80,2500,367,19702354.63,-834,9597,10431,5348.307902,2714.106266
Cell R81,2500,367,19702354.63,1127,9496,8369,7406.163488,1015.116858
Cell R82,2500,372,19970779.08,418,8941,8523,4769.314516,2690.542321
Cell R83,2500,372,19970779.08,853,9050,8197,6028.55914,2540.000019
Cell R84,2500,367,19702354.63,1292,8783,7491,4982.362398,2333.646605
Cell R85,2500,374,20078148.86,1384,8783,7399,7058.727273,1542.840498
Cell R86,2500,367,19702354.63,6656,8671,2015,7786.844687,335.309171
Cell R87,2500,365,19594984.85,7216,8658,1442,7990.49589,300.0611045
Cell R9,2500,367,19702354.63,-1067,9023,10090,7362.700272,1180.319251
Cell R90,2500,370,19863409.3,2853,8698,5845,7539.083784,805.267413
Cell R91,2500,368,19756039.52,5605,8719,3114,8030.103261,507.3354094
Cell R92,2500,372,19970779.08,1436,9904,8468,3799.005376,2441.512022
Cell R93,2500,367,19702354.63,4988,8554,3566,7520.002725,529.2777584
Cell R97,2500,372,19970779.08,1572,9135,7563,7030.016129,1771.233579
Cell R98,2500,366,19648669.74,6681,8533,1852,8000.150273,341.6653715
Cell R99,2500,371,19917094.19,7047,8535,1488,7927.026954,300.2629204
Cell S102,2500,368,19756039.52,6670,8869,2199,8180.407609,447.8718726
Cell S108,2500,368,19756039.52,6942,8903,1961,8296.769022,381.0391804
Cell S13,2500,371,19917094.19,6589,8877,2288,7969.307278,398.1863092
Cell S14,2500,373,20024463.97,6034,8640,2606,8031.742627,426.8967744
Cell S2,2500,367,19702354.63,5788,8726,2938,8055.904632,401.6387605
Cell S23,2500,366,19648669.74,6235,8741,2506,8219.434426,272.9737869
Cell S32,2500,372,19970779.08,5982,8740,2758,8042.080645,469.7583844
Cell S33,2500,366,19648669.74,6876,8739,1863,7890.330601,365.6609668
Cell S34,2500,367,19702354.63,6891,8963,2072,7983.93188,335.4095276
Cell S41,2500,371,19917094.19,6697,8652,1955,7889.247978,326.1690861
Cell S42,2500,367,19702354.63,7298,8920,1622,8451.967302,260.2867713
Cell S44,2500,372,19970779.08,6879,8977,2098,8012.760753,357.9976411
Cell S56,2500,371,19917094.19,6630,8938,2308,7767.584906,381.7709057
Cell S67,2500,367,19702354.63,5623,8875,3252,7795.653951,552.2714035
Cell S78,2500,371,19917094.19,6681,9036,2355,8402.504043,367.8340946
Cell S88,2500,366,19648669.74,6869,8828,1959,8234.060109,363.2299873
Cell S94,2500,366,19648669.74,7120,9085,1965,8283.601093,365.6366473
Cell S95,2500,376,20185518.64,7187,8980,1793,8137.034574,372.9533246
W287,2500,368,19756039.52,1279,8828,7549,4307.744565,1699.383921
W295,2500,367,19702354.63,2234,8458,6224,6795.079019,1323.448862
W338,2500,366,19648669.74,1331,9399,8068,6274.759563,1966.563067
W342,2500,367,19702354.63,1668,8283,6615,6002.449591,1856.808531
W345,2500,366,19648669.74,3500,8372,4872,7354.150273,503.7917341
W387,2500,367,19702354.63,1438,7851,6413,5500.945504,1937.807782
W393,2500,368,19756039.52,1863,8560,6697,7137.866848,853.306412
W440,2500,371,19917094.19,1467,7276,5809,5200.865229,1398.333819
W441,2500,366,19648669.74,4985,8095,3110,7392.125683,513.4918982
W445,2500,366,19648669.74,5262,7719,2457,6929.508197,493.4293663
W500,2500,368,19756039.52,1353,8546,7193,5831.788043,2285.591474
1,2750,446,23943460.94,4204,8527,4323,7669.069507,619.7501067
2,2750,444,23836091.16,1796,8812,7016,6553.182432,1330.688683
3,2750,446,23943460.94,6761,8520,1759,7936.278027,275.0435739
4,2750,449,24104515.61,4141,8419,4278,7577.053452,517.9834996
5,2750,449,24104515.61,-1836,8161,9997,6279.011136,1655.988664
6,2750,446,23943460.94,3702,8664,4962,7949.089686,763.088844
7,2750,444,23836091.16,2052,9571,7519,7626.81982,841.9106081
8,2750,447,23997145.83,2239,8325,6086,6477.067114,1481.701481
9,2750,448,24050830.72,5982,8693,2711,7946.78125,432.0052718
10,2750,446,23943460.94,835,8859,8024,6324.710762,1822.591347
11,2750,448,24050830.72,1503,8628,7125,6322.997768,1942.079256
12,2750,448,24050830.72,1336,9055,7719,5794.805804,1965.908973
13,2750,449,24104515.61,2527,8907,6380,7435.082405,1039.941955
14,2750,447,23997145.83,6238,8581,2343,8032.447427,397.0075721
16,2750,447,23997145.83,542,9547,9005,4092.346756,2374.953703
17,2750,448,24050830.72,5774,8503,2729,7402.265625,516.210132
18,2750,445,23889776.05,1040,9950,8910,4293.867416,2840.765998
19,2750,450,24158200.5,1104,8810,7706,4771.166667,2397.997121
20,2750,448,24050830.72,6689,8622,1933,8077.328125,307.7300633
21,2750,445,23889776.05,6445,8675,2230,7909.12809,375.8013152
22,2750,443,23782406.27,-1781,9500,11281,4787.751693,2849.698951
23,2750,437,23460296.93,418,9121,8703,4732.812357,2707.419733
24,2750,448,24050830.72,5135,8719,3584,7967.1875,558.7724953
25,2750,438,23513981.82,2124,8906,6782,7420.525114,863.591935
26,2750,447,23997145.83,7216,8732,1516,8017.744966,315.5585543
27,2750,448,24050830.72,6681,8616,1935,8018.299107,329.4886119
28,2750,447,23997145.83,5761,8531,2770,7826.689038,509.0825537
29,2750,448,24050830.72,5543,8718,3175,7789.46875,498.7853674
31,2750,446,23943460.94,5576,8730,3154,7879.426009,657.1212955
32,2750,446,23943460.94,2557,8502,5945,7281.706278,931.7654304
33,2750,448,24050830.72,5522,8344,2822,7056.071429,444.1747005
34,2750,444,23836091.16,5169,8482,3313,7205.727477,582.478987
10A,2750,446,23943460.94,1650,9882,8232,6962.38565,1696.138487
10NE,2750,447,23997145.83,1278,9270,7992,6880.966443,1610.048141
10NW,2750,447,23997145.83,2194,8496,6302,6915.753915,1131.456893
10SW,2750,445,23889776.05,631,9882,9251,5001.38427,2319.654185
11NE,2750,440,23621351.6,1850,8733,6883,7081.459091,1544.02344
11NW,2750,448,24050830.72,264,8783,8519,6670.828125,2090.256673
11SE,2750,446,23943460.94,1916,8632,6716,6646.132287,1584.743451
17NW,2750,447,23997145.83,2717,9271,6554,7182.959732,928.9154814
17SE,2750,447,23997145.83,2062,8477,6415,6748.449664,1417.910164
17SW,2750,448,24050830.72,1395,9693,8298,6084.314732,2108.280818
22S,2750,447,23997145.83,-1781,9500,11281,4624.09396,2924.558261
23S,2750,448,24050830.72,1386,8611,7225,3449.671875,1617.595446
24S,2750,446,23943460.94,5135,8719,3584,7966.443946,564.3737871
27A,2750,448,24050830.72,1521,9135,7614,6454.691964,2148.824552
2A,2750,447,23997145.83,2318,9292,6974,6489.114094,1691.06565
5NE,2750,446,23943460.94,1766,9550,7784,6252.849776,1712.112005
5NW,2750,444,23836091.16,1111,9736,8625,5784.511261,1953.250548
5SE,2750,446,23943460.94,702,9804,9102,3909.006726,2418.26951
6NE,2750,438,23513981.82,1796,8638,6842,7182.381279,1563.973871
6NW,2750,438,23513981.82,1835,9147,7312,6963.493151,1943.43355
6SW,2750,445,23889776.05,1604,8994,7390,7038.024719,1893.726237
Cell 1 2011/12,2750,446,23943460.94,4204,8527,4323,7669.069507,619.7501067
Cell 1 SW 2013,2750,448,24050830.72,-1428,7774,9202,5652.743304,1843.10658
Cell 10 2011/12,2750,446,23943460.94,835,8859,8024,6324.710762,1822.591347
Cell 10 NE 2011/12,2750,447,23997145.83,1278,9270,7992,6880.966443,1610.048141
Cell 10 NW 2011/12,2750,447,23997145.83,2194,8496,6302,6915.753915,1131.456893
Cell 10 SE 2013,2750,438,23513981.82,1835,9147,7312,6963.493151,1943.43355
Cell 10 SW 2011/12,2750,445,23889776.05,631,9882,9251,5001.38427,2319.654185
Cell 10-A 2011/12,2750,446,23943460.94,1650,9882,8232,6962.38565,1696.138487
Cell 11 NE 2011/12,2750,440,23621351.6,1850,8733,6883,7081.459091,1544.02344
Cell 11 NW 2013,2750,447,23997145.83,1796,8812,7016,6608.46085,1544.315651
Cell 11 SW 2013,2750,449,24104515.61,6044,9050,3006,8059.841871,592.7497317
Cell 12 2013,2750,447,23997145.83,2052,9571,7519,7605.733781,896.6098807
Cell 13 2013,2750,449,24104515.61,2239,8325,6086,6347.674833,1570.229958
Cell 14 2013,2750,448,24050830.72,7289,8733,1444,7983.162946,311.558894
Cell 15 2013,2750,446,23943460.94,6876,8574,1698,7985.76009,326.1527034
Cell 15-A 2013,2750,449,24104515.61,6876,8739,1863,7898.832962,355.8572462
Cell 16 2013,2750,446,23943460.94,6398,8963,2565,7924.64574,379.4926694
Cell 17 NW 2011/12,2750,447,23997145.83,2717,9271,6554,7182.959732,928.9154814
Cell 17 NW 2013,2750,440,23621351.6,-1836,9736,11572,6136.418182,1841.117715
Cell 17 SE 2013,2750,446,23943460.94,2194,8496,6302,6916.784753,1132.514943
Cell 17 SW 2013,2750,448,24050830.72,-1836,8161,9997,6281.167411,1639.095843
Cell 18 2011/12,2750,445,23889776.05,1040,9950,8910,4293.867416,2840.765998
Cell 18 NE 2013,2750,448,24050830.72,1604,9287,7683,6957.263393,1966.994945
Cell 18 NW 2013,2750,443,23782406.27,702,9804,9102,3786.060948,2372.502447
Cell 18 SE 2013,2750,440,23621351.6,1850,8733,6883,7081.459091,1544.02344
Cell 18 SSE 2013,2750,444,23836091.16,791,8628,7837,6633.493243,1977.747724
Cell 19 NW 2013,2750,445,23889776.05,6117,9287,3170,8112.539326,522.4450523
Cell 2 2011/12,2750,444,23836091.16,1796,8812,7016,6553.182432,1330.688683
Cell 2 NE 2013,2750,446,23943460.94,-1851,9266,11117,6606.874439,1886.413346
Cell 2 SW 2013,2750,445,23889776.05,4379,8527,4148,7676.85618,598.256904
Cell 20 2013,2750,448,24050830.72,5970,9548,3578,7777.477679,473.5781911
Cell 21 2013,2750,450,24158200.5,2206,8914,6708,7188.484444,1293.70504
Cell 22 2013,2750,445,23889776.05,5982,8660,2678,7951.833708,449.6282952
Cell 23 2013,2750,438,23513981.82,7298,8920,1622,8424.671233,279.0614761
Cell 24 2013,2750,445,23889776.05,6891,8963,2072,7983.355056,343.8459019
Cell 25 NE 2013,2750,444,23836091.16,1049,8859,7810,6348.468468,1791.849796
Cell 25 SE 2013,2750,445,23889776.05,631,9882,9251,5001.38427,2319.654185
Cell 26 NE 2013,2750,447,23997145.83,1503,8628,7125,6321.474273,1943.982962
Cell 26 NNW 2013,2750,447,23997145.83,1278,9270,7992,6880.966443,1610.048141
Cell 26 NW 2013,2750,446,23943460.94,1650,9882,8232,6962.38565,1696.138487
Cell 27 NW 2013,2750,445,23889776.05,1916,8632,6716,6644.766292,1586.260766
Cell 28 2013,2750,448,24050830.72,1336,9055,7719,5794.805804,1965.908973
Cell 29 2013,2750,450,24158200.5,2527,8907,6380,7435.862222,1038.917237
Cell 3 NE 2013,2750,448,24050830.72,-1958,9038,10996,7251.533482,1781.448916
Cell 3 NW 2013,2750,447,23997145.83,2425,9266,6841,7245.727069,1128.571022
Cell 30 2013,2750,445,23889776.05,6794,8967,2173,8060.530337,339.1647203
Cell 31 2013,2750,448,24050830.72,6238,8584,2346,8018.933036,403.6602841
Cell 32 2013,2750,446,23943460.94,5623,8875,3252,7791.423767,572.1935938
Cell 33 NE 2013,2750,447,23997145.83,2717,9271,6554,7182.959732,928.9154814
Cell 33 SE 2013,2750,447,23997145.83,1395,9693,8298,6079.158837,2107.814612
Cell 33 SW 2013,2750,450,24158200.5,542,9547,9005,3823.737778,2355.187147
Cell 34 N 2013,2750,450,24158200.5,2088,8553,6465,7063.491111,1229.331154
Cell 34 NW 2013,2750,448,24050830.72,5774,8503,2729,7402.265625,516.210132
Cell 34 SE 2013,2750,447,23997145.83,2062,8477,6415,6767.574944,1400.666787
Cell 35 2013,2750,437,23460296.93,1132,9950,8818,4990.485126,2939.63032
Cell 37 2013,2750,443,23782406.27,6689,8622,1933,8079.72009,300.1761608
Cell 38 2013,2750,448,24050830.72,6445,8675,2230,7913.618304,370.4815512
Cell 39 2013,2750,450,24158200.5,6681,9036,2355,8400.182222,351.9718962
Cell 4 2013,2750,445,23889776.05,6877,8408,1531,7802.101124,266.2866178
Cell 40 NE 2013,2750,438,23513981.82,-1781,9597,11378,5248.96347,2776.708006
Cell 41 N 2013,2750,447,23997145.83,658,9972,9314,7273.431767,1818.823846
Cell 41 NW 2013,2750,446,23943460.94,-1781,9972,11753,6634.7287,2683.127351
Cell 42 NW 2013,2750,448,24050830.72,418,9121,8703,4583.020089,2737.2405
Cell 43 2013,2750,447,23997145.83,1384,8783,7399,6959.257271,1601.18741
Cell 44 2013,2750,447,23997145.83,5854,8671,2817,7941.64877,416.5973325
Cell 45 2013,2750,446,23943460.94,7216,8732,1516,8016.834081,315.3245738
Cell 47 2013,2750,450,24158200.5,1510,8698,7188,7338.048889,1229.777713
Cell 48 2013,2750,445,23889776.05,5135,8719,3584,7970.748315,558.4156839
Cell 49 2013,2750,438,23513981.82,2124,8906,6782,7420.525114,863.591935
Cell 5 2011/12 Summer,2750,448,24050830.72,-1836,8161,9997,6281.167411,1639.095843
Cell 5 2013,2750,447,23997145.83,6707,8707,2000,7917.908277,342.8602654
Cell 50 2013,2750,448,24050830.72,5543,8718,3175,7789.46875,498.7853674
Cell 51 2013,2750,448,24050830.72,7187,8980,1793,8142.435268,379.5016884
Cell 52 2013,2750,448,24050830.72,7047,8535,1488,7935.372768,298.3182204
Cell 53 2013,2750,447,23997145.83,5761,8531,2770,7826.689038,509.0825537
Cell 54 2013,2750,446,23943460.94,5568,8970,3402,8203.242152,514.7583652
Cell 55 2013,2750,447,23997145.83,6809,8903,2094,8273.767338,411.1439811
Cell 56 2013,2750,448,24050830.72,5522,8344,2822,7050.578125,438.0326688
Cell 57 2013,2750,444,23836091.16,2557,8502,5945,7276.349099,932.39333
Cell 58 2013,2750,447,23997145.83,7483,8885,1402,8443.324385,222.4263695
Cell 59 2013,2750,445,23889776.05,6373,8233,1860,7296.314607,391.3270593
Cell 6 2011/12,2750,446,23943460.94,3702,8664,4962,7949.089686,763.088844
Cell 6 2013,2750,446,23943460.94,5788,8726,2938,8011.926009,405.2900046
Cell 6 NE 2011/12,2750,438,23513981.82,1796,8638,6842,7182.381279,1563.973871
Cell 6 NW 2011/12,2750,438,23513981.82,1835,9147,7312,6963.493151,1943.43355
Cell 6 SW 2011/12,2750,445,23889776.05,1604,8994,7390,7038.024719,1893.726237
Cell 60 2013,2750,448,24050830.72,5169,8221,3052,7246.640625,531.8519555
Cell 61 2013,2750,446,23943460.94,5588,8551,2963,7683.309417,587.4572426
Cell 7 2013,2750,446,23943460.94,6034,8640,2606,8030.502242,415.9195483
Cell 9 NW 2013,2750,444,23836091.16,-76,9285,9361,6031.45045,1895.577947
Cell 9 SE 2013,2750,446,23943460.94,1766,9550,7784,6252.849776,1712.112005
Cell 9 SW 2013,2750,445,23889776.05,1111,9736,8625,5777.361798,1956.862088
Cell R1,2750,437,23460296.93,1661,8197,6536,6305.832952,1683.695724
Cell R10,2750,446,23943460.94,6877,8408,1531,7802.625561,266.2178904
Cell R100,2750,448,24050830.72,5543,8718,3175,7789.46875,498.7853674
Cell R101,2750,446,23943460.94,6574,8722,2148,8015.591928,343.2465081
Cell R104,2750,447,23997145.83,4550,9360,4810,8028.219239,419.3224921
Cell R105,2750,447,23997145.83,5761,8531,2770,7826.689038,509.0825537
Cell R106,2750,445,23889776.05,1520,8518,6998,7107.41573,1421.949483
Cell R107,2750,446,23943460.94,5568,8970,3402,8203.242152,514.7583652
Cell R11,2750,447,23997145.83,6707,8707,2000,7917.908277,342.8602654
Cell R111,2750,447,23997145.83,1562,9009,7447,7331.0783,1986.38277
Cell R112,2750,447,23997145.83,6819,8555,1736,8035.767338,299.4307567
Cell R113,2750,444,23836091.16,2557,8502,5945,7276.349099,932.39333
Cell R114,2750,447,23997145.83,7483,8885,1402,8443.324385,222.4263695
Cell R117,2750,443,23782406.27,5522,8600,3078,7195.309255,582.4044669
Cell R118,2750,447,23997145.83,5522,8344,2822,7048.939597,437.1488143
Cell R119,2750,446,23943460.94,3280,8021,4741,6855.284753,849.9395083
Cell R120,2750,437,23460296.93,4681,8655,3974,7813.425629,738.2434698
Cell R121,2750,447,23997145.83,6617,8762,2145,8057.715884,361.5911485
Cell R123,2750,448,24050830.72,6600,8412,1812,7510.495536,380.2128692
Cell R124,2750,448,24050830.72,5658,8221,2563,7359.337054,471.9734361
Cell R125,2750,448,24050830.72,1894,8555,6661,6850.515625,1264.422098
Cell R126,2750,448,24050830.72,3582,8551,4969,7388.337054,885.3870851
Cell R15,2750,448,24050830.72,-1428,7774,9202,5652.743304,1843.10658
Cell R16,2750,444,23836091.16,-76,9285,9361,6042.592342,1876.821557
Cell R17,2750,448,24050830.72,2415,8962,6547,7217.129464,1249.966637
Cell R18,2750,448,24050830.72,1796,8812,7016,6598.669643,1550.314183
Cell R19,2750,443,23782406.27,3210,8969,5759,7818.557562,512.8743268
Cell R20,2750,447,23997145.83,4416,8399,3983,7627.637584,469.6031007
Cell R21,2750,449,24104515.61,6867,8692,1825,7656.746102,276.2688688
Cell R22,2750,448,24050830.72,7289,8733,1444,7983.162946,311.558894
Cell R24,2750,440,23621351.6,-1836,9736,11572,6136.418182,1841.117715
Cell R25,2750,443,23782406.27,702,9804,9102,3786.060948,2372.502447
Cell R26,2750,446,23943460.94,1835,9147,7312,6992.08296,1901.747683
Cell R27,2750,445,23889776.05,6117,9287,3170,8112.539326,522.4450523
Cell R28,2750,447,23997145.83,1868,9571,7703,6594.409396,1973.501595
Cell R29,2750,448,24050830.72,5970,9548,3578,7777.477679,473.5781911
Cell R30,2750,446,23943460.94,5299,8415,3116,7568.721973,555.5797673
Cell R31,2750,447,23997145.83,4978,8653,3675,7724.684564,534.5084227
Cell R35,2750,448,24050830.72,-1836,8161,9997,6281.167411,1639.095843
Cell R36,2750,446,23943460.94,2194,8496,6302,6916.067265,1132.705258
Cell R37,2750,441,23675036.49,1850,8733,6883,7071.029478,1557.711228
Cell R38,2750,446,23943460.94,2299,9787,7488,7485.17713,1315.923096
Cell R39,2750,445,23889776.05,2420,8970,6550,7545.164045,947.957114
Cell R40,2750,450,24158200.5,2206,8914,6708,7188.484444,1293.70504
Cell R46,2750,446,23943460.94,631,8665,8034,4720.26009,2322.387715
Cell R47,2750,446,23943460.94,1650,9882,8232,6962.38565,1696.138487
Cell R48,2750,446,23943460.94,1503,8628,7125,6325.340807,1944.443447
Cell R49,2750,445,23889776.05,1916,8632,6716,6644.766292,1586.260766
Cell R5,2750,439,23567666.71,-1428,8079,9507,5592.888383,1909.285685
Cell R50,2750,448,24050830.72,1336,9055,7719,5794.805804,1965.908973
Cell R51,2750,448,24050830.72,2527,8907,6380,7443.714286,1023.078322
Cell R52,2750,448,24050830.72,3451,8779,5328,7709.908482,702.7128669
Cell R53,2750,448,24050830.72,4412,8634,4222,7712.142857,562.415662
Cell R54,2750,448,24050830.72,6238,8584,2346,8018.933036,403.6602841
Cell R58,2750,447,23997145.83,-128,8907,9035,4547.997763,2357.593532
Cell R59,2750,447,23997145.83,2717,9271,6554,7182.959732,928.9154814
Cell R6,2750,445,23889776.05,4379,8527,4148,7676.85618,598.256904
Cell R60,2750,447,23997145.83,5774,8503,2729,7402.400447,516.7793469
Cell R61,2750,437,23460296.93,1132,9950,8818,4990.485126,2939.63032
Cell R62,2750,448,24050830.72,1104,8810,7706,4628.754464,2380.150751
Cell R63,2750,448,24050830.72,1205,8767,7562,7198.716518,1454.616206
Cell R64,2750,447,23997145.83,4051,8585,4534,7981.485459,471.6377047
Cell R65,2750,446,23943460.94,6794,8967,2173,8060.61435,338.7889129
Cell R66,2750,446,23943460.94,7030,8921,1891,8473.643498,357.6060234
Cell R69,2750,450,24158200.5,542,9547,9005,3823.737778,2355.187147
Cell R7,2750,447,23997145.83,2425,9266,6841,7245.727069,1128.571022
Cell R70,2750,447,23997145.83,1395,9693,8298,6079.158837,2107.814612
Cell R71,2750,447,23997145.83,2062,8477,6415,6767.574944,1400.666787
Cell R72,2750,448,24050830.72,418,9677,9259,4395.566964,2241.814779
Cell R73,2750,447,23997145.83,1277,9015,7738,7156.127517,1642.781181
Cell R74,2750,446,23943460.94,1387,9400,8013,7158.46861,1619.332513
Cell R75,2750,444,23836091.16,6689,8622,1933,8080.277027,300.0669855
Cell R76,2750,448,24050830.72,7064,8929,1865,8393.696429,346.621863
Cell R77,2750,447,23997145.83,6445,8675,2230,7912.060403,369.4270168
Cell R8,2750,448,24050830.72,-1958,9038,10996,7337.46875,1794.322461
Cell R80,2750,438,23513981.82,-1781,9597,11378,5248.96347,2776.708006
Cell R81,2750,447,23997145.83,1127,9496,8369,7282.297539,1215.47384
Cell R82,2750,447,23997145.83,418,9121,8703,4590.910515,2735.206632
Cell R83,2750,448,24050830.72,853,9050,8197,5906.053571,2658.864131
Cell R84,2750,446,23943460.94,1292,8783,7491,4985.201794,2350.781593
Cell R85,2750,447,23997145.83,1384,8783,7399,6959.257271,1601.18741
Cell R86,2750,447,23997145.83,6536,8671,2135,7764.483221,341.4184638
Cell R87,2750,446,23943460.94,7216,8732,1516,8016.834081,315.3245738
Cell R9,2750,437,23460296.93,-1067,9023,10090,7339.201373,1283.89007
Cell R90,2750,450,24158200.5,1510,8698,7188,7338.048889,1229.777713
Cell R91,2750,445,23889776.05,5135,8719,3584,7970.413483,558.7538099
Cell R92,2750,449,24104515.61,1436,9904,8468,3754.285078,2392.274974
Cell R93,2750,438,23513981.82,2124,8906,6782,7420.525114,863.591935
Cell R97,2750,448,24050830.72,1572,9135,7563,6852.495536,1938.3301
Cell R98,2750,447,23997145.83,6681,8616,1935,8019.100671,329.4203589
Cell R99,2750,448,24050830.72,7047,8535,1488,7935.372768,298.3182204
Cell S102,2750,447,23997145.83,6670,9074,2404,8187.53915,443.2997912
Cell S108,2750,447,23997145.83,6809,8903,2094,8273.767338,411.1439811
Cell S13,2750,449,24104515.61,6589,8877,2288,7977.982183,399.8204994
Cell S14,2750,446,23943460.94,6034,8640,2606,8030.502242,415.9195483
Cell S2,2750,446,23943460.94,5788,8726,2938,8011.926009,405.2900046
Cell S23,2750,449,24104515.61,6235,8741,2506,8168.400891,340.0774504
Cell S32,2750,449,24104515.61,5982,8740,2758,8052.193764,448.0487121
Cell S33,2750,449,24104515.61,6876,8739,1863,7898.832962,355.8572462
Cell S34,2750,446,23943460.94,6891,8963,2072,7983.360987,343.4602309
Cell S41,2750,449,24104515.61,6697,8680,1983,7906.418708,327.6552227
Cell S42,2750,438,23513981.82,7298,8920,1622,8424.671233,279.0614761
Cell S44,2750,447,23997145.83,6879,8977,2098,8004.599553,365.9798081
Cell S56,2750,447,23997145.83,6227,8938,2711,7754.196868,398.6349209
Cell S67,2750,447,23997145.83,5623,8875,3252,7792.930649,572.4384571
Cell S78,2750,450,24158200.5,6681,9036,2355,8400.182222,351.9718962
Cell S88,2750,446,23943460.94,6869,8863,1994,8245.098655,362.2335287
Cell S94,2750,447,23997145.83,7120,9085,1965,8288.375839,361.9157294
Cell S95,2750,448,24050830.72,7187,8980,1793,8142.435268,379.5016884
W287,2750,446,23943460.94,1233,8828,7595,4286.497758,1720.520804
W295,2750,446,23943460.94,2167,8458,6291,6762.183857,1357.837133
W338,2750,438,23513981.82,1172,9399,8227,5962.812785,2185.930241
W342,2750,437,23460296.93,1668,8482,6814,5943.139588,1903.194219
W345,2750,447,23997145.83,3500,8372,4872,7374.548098,502.2839262
W387,2750,444,23836091.16,1430,7851,6421,5424.617117,2037.000243
W393,2750,444,23836091.16,1788,8560,6772,6981.288288,1163.326363
W440,2750,445,23889776.05,1161,7276,6115,5065.593258,1518.415836
W441,2750,446,23943460.94,4554,8095,3541,7335.464126,594.570054
W445,2750,438,23513981.82,5262,7772,2510,6918.573059,507.0224099
W500,2750,447,23997145.83,1306,8546,7240,5747.572707,2296.251482
1,3000,531,28506676.59,4204,8527,4323,7622.293785,684.4898937
2,3000,531,28506676.59,1796,8812,7016,6539.951036,1385.888937
3,3000,530,28452991.7,6761,8883,2122,7932.945283,294.3669364
4,3000,530,28452991.7,4134,8447,4313,7573.556604,563.1519866
5,3000,528,28345621.92,-1836,8161,9997,6211.659091,1679.941178
6,3000,529,28399306.81,3445,8735,5290,7905.814745,829.422228
7,3000,530,28452991.7,2052,9571,7519,7554.888679,994.9555925
8,3000,531,28506676.59,2239,8325,6086,6531.333333,1484.560034
9,3000,531,28506676.59,5982,8693,2711,7960.472693,439.3000089
10,3000,528,28345621.92,835,8859,8024,6280.420455,1884.389274
11,3000,534,28667731.26,1469,8628,7159,6150.771536,2077.136268
12,3000,537,28828785.93,1336,9055,7719,5617.493482,2064.43938
13,3000,534,28667731.26,2206,8970,6764,7361.468165,1163.326735
14,3000,531,28506676.59,6238,8634,2396,8050.52354,385.6946004
16,3000,534,28667731.26,542,9547,9005,4199.893258,2379.754501
17,3000,530,28452991.7,5774,8503,2729,7402.137736,509.1572225
18,3000,531,28506676.59,1040,9950,8910,4172.845574,2774.203737
19,3000,528,28345621.92,1104,8810,7706,4694.897727,2431.71257
20,3000,531,28506676.59,5854,8622,2768,8076.621469,314.0853367
21,3000,531,28506676.59,6445,8675,2230,7927.854991,386.7900783
22,3000,531,28506676.59,-1781,9500,11281,4771.06403,2827.940284
23,3000,526,28238252.14,418,9121,8703,4545.197719,2763.707874
24,3000,533,28614046.37,5135,8847,3712,7940.080675,563.302057
25,3000,529,28399306.81,1783,9510,7727,7340.621928,1083.708764
26,3000,529,28399306.81,7085,8732,1647,8045.877127,326.7237232
27,3000,530,28452991.7,6681,8616,1935,8030.615094,323.6797843
28,3000,527,28291937.03,5761,8531,2770,7820.641366,507.8883194
29,3000,530,28452991.7,4957,8718,3761,7745.383019,547.387144
31,3000,529,28399306.81,5576,8730,3154,7874.911153,647.4289895
32,3000,530,28452991.7,1815,8502,6687,7124.041509,1225.776394
33,3000,534,28667731.26,5522,8344,2822,7087.863296,457.8161257
34,3000,532,28560361.48,5169,8482,3313,7260.791353,581.937414
10A,3000,534,28667731.26,1650,9882,8232,6781.848315,1804.123655
10NE,3000,530,28452991.7,629,9270,8641,6770.539623,1735.558953
10NW,3000,527,28291937.03,2194,8613,6419,6894.960152,1153.632978
10SW,3000,536,28775101.04,631,9882,9251,4987.473881,2313.286074
11NE,3000,531,28506676.59,1850,9787,7937,7043.615819,1595.906049
11NW,3000,531,28506676.59,190,8783,8593,6461.93032,2281.979081
11SE,3000,529,28399306.81,1556,8632,7076,6526.037807,1670.023901
17NW,3000,529,28399306.81,1669,9338,7669,7074.604915,1220.863809
17SE,3000,530,28452991.7,1284,8787,7503,6712.90566,1479.918589
17SW,3000,534,28667731.26,1098,9693,8595,5902.447566,2172.373204
22S,3000,526,28238252.14,-1781,9500,11281,4583.140684,2933.163911
23S,3000,537,28828785.93,1386,8611,7225,3559.560521,1727.176479
24S,3000,528,28345621.92,5135,8847,3712,7943.181818,566.2042117
27A,3000,533,28614046.37,1521,9135,7614,6493.634146,2155.550868
2A,3000,530,28452991.7,2318,9292,6974,6460.198113,1698.88494
5NE,3000,530,28452991.7,1415,9550,8135,5943.101887,1877.212297
5NW,3000,531,28506676.59,1063,9736,8673,5754.826742,2022.168501
5SE,3000,532,28560361.48,702,9804,9102,3809.62594,2412.856368
6NE,3000,529,28399306.81,1796,8675,6879,7133.733459,1609.809749
6NW,3000,528,28345621.92,1835,9147,7312,6846.825758,2019.742247
6SW,3000,529,28399306.81,1297,9171,7874,6972.640832,1974.161057
Cell 1 2011/12,3000,531,28506676.59,4204,8527,4323,7622.293785,684.4898937
Cell 1 SW 2013,3000,533,28614046.37,-1428,7777,9205,5530.744841,1911.733173
Cell 10 2011/12,3000,528,28345621.92,835,8859,8024,6280.420455,1884.389274
Cell 10 NE 2011/12,3000,530,28452991.7,629,9270,8641,6770.539623,1735.558953
Cell 10 NW 2011/12,3000,527,28291937.03,2194,8613,6419,6894.960152,1153.632978
Cell 10 SE 2013,3000,528,28345621.92,1835,9147,7312,6846.825758,2019.742247
Cell 10 SW 2011/12,3000,536,28775101.04,631,9882,9251,4987.473881,2313.286074
Cell 10-A 2011/12,3000,534,28667731.26,1650,9882,8232,6781.848315,1804.123655
Cell 11 NE 2011/12,3000,531,28506676.59,1850,9787,7937,7043.615819,1595.906049
Cell 11 NW 2013,3000,531,28506676.59,1796,8812,7016,6587.956685,1559.873534
Cell 11 SW 2013,3000,530,28452991.7,3651,9253,5602,8039.026415,635.1261346
Cell 12 2013,3000,529,28399306.81,2052,9571,7519,7554.151229,995.7158133
Cell 13 2013,3000,532,28560361.48,2239,8325,6086,6406.667293,1560.757341
Cell 14 2013,3000,532,28560361.48,7289,8733,1444,7979.451128,308.7648256
Cell 15 2013,3000,532,28560361.48,6876,8574,1698,7983.851504,321.1948828
Cell 15-A 2013,3000,530,28452991.7,6215,8739,2524,7902.873585,366.9175336
Cell 16 2013,3000,528,28345621.92,6398,8963,2565,7924.041667,385.0165853
Cell 17 NW 2011/12,3000,529,28399306.81,1669,9338,7669,7074.604915,1220.863809
Cell 17 NW 2013,3000,528,28345621.92,-1836,9736,11572,6079.795455,1834.882408
Cell 17 SE 2013,3000,527,28291937.03,2194,8613,6419,6894.960152,1153.632978
Cell 17 SW 2013,3000,534,28667731.26,-1836,8397,10233,6206.271536,1704.925576
Cell 18 2011/12,3000,531,28506676.59,1040,9950,8910,4172.845574,2774.203737
Cell 18 NE 2013,3000,531,28506676.59,1254,9287,8033,6881.105461,2090.260411
Cell 18 NW 2013,3000,531,28506676.59,702,9804,9102,3679.079096,2357.305104
Cell 18 SE 2013,3000,530,28452991.7,1850,9787,7937,7051.724528,1586.445004
Cell 18 SSE 2013,3000,530,28452991.7,264,8628,8364,6346.424528,2202.959471
Cell 19 NW 2013,3000,530,28452991.7,6089,9287,3198,8099.233962,544.2200321
Cell 2 2011/12,3000,531,28506676.59,1796,8812,7016,6539.951036,1385.888937
Cell 2 NE 2013,3000,524,28130882.36,-1851,9266,11117,6545.377863,1900.124282
Cell 2 SW 2013,3000,530,28452991.7,4204,8527,4323,7622.796226,685.0375007
Cell 20 2013,3000,531,28506676.59,2358,9548,7190,7744.600753,641.9625737
Cell 21 2013,3000,531,28506676.59,2206,8914,6708,7203.201507,1296.289581
Cell 22 2013,3000,528,28345621.92,5982,8660,2678,7932.909091,479.018112
Cell 23 2013,3000,530,28452991.7,6737,8920,2183,8399.20566,309.5909431
Cell 24 2013,3000,531,28506676.59,6891,8963,2072,7981.847458,340.6365279
Cell 25 NE 2013,3000,528,28345621.92,835,8859,8024,6280.420455,1884.389274
Cell 25 SE 2013,3000,535,28721416.15,631,9882,9251,4991.401869,2313.660494
Cell 26 NE 2013,3000,534,28667731.26,1469,8628,7159,6150.771536,2077.136268
Cell 26 NNW 2013,3000,530,28452991.7,629,9270,8641,6770.539623,1735.558953
Cell 26 NW 2013,3000,534,28667731.26,1650,9882,8232,6781.848315,1804.123655
Cell 27 NW 2013,3000,529,28399306.81,1556,8632,7076,6526.037807,1670.023901
Cell 28 2013,3000,537,28828785.93,1336,9055,7719,5617.493482,2064.43938
Cell 29 2013,3000,532,28560361.48,2206,8970,6764,7357.554511,1164.293585
Cell 3 NE 2013,3000,531,28506676.59,-1958,9038,10996,7257.854991,1693.424481
Cell 3 NW 2013,3000,530,28452991.7,2079,9266,7187,7201.522642,1231.380926
Cell 30 2013,3000,530,28452991.7,6794,8967,2173,8074.498113,340.672721
Cell 31 2013,3000,534,28667731.26,6238,8639,2401,8028.102996,390.6484701
Cell 32 2013,3000,527,28291937.03,5623,8875,3252,7777.051233,577.3482922
Cell 33 NE 2013,3000,529,28399306.81,1669,9338,7669,7074.604915,1220.863809
Cell 33 SE 2013,3000,534,28667731.26,1098,9693,8595,5902.447566,2172.373204
Cell 33 SW 2013,3000,529,28399306.81,542,9547,9005,3922.801512,2395.594752
Cell 34 N 2013,3000,530,28452991.7,2088,8852,6764,7085.413208,1213.319015
Cell 34 NW 2013,3000,530,28452991.7,5774,8503,2729,7402.137736,509.1572225
Cell 34 SE 2013,3000,531,28506676.59,1284,8787,7503,6713.655367,1478.625148
Cell 35 2013,3000,529,28399306.81,1132,9950,8818,4807.011342,2937.310564
Cell 37 2013,3000,530,28452991.7,6689,8622,1933,8083.137736,297.1065781
Cell 38 2013,3000,533,28614046.37,6445,8675,2230,7923.660413,383.8575543
Cell 39 2013,3000,531,28506676.59,6681,9036,2355,8390.755179,357.8504674
Cell 4 2013,3000,529,28399306.81,6877,8408,1531,7802.323251,276.7374457
Cell 40 NE 2013,3000,528,28345621.92,-1781,9597,11378,5198.395833,2797.559238
Cell 41 N 2013,3000,534,28667731.26,349,9972,9623,7176.044944,1870.913167
Cell 41 NW 2013,3000,531,28506676.59,-1781,9972,11753,6502.463277,2673.667202
Cell 42 NW 2013,3000,534,28667731.26,418,9121,8703,4490.674157,2773.094801
Cell 43 2013,3000,537,28828785.93,1292,8783,7491,6853.225326,1680.618354
Cell 44 2013,3000,534,28667731.26,5854,8671,2817,7905.981273,453.387462
Cell 45 2013,3000,528,28345621.92,7085,8732,1647,8045.710227,327.0104445
Cell 47 2013,3000,530,28452991.7,1320,8847,7527,7115.29434,1589.324806
Cell 48 2013,3000,529,28399306.81,5135,8847,3712,7942.510397,566.0807089
Cell 49 2013,3000,529,28399306.81,1783,9510,7727,7340.621928,1083.708764
Cell 5 2011/12 Summer,3000,534,28667731.26,-1836,8397,10233,6206.271536,1704.925576
Cell 5 2013,3000,529,28399306.81,6707,8707,2000,7919.812854,346.3935786
Cell 50 2013,3000,531,28506676.59,4957,8718,3761,7743.13936,549.3054058
Cell 51 2013,3000,538,28882470.82,7187,8980,1793,8148.453532,379.9873734
Cell 52 2013,3000,530,28452991.7,6441,8616,2175,7920.283019,326.8192841
Cell 53 2013,3000,527,28291937.03,5761,8531,2770,7820.641366,507.8883194
Cell 54 2013,3000,530,28452991.7,5568,8970,3402,8173.415094,544.510822
Cell 55 2013,3000,531,28506676.59,6477,8903,2426,8251.694915,439.4354934
Cell 56 2013,3000,534,28667731.26,5522,8344,2822,7086.035581,457.3965455
Cell 57 2013,3000,531,28506676.59,1815,8502,6687,7121.945386,1225.572041
Cell 58 2013,3000,531,28506676.59,7462,8885,1423,8443.043315,223.4876017
Cell 59 2013,3000,530,28452991.7,6373,8233,1860,7310.909434,390.2073364
Cell 6 2011/12,3000,529,28399306.81,3445,8735,5290,7905.814745,829.422228
Cell 6 2013,3000,529,28399306.81,5788,8726,2938,7986.379962,401.4870766
Cell 6 NE 2011/12,3000,529,28399306.81,1796,8675,6879,7133.733459,1609.809749
Cell 6 NW 2011/12,3000,528,28345621.92,1835,9147,7312,6846.825758,2019.742247
Cell 6 SW 2011/12,3000,529,28399306.81,1297,9171,7874,6972.640832,1974.161057
Cell 60 2013,3000,534,28667731.26,5169,8221,3052,7301.807116,519.386957
Cell 61 2013,3000,529,28399306.81,5439,8551,3112,7650.003781,634.3122587
Cell 7 2013,3000,536,28775101.04,6034,8640,2606,8011.304104,416.3627003
Cell 9 NW 2013,3000,529,28399306.81,-76,9285,9361,5876.100189,1993.043686
Cell 9 SE 2013,3000,530,28452991.7,1415,9550,8135,5943.101887,1877.212297
Cell 9 SW 2013,3000,530,28452991.7,1063,9736,8673,5754.101887,2024.006388
Cell R1,3000,521,27969827.69,1661,8197,6536,6211.28023,1773.717726
Cell R10,3000,528,28345621.92,6877,8408,1531,7802.049242,276.9276815
Cell R100,3000,531,28506676.59,4957,8718,3761,7743.13936,549.3054058
Cell R101,3000,530,28452991.7,6574,8748,2174,8010.637736,364.4806397
Cell R104,3000,526,28238252.14,2770,9360,6590,7958.954373,668.2190889
Cell R105,3000,527,28291937.03,5761,8531,2770,7820.641366,507.8883194
Cell R106,3000,530,28452991.7,1520,8518,6998,7062.90566,1496.725844
Cell R107,3000,530,28452991.7,5568,8970,3402,8173.415094,544.510822
Cell R11,3000,529,28399306.81,6707,8707,2000,7919.812854,346.3935786
Cell R111,3000,526,28238252.14,1562,9009,7447,7258.724335,2031.434623
Cell R112,3000,531,28506676.59,6656,8555,1899,8050.623352,309.9252284
Cell R113,3000,531,28506676.59,1815,8502,6687,7121.945386,1225.572041
Cell R114,3000,531,28506676.59,7462,8885,1423,8443.043315,223.4876017
Cell R117,3000,531,28506676.59,5473,8600,3127,7233.107345,597.2323312
Cell R118,3000,534,28667731.26,5522,8344,2822,7086.035581,457.3965455
Cell R119,3000,528,28345621.92,2905,8021,5116,6841.064394,901.9664584
Cell R120,3000,527,28291937.03,4681,8655,3974,7767.370019,746.8212902
Cell R121,3000,531,28506676.59,6617,8791,2174,8076.640301,357.776262
Cell R123,3000,526,28238252.14,6600,8448,1848,7532.56654,383.2241528
Cell R124,3000,531,28506676.59,5169,8221,3052,7356.679849,506.391342
Cell R125,3000,534,28667731.26,1894,8555,6661,6814.679775,1284.12912
Cell R126,3000,531,28506676.59,3582,8551,4969,7372.216573,912.7696703
Cell R15,3000,533,28614046.37,-1428,7777,9205,5530.744841,1911.733173
Cell R16,3000,530,28452991.7,-76,9285,9361,5869.703774,1987.765295
Cell R17,3000,531,28506676.59,1694,9057,7363,7235.772128,1326.724813
Cell R18,3000,540,28989840.6,1796,8812,7016,6572.744444,1569.438927
Cell R19,3000,531,28506676.59,2161,8969,6808,7760.574388,754.9643957
Cell R20,3000,532,28560361.48,4134,8433,4299,7610.849624,548.1999971
Cell R21,3000,530,28452991.7,6838,8692,1854,7659.518868,279.0542461
Cell R22,3000,532,28560361.48,7289,8733,1444,7979.451128,308.7648256
Cell R24,3000,528,28345621.92,-1836,9736,11572,6079.795455,1834.882408
Cell R25,3000,531,28506676.59,702,9804,9102,3679.079096,2357.305104
Cell R26,3000,524,28130882.36,1835,9147,7312,6880.288168,1960.076358
Cell R27,3000,530,28452991.7,6089,9287,3198,8099.233962,544.2200321
Cell R28,3000,527,28291937.03,1824,9571,7747,6523.929791,2038.833694
Cell R29,3000,531,28506676.59,2358,9548,7190,7744.600753,641.9625737
Cell R30,3000,527,28291937.03,5299,8475,3176,7571.99241,559.1814734
Cell R31,3000,534,28667731.26,4978,8653,3675,7724.522472,523.1634852
Cell R35,3000,532,28560361.48,-1836,8397,10233,6219.454887,1694.470159
Cell R36,3000,527,28291937.03,2194,8613,6419,6894.960152,1153.632978
Cell R37,3000,531,28506676.59,1850,9787,7937,7043.615819,1595.906049
Cell R38,3000,534,28667731.26,1828,9787,7959,7300.632959,1499.047325
Cell R39,3000,528,28345621.92,2420,8970,6550,7412.767045,1122.83363
Cell R40,3000,531,28506676.59,2206,8914,6708,7203.201507,1296.289581
Cell R46,3000,532,28560361.48,631,8665,8034,4714.016917,2368.160508
Cell R47,3000,534,28667731.26,1650,9882,8232,6781.848315,1804.123655
Cell R48,3000,534,28667731.26,1469,8628,7159,6150.771536,2077.136268
Cell R49,3000,529,28399306.81,1556,8632,7076,6526.037807,1670.023901
Cell R5,3000,529,28399306.81,-1428,8079,9507,5587.434783,1863.998665
Cell R50,3000,537,28828785.93,1336,9055,7719,5617.493482,2064.43938
Cell R51,3000,534,28667731.26,2206,8970,6764,7358.812734,1167.249791
Cell R52,3000,532,28560361.48,3327,8779,5452,7662.492481,801.549396
Cell R53,3000,530,28452991.7,4412,8634,4222,7718.971698,553.7663845
Cell R54,3000,534,28667731.26,6238,8639,2401,8028.102996,390.6484701
Cell R58,3000,529,28399306.81,-218,8907,9125,4416.342155,2374.223438
Cell R59,3000,529,28399306.81,1669,9338,7669,7074.604915,1220.863809
Cell R6,3000,530,28452991.7,4204,8527,4323,7622.796226,685.0375007
Cell R60,3000,530,28452991.7,5774,8503,2729,7402.137736,509.1572225
Cell R61,3000,529,28399306.81,1132,9950,8818,4807.011342,2937.310564
Cell R62,3000,531,28506676.59,1104,8810,7706,4553.146893,2424.70073
Cell R63,3000,530,28452991.7,1205,8912,7707,7102.967925,1549.964489
Cell R64,3000,531,28506676.59,4051,8585,4534,7973.73823,473.375077
Cell R65,3000,529,28399306.81,6794,8967,2173,8074.928166,340.8508071
Cell R66,3000,536,28775101.04,7030,8921,1891,8447.617537,377.3644083
Cell R69,3000,530,28452991.7,542,9547,9005,3928.630189,2397.085338
Cell R7,3000,530,28452991.7,2079,9266,7187,7201.522642,1231.380926
Cell R70,3000,534,28667731.26,1098,9693,8595,5902.447566,2172.373204
Cell R71,3000,531,28506676.59,1284,8787,7503,6713.655367,1478.625148
Cell R72,3000,531,28506676.59,418,9677,9259,4659.05838,2401.785458
Cell R73,3000,533,28614046.37,1277,9015,7738,6944.615385,1840.519916
Cell R74,3000,530,28452991.7,1387,9400,8013,7049.749057,1794.746668
Cell R75,3000,531,28506676.59,5854,8622,2768,8078.939736,312.1640222
Cell R76,3000,535,28721416.15,6858,8980,2122,8360.280374,367.6497367
Cell R77,3000,534,28667731.26,6445,8675,2230,7923.033708,383.7708073
Cell R8,3000,528,28345621.92,-1958,9038,10996,7368.861742,1685.204853
Cell R80,3000,528,28345621.92,-1781,9597,11378,5198.395833,2797.559238
Cell R81,3000,529,28399306.81,1127,9496,8369,7122.122873,1490.275484
Cell R82,3000,534,28667731.26,418,9121,8703,4490.674157,2773.094801
Cell R83,3000,532,28560361.48,853,9121,8268,5808.612782,2711.31476
Cell R84,3000,530,28452991.7,1292,8783,7491,4942.913208,2354.916233
Cell R85,3000,537,28828785.93,1292,8783,7491,6853.225326,1680.618354
Cell R86,3000,530,28452991.7,6391,8671,2280,7758.326415,361.6654624
Cell R87,3000,528,28345621.92,7085,8732,1647,8045.710227,327.0104445
Cell R9,3000,529,28399306.81,-1067,9023,10090,7291.568998,1381.311141
Cell R90,3000,531,28506676.59,1320,8847,7527,7105.913371,1602.447418
Cell R91,3000,529,28399306.81,5135,8847,3712,7942.510397,566.0807089
Cell R92,3000,532,28560361.48,1436,9904,8468,3780.37782,2364.620537
Cell R93,3000,529,28399306.81,1783,9510,7727,7340.621928,1083.708764
Cell R97,3000,534,28667731.26,1534,9135,7601,6782.312734,1969.708016
Cell R98,3000,529,28399306.81,6681,8616,1935,8031.185255,323.7195683
Cell R99,3000,530,28452991.7,6441,8616,2175,7920.283019,326.8192841
Cell S102,3000,532,28560361.48,6670,9074,2404,8204.93797,434.4153684
Cell S108,3000,531,28506676.59,6477,8903,2426,8251.694915,439.4354934
Cell S13,3000,531,28506676.59,6589,8877,2288,7986.821092,392.318772
Cell S14,3000,536,28775101.04,6034,8640,2606,8011.304104,416.3627003
Cell S2,3000,529,28399306.81,5788,8726,2938,7986.379962,401.4870766
Cell S23,3000,529,28399306.81,6235,8741,2506,8146.415879,346.1993932
Cell S32,3000,531,28506676.59,5982,8740,2758,8058.080979,442.9045238
Cell S33,3000,529,28399306.81,6215,8739,2524,7903.62949,366.8516525
Cell S34,3000,531,28506676.59,6891,8963,2072,7981.847458,340.6365279
Cell S41,3000,529,28399306.81,6697,8723,2026,7913.272212,330.4130451
Cell S42,3000,530,28452991.7,6737,8920,2183,8399.20566,309.5909431
Cell S44,3000,532,28560361.48,6758,8977,2219,7998.712406,374.3059467
Cell S56,3000,531,28506676.59,6104,8938,2834,7732.905838,415.3562882
Cell S67,3000,527,28291937.03,5623,8875,3252,7777.051233,577.3482922
Cell S78,3000,531,28506676.59,6681,9036,2355,8390.755179,357.8504674
Cell S88,3000,528,28345621.92,6869,8920,2051,8249.82197,366.8134157
Cell S94,3000,528,28345621.92,7120,9085,1965,8298.030303,355.9578348
Cell S95,3000,537,28828785.93,7187,8980,1793,8147.577281,379.7975817
W287,3000,532,28560361.48,1016,8828,7812,4295.426692,1756.994891
W295,3000,530,28452991.7,2167,8470,6303,6784.64717,1377.46419
W338,3000,528,28345621.92,1159,9399,8240,5705.505682,2304.25036
W342,3000,529,28399306.81,1612,8515,6903,5809.964083,1972.355076
W345,3000,527,28291937.03,3500,8372,4872,7403.104364,476.7348052
W387,3000,529,28399306.81,1121,7851,6730,5369.013233,2126.635623
W393,3000,530,28452991.7,1728,8560,6832,6871.033962,1298.689945
W440,3000,532,28560361.48,1161,7294,6133,4982.787594,1595.616234
W441,3000,528,28345621.92,4554,8095,3541,7286.878788,654.0620775
W445,3000,528,28345621.92,5262,7772,2510,6900.691288,538.9211035
W500,3000,530,28452991.7,1306,8546,7240,5690.620755,2284.427632
1,3250,621,33338316.69,4204,8542,4338,7582.531401,700.2197546
2,3250,619,33230946.91,1796,8812,7016,6549.602585,1400.251039
3,3250,626,33606741.14,5514,8883,3369,7919.399361,330.3225071
4,3250,625,33553056.25,4134,8447,4313,7554.7552,639.5731046
5,3250,625,33553056.25,-1836,8397,10233,6213.504,1668.945638
6,3250,624,33499371.36,3445,9287,5842,7847.892628,922.7454991
7,3250,620,33284631.8,2052,9571,7519,7488.974194,1089.575379
8,3250,625,33553056.25,2239,8415,6176,6583.8032,1484.507337
9,3250,626,33606741.14,5982,8693,2711,7983.322684,434.6790796
10,3250,624,33499371.36,713,9882,9169,6242.241987,1955.043039
11,3250,622,33392001.58,1176,8628,7452,5993.863344,2163.044086
12,3250,619,33230946.91,1336,9055,7719,5493.016155,2110.192867
13,3250,623,33445686.47,2206,8970,6764,7331.550562,1228.151144
14,3250,625,33553056.25,6238,8735,2497,8064.128,379.148823
16,3250,620,33284631.8,542,9547,9005,4259.245161,2419.756393
17,3250,625,33553056.25,5120,9268,4148,7404.192,528.3588432
18,3250,620,33284631.8,1040,9950,8910,4147.316129,2721.694213
19,3250,624,33499371.36,1104,8810,7706,4701.564103,2458.363071
20,3250,625,33553056.25,5854,8671,2817,8077.3904,311.2214099
21,3250,623,33445686.47,6445,8675,2230,7948.799358,386.9436438
22,3250,621,33338316.69,-1781,9500,11281,4785.177134,2816.294125
23,3250,622,33392001.58,418,9121,8703,4424.107717,2771.491545
24,3250,624,33499371.36,5094,8847,3753,7901.963141,591.9942071
25,3250,621,33338316.69,1612,9510,7898,7287.062802,1217.254912
26,3250,622,33392001.58,7085,8732,1647,8066.681672,333.8527916
27,3250,624,33499371.36,5313,8616,3303,8024.940705,339.857141
28,3250,625,33553056.25,5761,8567,2806,7805.92,515.8106971
29,3250,624,33499371.36,4957,8718,3761,7731.605769,573.5759834
31,3250,625,33553056.25,5576,8730,3154,7868.8624,635.6163575
32,3250,621,33338316.69,1681,8502,6821,6994.719807,1421.101951
33,3250,623,33445686.47,5522,8344,2822,7126.874799,472.0021156
34,3250,620,33284631.8,5169,8482,3313,7288.580645,573.1448319
10A,3250,622,33392001.58,1374,9882,8508,6601.988746,1918.31921
10NE,3250,625,33553056.25,629,9270,8641,6617.272,1871.783955
10NW,3250,625,33553056.25,1053,8869,7816,6814.5312,1250.32472
10SW,3250,621,33338316.69,631,9882,9251,4984.89694,2314.666609
11NE,3250,620,33284631.8,1850,9787,7937,7025.437097,1622.999553
11NW,3250,624,33499371.36,-92,8783,8875,6216.88141,2439.179346
11SE,3250,624,33499371.36,956,8632,7676,6416.145833,1823.405346
17NW,3250,621,33338316.69,1295,9338,8043,6938.557166,1473.508212
17SE,3250,622,33392001.58,1284,8787,7503,6655.414791,1546.68139
17SW,3250,622,33392001.58,1098,9693,8595,5872.117363,2194.651919
22S,3250,625,33553056.25,-1781,9561,11342,4547.8064,2923.49769
23S,3250,619,33230946.91,1386,8611,7225,3567.575121,1741.816095
24S,3250,624,33499371.36,5094,8847,3753,7898.282051,601.1243103
27A,3250,625,33553056.25,1521,9135,7614,6533.5088,2147.459743
2A,3250,625,33553056.25,1812,9292,7480,6428.8304,1717.95455
5NE,3250,622,33392001.58,1415,9550,8135,5673.207395,1996.942317
5NW,3250,618,33177262.02,1063,9736,8673,5724.967638,2054.15603
5SE,3250,624,33499371.36,702,9804,9102,3783.892628,2417.097546
6NE,3250,622,33392001.58,1796,8784,6988,7109.934084,1652.246714
6NW,3250,619,33230946.91,1522,9147,7625,6717.735057,2068.765098
6SW,3250,624,33499371.36,1242,9287,8045,6881.884615,2094.330702
Cell 1 2011/12,3250,621,33338316.69,4204,8542,4338,7582.531401,700.2197546
Cell 1 SW 2013,3250,623,33445686.47,-1428,7777,9205,5395.449438,1959.417391
Cell 10 2011/12,3250,624,33499371.36,713,9882,9169,6242.241987,1955.043039
Cell 10 NE 2011/12,3250,625,33553056.25,629,9270,8641,6617.272,1871.783955
Cell 10 NW 2011/12,3250,625,33553056.25,1053,8869,7816,6814.5312,1250.32472
Cell 10 SE 2013,3250,619,33230946.91,1522,9147,7625,6717.735057,2068.765098
Cell 10 SW 2011/12,3250,621,33338316.69,631,9882,9251,4984.89694,2314.666609
Cell 10-A 2011/12,3250,622,33392001.58,1374,9882,8508,6601.988746,1918.31921
Cell 11 NE 2011/12,3250,620,33284631.8,1850,9787,7937,7025.437097,1622.999553
Cell 11 NW 2013,3250,626,33606741.14,1796,8812,7016,6583.777955,1570.261344
Cell 11 SW 2013,3250,625,33553056.25,1988,9253,7265,7973.8816,740.5184748
Cell 12 2013,3250,623,33445686.47,2052,9571,7519,7488.152488,1086.248242
Cell 13 2013,3250,626,33606741.14,2165,8325,6160,6478.634185,1537.408297
Cell 14 2013,3250,626,33606741.14,7227,8733,1506,7976.634185,308.6280712
Cell 15 2013,3250,622,33392001.58,6876,8608,1732,7989.080386,319.4360082
Cell 15-A 2013,3250,627,33660426.03,6215,8739,2524,7918.094099,360.6420587
Cell 16 2013,3250,624,33499371.36,6398,8963,2565,7922.490385,387.7962266
Cell 17 NW 2011/12,3250,621,33338316.69,1295,9338,8043,6938.557166,1473.508212
Cell 17 NW 2013,3250,622,33392001.58,-1836,9736,11572,6066.884244,1795.528032
Cell 17 SE 2013,3250,625,33553056.25,1053,8869,7816,6814.5312,1250.32472
Cell 17 SW 2013,3250,622,33392001.58,-1836,8397,10233,6176.889068,1692.914329
Cell 18 2011/12,3250,620,33284631.8,1040,9950,8910,4147.316129,2721.694213
Cell 18 NE 2013,3250,623,33445686.47,1242,9287,8045,6820.950241,2162.624822
Cell 18 NW 2013,3250,620,33284631.8,674,9804,9130,3664.691935,2359.243604
Cell 18 SE 2013,3250,621,33338316.69,1850,9787,7937,7027.937198,1622.88666
Cell 18 SSE 2013,3250,620,33284631.8,264,8783,8519,6133.090323,2340.290375
Cell 19 NW 2013,3250,622,33392001.58,3702,9287,5585,8026.300643,663.75972
Cell 2 2011/12,3250,619,33230946.91,1796,8812,7016,6549.602585,1400.251039
Cell 2 NE 2013,3250,623,33445686.47,-1954,9266,11220,6528.00321,1911.891965
Cell 2 SW 2013,3250,620,33284631.8,4204,8542,4338,7582.348387,700.7693799
Cell 20 2013,3250,626,33606741.14,2003,9548,7545,7638.43131,959.9839968
Cell 21 2013,3250,625,33553056.25,2206,8914,6708,7228.9296,1302.442008
Cell 22 2013,3250,624,33499371.36,5930,8660,2730,7927.233974,478.4059734
Cell 23 2013,3250,620,33284631.8,6737,8920,2183,8379.641935,318.862268
Cell 24 2013,3250,620,33284631.8,6891,8963,2072,7991.941935,342.5309402
Cell 25 NE 2013,3250,624,33499371.36,713,9882,9169,6242.241987,1955.043039
Cell 25 SE 2013,3250,621,33338316.69,631,9882,9251,4984.89694,2314.666609
Cell 26 NE 2013,3250,622,33392001.58,1176,8628,7452,5993.863344,2163.044086
Cell 26 NNW 2013,3250,624,33499371.36,629,9270,8641,6619.294872,1872.60043
Cell 26 NW 2013,3250,622,33392001.58,1374,9882,8508,6601.988746,1918.31921
Cell 27 NW 2013,3250,624,33499371.36,956,8632,7676,6416.145833,1823.405346
Cell 28 2013,3250,619,33230946.91,1336,9055,7719,5493.016155,2110.192867
Cell 29 2013,3250,625,33553056.25,2206,8970,6764,7329.9264,1227.589865
Cell 3 NE 2013,3250,624,33499371.36,-1958,9038,10996,7260.185897,1615.937481
Cell 3 NW 2013,3250,620,33284631.8,-1851,9266,11117,7163.479032,1378.960749
Cell 30 2013,3250,619,33230946.91,6794,8967,2173,8094.276252,341.3880338
Cell 31 2013,3250,622,33392001.58,6238,8692,2454,8034.684887,384.3193805
Cell 32 2013,3250,625,33553056.25,5623,8875,3252,7770.8656,572.7578123
Cell 33 NE 2013,3250,621,33338316.69,1295,9338,8043,6938.557166,1473.508212
Cell 33 SE 2013,3250,622,33392001.58,1098,9693,8595,5872.117363,2194.651919
Cell 33 SW 2013,3250,625,33553056.25,262,9547,9285,4072.5072,2442.487448
Cell 34 N 2013,3250,625,33553056.25,2088,8852,6764,7074.5248,1220.587453
Cell 34 NW 2013,3250,625,33553056.25,5120,9268,4148,7404.192,528.3588432
Cell 34 SE 2013,3250,622,33392001.58,1284,8787,7503,6665.474277,1541.958126
Cell 35 2013,3250,620,33284631.8,1040,9950,8910,4755.25,2912.482986
Cell 37 2013,3250,624,33499371.36,5854,8671,2817,8078.283654,310.1473564
Cell 38 2013,3250,621,33338316.69,6445,8723,2278,7943.193237,388.2671499
Cell 39 2013,3250,627,33660426.03,6681,9036,2355,8370.452951,375.8999226
Cell 4 2013,3250,624,33499371.36,6698,8408,1710,7793.375,295.9913326
Cell 40 NE 2013,3250,621,33338316.69,-1781,9597,11378,5175.702093,2782.042505
Cell 41 N 2013,3250,621,33338316.69,349,9972,9623,7128.706924,1928.954791
Cell 41 NW 2013,3250,621,33338316.69,-1781,9972,11753,6317.89694,2690.395713
Cell 42 NW 2013,3250,620,33284631.8,418,9121,8703,4363.629032,2784.536321
Cell 43 2013,3250,620,33284631.8,1292,8783,7491,6765.404839,1771.672113
Cell 44 2013,3250,622,33392001.58,5854,8671,2817,7891.73955,470.9371477
Cell 45 2013,3250,624,33499371.36,7085,8732,1647,8068.338141,334.5951238
Cell 47 2013,3250,625,33553056.25,1125,8847,7722,6888.0928,1857.742393
Cell 48 2013,3250,623,33445686.47,5094,8847,3753,7896.754414,606.0011435
Cell 49 2013,3250,621,33338316.69,1612,9510,7898,7287.062802,1217.254912
Cell 5 2011/12 Summer,3250,623,33445686.47,-1836,8397,10233,6178.089888,1691.820196
Cell 5 2013,3250,624,33499371.36,6707,8707,2000,7928.189103,349.6980146
Cell 50 2013,3250,624,33499371.36,4957,8718,3761,7731.605769,573.5759834
Cell 51 2013,3250,620,33284631.8,6670,8980,2310,8160.209677,383.5039402
Cell 52 2013,3250,626,33606741.14,6441,8616,2175,7912.269968,332.7745338
Cell 53 2013,3250,624,33499371.36,5761,8567,2806,7805.379808,516.0471632
Cell 54 2013,3250,621,33338316.69,5568,8970,3402,8163.425121,549.7903623
Cell 55 2013,3250,626,33606741.14,6477,8903,2426,8224.86901,462.1582258
Cell 56 2013,3250,622,33392001.58,5522,8344,2822,7127.138264,472.0338326
Cell 57 2013,3250,621,33338316.69,1681,8502,6821,6992.115942,1420.548343
Cell 58 2013,3250,625,33553056.25,7462,8885,1423,8445.1424,224.0005297
Cell 59 2013,3250,620,33284631.8,6052,8233,2181,7320.530645,397.7256398
Cell 6 2011/12,3250,624,33499371.36,3445,9287,5842,7847.892628,922.7454991
Cell 6 2013,3250,626,33606741.14,5788,8726,2938,7983.078275,393.165813
Cell 6 NE 2011/12,3250,622,33392001.58,1796,8784,6988,7109.934084,1652.246714
Cell 6 NW 2011/12,3250,619,33230946.91,1522,9147,7625,6717.735057,2068.765098
Cell 6 SW 2011/12,3250,624,33499371.36,1242,9287,8045,6881.884615,2094.330702
Cell 60 2013,3250,619,33230946.91,5169,8482,3313,7332.240711,512.26476
Cell 61 2013,3250,626,33606741.14,4735,8551,3816,7638.148562,654.5029175
Cell 7 2013,3250,619,33230946.91,5654,8640,2986,7960.022617,457.5048323
Cell 9 NW 2013,3250,625,33553056.25,-76,9285,9361,5762.6592,2072.118723
Cell 9 SE 2013,3250,623,33445686.47,1415,9550,8135,5666.58427,2002.164382
Cell 9 SW 2013,3250,618,33177262.02,1063,9736,8673,5724.967638,2054.15603
Cell R1,3250,621,33338316.69,1372,8197,6825,6078.254428,1868.849344
Cell R10,3250,624,33499371.36,6698,8408,1710,7792.487179,296.1170774
Cell R100,3250,624,33499371.36,4957,8718,3761,7731.605769,573.5759834
Cell R101,3250,622,33392001.58,6311,8748,2437,8007.23955,383.4407296
Cell R104,3250,624,33499371.36,1869,9360,7491,7780.532051,1118.669035
Cell R105,3250,624,33499371.36,5761,8567,2806,7805.379808,516.0471632
Cell R106,3250,620,33284631.8,1520,8518,6998,7067.501613,1519.988815
Cell R107,3250,621,33338316.69,5568,8970,3402,8163.425121,549.7903623
Cell R11,3250,624,33499371.36,6707,8707,2000,7928.189103,349.6980146
Cell R111,3250,624,33499371.36,1562,9468,7906,7237.705128,2033.214199
Cell R112,3250,625,33553056.25,6656,8555,1899,8057.1792,314.303191
Cell R113,3250,621,33338316.69,1681,8502,6821,6992.115942,1420.548343
Cell R114,3250,625,33553056.25,7462,8885,1423,8445.1424,224.0005297
Cell R117,3250,620,33284631.8,5364,8678,3314,7233.422581,622.7612411
Cell R118,3250,622,33392001.58,5522,8344,2822,7127.138264,472.0338326
Cell R119,3250,624,33499371.36,2628,8210,5582,6803.033654,994.8169448
Cell R120,3250,621,33338316.69,4681,8655,3974,7733.713366,757.0910353
Cell R121,3250,624,33499371.36,6617,8791,2174,8090.913462,354.0357148
Cell R123,3250,625,33553056.25,6600,8448,1848,7548.2112,395.5059385
Cell R124,3250,626,33606741.14,5169,8311,3142,7366.001597,511.1307783
Cell R125,3250,622,33392001.58,1894,8555,6661,6788.290997,1288.4351
Cell R126,3250,624,33499371.36,3582,8551,4969,7382.607372,908.1191862
Cell R15,3250,622,33392001.58,-1428,7777,9205,5394.008039,1960.661797
Cell R16,3250,621,33338316.69,-76,9285,9361,5790.687601,2055.238144
Cell R17,3250,624,33499371.36,1694,9057,7363,7259.315705,1374.876643
Cell R18,3250,616,33069892.24,1796,8812,7016,6574.01461,1580.872781
Cell R19,3250,619,33230946.91,1825,8969,7144,7672.533118,999.1176415
Cell R20,3250,626,33606741.14,4134,8433,4299,7597.797125,604.2148725
Cell R21,3250,626,33606741.14,6061,8692,2631,7651.129393,307.0949539
Cell R22,3250,626,33606741.14,7227,8733,1506,7976.634185,308.6280712
Cell R24,3250,622,33392001.58,-1836,9736,11572,6066.884244,1795.528032
Cell R25,3250,619,33230946.91,674,9804,9130,3659.909532,2358.143782
Cell R26,3250,622,33392001.58,1522,9147,7625,6755.980707,2022.677224
Cell R27,3250,622,33392001.58,3702,9287,5585,8026.300643,663.75972
Cell R28,3250,625,33553056.25,1474,9571,8097,6506.0576,2055.854268
Cell R29,3250,626,33606741.14,2003,9548,7545,7638.43131,959.9839968
Cell R30,3250,624,33499371.36,4926,8515,3589,7581.089744,590.4214202
Cell R31,3250,623,33445686.47,4978,8653,3675,7738.491172,512.3185388
Cell R35,3250,623,33445686.47,-1836,8397,10233,6178.089888,1691.820196
Cell R36,3250,625,33553056.25,1053,8869,7816,6814.5312,1250.32472
Cell R37,3250,621,33338316.69,1850,9787,7937,7024.362319,1621.913065
Cell R38,3250,622,33392001.58,1527,9787,8260,7108.663987,1678.937089
Cell R39,3250,620,33284631.8,1810,8970,7160,7299.329032,1269.510418
Cell R40,3250,625,33553056.25,2206,8914,6708,7228.9296,1302.442008
Cell R46,3250,624,33499371.36,631,8665,8034,4806.682692,2375.708425
Cell R47,3250,622,33392001.58,1374,9882,8508,6601.988746,1918.31921
Cell R48,3250,622,33392001.58,1176,8628,7452,5993.863344,2163.044086
Cell R49,3250,624,33499371.36,956,8632,7676,6416.145833,1823.405346
Cell R5,3250,620,33284631.8,-1428,8079,9507,5582.904839,1831.786926
Cell R50,3250,619,33230946.91,1336,9055,7719,5493.016155,2110.192867
Cell R51,3250,623,33445686.47,2206,8970,6764,7335.170144,1215.185234
Cell R52,3250,624,33499371.36,2815,8779,5964,7621.676282,868.8239589
Cell R53,3250,624,33499371.36,4412,8634,4222,7745.407051,538.6655618
Cell R54,3250,622,33392001.58,6238,8692,2454,8034.684887,384.3193805
Cell R58,3250,623,33445686.47,-706,8907,9613,4330.858748,2365.260781
Cell R59,3250,621,33338316.69,1295,9338,8043,6938.557166,1473.508212
Cell R6,3250,620,33284631.8,4204,8542,4338,7582.348387,700.7693799
Cell R60,3250,624,33499371.36,5120,9268,4148,7405.365385,527.9677303
Cell R61,3250,620,33284631.8,1040,9950,8910,4755.25,2912.482986
Cell R62,3250,624,33499371.36,1104,8810,7706,4547.847756,2441.305917
Cell R63,3250,626,33606741.14,1205,8912,7707,6997.528754,1620.586221
Cell R64,3250,624,33499371.36,4051,8585,4534,7958.74359,469.9640074
Cell R65,3250,619,33230946.91,6794,8967,2173,8094.276252,341.3880338
Cell R66,3250,622,33392001.58,7010,8921,1911,8429.681672,392.8650697
Cell R69,3250,625,33553056.25,262,9547,9285,4072.5072,2442.487448
Cell R7,3250,620,33284631.8,-1851,9266,11117,7163.479032,1378.960749
Cell R70,3250,622,33392001.58,1098,9693,8595,5872.117363,2194.651919
Cell R71,3250,623,33445686.47,1284,8787,7503,6658.113965,1551.616828
Cell R72,3250,626,33606741.14,418,9677,9259,4822.984026,2500.329098
Cell R73,3250,622,33392001.58,1277,9127,7850,6686.897106,2051.725162
Cell R74,3250,622,33392001.58,1387,9400,8013,6958.184887,1932.482565
Cell R75,3250,622,33392001.58,5854,8671,2817,8077.263666,310.8394007
Cell R76,3250,622,33392001.58,6858,8980,2122,8330.384244,390.2092133
Cell R77,3250,621,33338316.69,6445,8723,2278,7943.193237,388.2671499
Cell R8,3250,624,33499371.36,-1958,9038,10996,7396.358974,1595.903718
Cell R80,3250,621,33338316.69,-1781,9597,11378,5175.702093,2782.042505
Cell R81,3250,621,33338316.69,1127,9496,8369,6997.838969,1693.890213
Cell R82,3250,620,33284631.8,418,9121,8703,4363.629032,2784.536321
Cell R83,3250,625,33553056.25,853,9121,8268,5718.7504,2723.646155
Cell R84,3250,621,33338316.69,1292,8783,7491,4973.383253,2351.734773
Cell R85,3250,620,33284631.8,1292,8783,7491,6765.404839,1771.672113
Cell R86,3250,622,33392001.58,6391,8671,2280,7761.167203,366.4788317
Cell R87,3250,624,33499371.36,7085,8732,1647,8068.338141,334.5951238
Cell R9,3250,620,33284631.8,-1067,9038,10105,7286.648387,1409.110139
Cell R90,3250,625,33553056.25,1125,8847,7722,6888.0928,1857.742393
Cell R91,3250,622,33392001.58,5094,8847,3753,7899.935691,601.2675884
Cell R92,3250,625,33553056.25,1436,9904,8468,3811.52,2340.535649
Cell R93,3250,621,33338316.69,1612,9510,7898,7287.062802,1217.254912
Cell R97,3250,621,33338316.69,1487,9135,7648,6727.985507,1990.935581
Cell R98,3250,624,33499371.36,5313,8616,3303,8024.940705,339.857141
Cell R99,3250,626,33606741.14,6441,8616,2175,7912.269968,332.7745338
Cell S102,3250,622,33392001.58,6670,9085,2415,8218.856913,433.4122932
Cell S108,3250,626,33606741.14,6477,8903,2426,8224.86901,462.1582258
Cell S13,3250,626,33606741.14,6589,8886,2297,7996.792332,389.3382093
Cell S14,3250,620,33284631.8,5654,8640,2986,7959.937097,457.1406795
Cell S2,3250,625,33553056.25,5788,8726,2938,7983.6352,393.2334163
Cell S23,3250,625,33553056.25,6235,8741,2506,8128.8832,344.5735555
Cell S32,3250,626,33606741.14,5845,8740,2895,8037.9377,462.4451277
Cell S33,3250,625,33553056.25,6215,8739,2524,7918.1408,360.9903658
Cell S34,3250,621,33338316.69,6891,8963,2072,7991.547504,342.3959246
Cell S41,3250,626,33606741.14,6638,8723,2085,7921.881789,332.3111567
Cell S42,3250,620,33284631.8,6737,8920,2183,8379.641935,318.862268
Cell S44,3250,624,33499371.36,6187,8977,2790,7991.461538,393.5109125
Cell S56,3250,623,33445686.47,6104,8938,2834,7729.081862,431.4017557
Cell S67,3250,625,33553056.25,5623,8875,3252,7770.8656,572.7578123
Cell S78,3250,625,33553056.25,6681,9036,2355,8369.9152,376.1283324
Cell S88,3250,626,33606741.14,6869,8920,2051,8256.899361,366.1404972
Cell S94,3250,626,33606741.14,7120,9085,1965,8306.63738,356.5314685
Cell S95,3250,619,33230946.91,6670,8980,2310,8161.061389,383.2272399
W287,3250,624,33499371.36,941,8828,7887,4283.870192,1817.260711
W295,3250,621,33338316.69,2167,8718,6551,6789,1416.364769
W338,3250,619,33230946.91,982,9399,8417,5458.515347,2413.814167
W342,3250,620,33284631.8,1612,8515,6903,5755.756452,1997.207363
W345,3250,624,33499371.36,3500,8372,4872,7416.628205,460.5988329
W387,3250,620,33284631.8,1121,7851,6730,5323.912903,2189.242003
W393,3250,621,33338316.69,1378,8560,7182,6728.68277,1473.755517
W440,3250,624,33499371.36,1161,7294,6133,4873.025641,1670.504659
W441,3250,624,33499371.36,4554,8095,3541,7263.038462,665.5740908
W445,3250,620,33284631.8,5262,7772,2510,6886.93871,553.1451476
W500,3250,624,33499371.36,1306,8546,7240,5740.189103,2232.816465
1,3500,719,38599435.91,4204,8598,4394,7567.670376,691.2777036
2,3500,721,38706805.69,1796,8812,7016,6537.692094,1441.579538
3,3500,718,38545751.02,5514,8883,3369,7913.246518,344.7847283
4,3500,720,38653120.8,2900,8447,5547,7543.030556,709.3201061
5,3500,722,38760490.58,-1836,8397,10233,6206.1759,1658.895551
6,3500,726,38975230.14,2354,9287,6933,7745.847107,1097.387987
7,3500,723,38814175.47,2052,9571,7519,7424.647303,1174.442818
8,3500,720,38653120.8,2165,8415,6250,6641.647222,1483.245976
9,3500,720,38653120.8,5982,8727,2745,8002.179167,429.4008356
10,3500,724,38867860.36,713,9882,9169,6247.763812,1976.179301
11,3500,726,38975230.14,1100,8628,7528,5887.015152,2197.821088
12,3500,726,38975230.14,1336,9150,7814,5320.071625,2151.353003
13,3500,722,38760490.58,2206,8970,6764,7320.969529,1248.766934
14,3500,719,38599435.91,6238,8757,2519,8071.023644,379.3618399
16,3500,724,38867860.36,262,9547,9285,4365.437845,2478.65828
17,3500,720,38653120.8,3292,9268,5976,7363.023611,650.4501973
18,3500,723,38814175.47,705,9950,9245,4224.968188,2708.458178
19,3500,718,38545751.02,1104,8810,7706,4687.871866,2459.848885
20,3500,720,38653120.8,5854,8671,2817,8080.166667,312.3642061
21,3500,725,38921545.25,6445,8777,2332,7976.777931,389.5771806
22,3500,724,38867860.36,-1781,9647,11428,4845.631215,2830.099592
23,3500,723,38814175.47,418,9121,8703,4397.341632,2766.506065
24,3500,722,38760490.58,2925,8847,5922,7836.409972,720.3355007
25,3500,725,38921545.25,1499,9510,8011,7259.342069,1299.412549
26,3500,724,38867860.36,7076,8732,1656,8084.073204,342.2834984
27,3500,722,38760490.58,5313,8616,3303,8014.722992,379.7545763
28,3500,722,38760490.58,5761,8567,2806,7795.965374,518.9924905
29,3500,721,38706805.69,4957,9230,4273,7747.130374,572.4726205
31,3500,726,38975230.14,5576,8730,3154,7872.909091,618.6422773
32,3500,722,38760490.58,1681,8502,6821,6925.98615,1488.880699
33,3500,723,38814175.47,5522,8344,2822,7166.894882,483.54317
34,3500,724,38867860.36,5169,8482,3313,7304.958564,572.0597547
10A,3500,723,38814175.47,1374,9882,8508,6416.448133,2029.081733
10NE,3500,720,38653120.8,629,9270,8641,6439.331944,2020.268188
10NW,3500,723,38814175.47,1053,8869,7816,6723.409405,1349.540056
10SW,3500,723,38814175.47,631,9882,9251,5044.477178,2305.162173
11NE,3500,726,38975230.14,1850,9787,7937,6996.717631,1648.488918
11NW,3500,718,38545751.02,-92,8783,8875,6078.224234,2491.094558
11SE,3500,724,38867860.36,956,8632,7676,6301.168508,1964.441218
17NW,3500,723,38814175.47,701,9338,8637,6776.467497,1734.36242
17SE,3500,719,38599435.91,1284,8787,7503,6601.820584,1610.206377
17SW,3500,725,38921545.25,-834,9693,10527,5810.474483,2264.274668
22S,3500,723,38814175.47,-1781,9597,11378,4579.222683,2900.943339
23S,3500,726,38975230.14,1386,8979,7593,3572.768595,1730.96513
24S,3500,723,38814175.47,2686,8847,6161,7819.742739,751.129466
27A,3500,722,38760490.58,1487,9135,7648,6586.470914,2137.704293
2A,3500,718,38545751.02,1796,9292,7496,6443.303621,1714.100913
5NE,3500,720,38653120.8,614,9550,8936,5439.352778,2114.955042
5NW,3500,721,38706805.69,1063,9736,8673,5693.809986,2080.687769
5SE,3500,723,38814175.47,674,9804,9130,3756.709544,2403.457278
6NE,3500,724,38867860.36,1796,8842,7046,7116.899171,1656.136659
6NW,3500,725,38921545.25,1277,9147,7870,6597.253793,2130.370059
6SW,3500,719,38599435.91,1242,9287,8045,6807.556328,2170.666689
Cell 1 2011/12,3500,719,38599435.91,4204,8598,4394,7567.670376,691.2777036
Cell 1 SW 2013,3500,722,38760490.58,-1428,7777,9205,5289.091413,1987.347115
Cell 10 2011/12,3500,724,38867860.36,713,9882,9169,6247.763812,1976.179301
Cell 10 NE 2011/12,3500,720,38653120.8,629,9270,8641,6439.331944,2020.268188
Cell 10 NW 2011/12,3500,723,38814175.47,1053,8869,7816,6723.409405,1349.540056
Cell 10 SE 2013,3500,725,38921545.25,1277,9147,7870,6597.253793,2130.370059
Cell 10 SW 2011/12,3500,723,38814175.47,631,9882,9251,5044.477178,2305.162173
Cell 10-A 2011/12,3500,723,38814175.47,1374,9882,8508,6416.448133,2029.081733
Cell 11 NE 2011/12,3500,726,38975230.14,1850,9787,7937,6996.717631,1648.488918
Cell 11 NW 2013,3500,717,38492066.13,1796,9292,7496,6569.156206,1586.601995
Cell 11 SW 2013,3500,719,38599435.91,1835,9253,7418,7882.257302,965.0897552
Cell 12 2013,3500,722,38760490.58,2052,9571,7519,7425.236842,1176.886303
Cell 13 2013,3500,719,38599435.91,2165,8415,6250,6541.591099,1531.684764
Cell 14 2013,3500,719,38599435.91,6867,8733,1866,7968.821975,316.7774525
Cell 15 2013,3500,721,38706805.69,6718,8691,1973,7987.364771,332.0025046
Cell 15-A 2013,3500,721,38706805.69,6215,8739,2524,7927.31484,363.4419743
Cell 16 2013,3500,725,38921545.25,6398,8963,2565,7927.275862,382.4083371
Cell 17 NW 2011/12,3500,723,38814175.47,701,9338,8637,6776.467497,1734.36242
Cell 17 NW 2013,3500,727,39028915.03,-1836,9736,11572,6055.462173,1784.125862
Cell 17 SE 2013,3500,723,38814175.47,1053,8869,7816,6723.409405,1349.540056
Cell 17 SW 2013,3500,723,38814175.47,-1836,8397,10233,6181.962656,1665.756665
Cell 18 2011/12,3500,723,38814175.47,705,9950,9245,4224.968188,2708.458178
Cell 18 NE 2013,3500,720,38653120.8,1242,9287,8045,6731.040278,2240.596761
Cell 18 NW 2013,3500,723,38814175.47,674,9804,9130,3654.517289,2343.94749
Cell 18 SE 2013,3500,725,38921545.25,1850,9787,7937,7003.121379,1640.576791
Cell 18 SSE 2013,3500,722,38760490.58,190,8783,8593,5974.396122,2410.885418
Cell 19 NW 2013,3500,720,38653120.8,3651,9287,5636,7954.975,783.6241141
Cell 2 2011/12,3500,721,38706805.69,1796,8812,7016,6537.692094,1441.579538
Cell 2 NE 2013,3500,723,38814175.47,-1954,9266,11220,6535.388658,1940.77136
Cell 2 SW 2013,3500,719,38599435.91,4204,8598,4394,7567.680111,691.3430182
Cell 20 2013,3500,717,38492066.13,2003,9548,7545,7517.481172,1164.130482
Cell 21 2013,3500,719,38599435.91,2206,8914,6708,7279.981919,1283.091612
Cell 22 2013,3500,724,38867860.36,5930,8742,2812,7921.651934,481.7596806
Cell 23 2013,3500,725,38921545.25,6737,8920,2183,8353.448276,341.9646751
Cell 24 2013,3500,724,38867860.36,6891,8963,2072,7996.44337,342.3238602
Cell 25 NE 2013,3500,726,38975230.14,713,9882,9169,6245.033058,1977.130991
Cell 25 SE 2013,3500,723,38814175.47,631,9882,9251,5044.477178,2305.162173
Cell 26 NE 2013,3500,726,38975230.14,1100,8628,7528,5887.015152,2197.821088
Cell 26 NNW 2013,3500,720,38653120.8,629,9270,8641,6439.331944,2020.268188
Cell 26 NW 2013,3500,723,38814175.47,1374,9882,8508,6416.448133,2029.081733
Cell 27 NW 2013,3500,724,38867860.36,956,8632,7676,6301.168508,1964.441218
Cell 28 2013,3500,727,39028915.03,1336,9150,7814,5316.62586,2151.876723
Cell 29 2013,3500,720,38653120.8,2206,8970,6764,7321.218056,1249.97071
Cell 3 NE 2013,3500,718,38545751.02,-1958,9038,10996,7267.299443,1555.793944
Cell 3 NW 2013,3500,719,38599435.91,-1851,9266,11117,7146.439499,1481.985701
Cell 30 2013,3500,724,38867860.36,6794,8967,2173,8102.448895,344.2122665
Cell 31 2013,3500,725,38921545.25,6238,8692,2454,8045.828966,379.7435447
Cell 32 2013,3500,723,38814175.47,5623,8875,3252,7783.493776,564.6029005
Cell 33 NE 2013,3500,723,38814175.47,701,9338,8637,6776.467497,1734.36242
Cell 33 SE 2013,3500,726,38975230.14,-834,9693,10527,5801.322314,2276.094344
Cell 33 SW 2013,3500,719,38599435.91,262,9547,9285,4201.869263,2520.573939
Cell 34 N 2013,3500,719,38599435.91,2088,8852,6764,7007.72879,1301.255559
Cell 34 NW 2013,3500,719,38599435.91,3292,9268,5976,7363.312935,650.8560711
Cell 34 SE 2013,3500,720,38653120.8,1284,8787,7503,6604.386111,1609.1235
Cell 35 2013,3500,723,38814175.47,1040,9950,8910,4726.316736,2856.412837
Cell 37 2013,3500,724,38867860.36,5854,8671,2817,8077.606354,310.2154411
Cell 38 2013,3500,724,38867860.36,6445,8777,2332,7968.993094,387.1136302
Cell 39 2013,3500,720,38653120.8,6681,9059,2378,8355.405556,394.1948855
Cell 4 2013,3500,722,38760490.58,6698,8408,1710,7788.443213,307.400179
Cell 40 NE 2013,3500,724,38867860.36,-1781,9597,11378,5122.031768,2794.131797
Cell 41 N 2013,3500,725,38921545.25,-1451,9972,11423,7050.805517,1958.674747
Cell 41 NW 2013,3500,720,38653120.8,-1781,9972,11753,6170.666667,2693.256873
Cell 42 NW 2013,3500,724,38867860.36,418,9298,8880,4345.973757,2789.191735
Cell 43 2013,3500,725,38921545.25,1292,8783,7491,6672.613793,1853.748071
Cell 44 2013,3500,724,38867860.36,5854,8671,2817,7879.34116,469.1749705
Cell 45 2013,3500,723,38814175.47,7076,8732,1656,8086.471646,341.8977348
Cell 47 2013,3500,719,38599435.91,1120,8847,7727,6727.570236,2000.377665
Cell 48 2013,3500,721,38706805.69,2686,8847,6161,7821.127601,751.8476993
Cell 49 2013,3500,725,38921545.25,1499,9510,8011,7259.342069,1299.412549
Cell 5 2011/12 Summer,3500,722,38760490.58,-1836,8397,10233,6181.836565,1666.906389
Cell 5 2013,3500,720,38653120.8,6707,8707,2000,7929.213889,353.1813059
Cell 50 2013,3500,721,38706805.69,4957,9230,4273,7747.130374,572.4726205
Cell 51 2013,3500,727,39028915.03,6670,8980,2310,8176.378267,380.2177993
Cell 52 2013,3500,720,38653120.8,2707,8616,5909,7867.994444,507.5092555
Cell 53 2013,3500,723,38814175.47,5761,8567,2806,7795.881051,518.6383995
Cell 54 2013,3500,721,38706805.69,5568,8970,3402,8152.17337,562.4533531
Cell 55 2013,3500,721,38706805.69,6477,8903,2426,8209.403606,472.0303822
Cell 56 2013,3500,725,38921545.25,5522,8344,2822,7167.244138,483.8829294
Cell 57 2013,3500,722,38760490.58,1681,8502,6821,6929.695291,1483.695965
Cell 58 2013,3500,719,38599435.91,7061,8885,1824,8433.513213,243.1372994
Cell 59 2013,3500,724,38867860.36,6045,8233,2188,7327.125691,411.2698358
Cell 6 2011/12,3500,726,38975230.14,2354,9287,6933,7745.847107,1097.387987
Cell 6 2013,3500,726,38975230.14,5788,8726,2938,7989.442149,383.1053108
Cell 6 NE 2011/12,3500,724,38867860.36,1796,8842,7046,7116.899171,1656.136659
Cell 6 NW 2011/12,3500,725,38921545.25,1277,9147,7870,6597.253793,2130.370059
Cell 6 SW 2011/12,3500,719,38599435.91,1242,9287,8045,6807.556328,2170.666689
Cell 60 2013,3500,724,38867860.36,5169,8482,3313,7351.440608,511.802079
Cell 61 2013,3500,726,38975230.14,3582,8598,5016,7629.07989,705.1525706
Cell 7 2013,3500,726,38975230.14,5036,8640,3604,7902.071625,509.6583259
Cell 9 NW 2013,3500,724,38867860.36,-76,9550,9626,5672.588398,2119.047932
Cell 9 SE 2013,3500,720,38653120.8,614,9550,8936,5439.352778,2114.955042
Cell 9 SW 2013,3500,721,38706805.69,1063,9736,8673,5691.540915,2080.890246
Cell R1,3500,723,38814175.47,1372,8197,6825,5994.872752,1921.12289
Cell R10,3500,722,38760490.58,6698,8408,1710,7788.443213,307.400179
Cell R100,3500,722,38760490.58,4957,9230,4273,7748.049861,572.6085597
Cell R101,3500,721,38706805.69,6311,8748,2437,8005.661581,406.708856
Cell R104,3500,723,38814175.47,1869,9360,7491,7623.427386,1407.242471
Cell R105,3500,723,38814175.47,5761,8567,2806,7795.881051,518.6383995
Cell R106,3500,724,38867860.36,1520,8518,6998,7092.259669,1542.086495
Cell R107,3500,723,38814175.47,5568,8970,3402,8148.146611,567.662113
Cell R11,3500,721,38706805.69,6707,8707,2000,7928.808599,353.1038038
Cell R111,3500,723,38814175.47,1562,9468,7906,7186.28769,2056.552166
Cell R112,3500,719,38599435.91,6656,8555,1899,8056.719054,317.6825535
Cell R113,3500,722,38760490.58,1681,8502,6821,6929.695291,1483.695965
Cell R114,3500,720,38653120.8,7061,8885,1824,8433.291667,243.0410081
Cell R117,3500,723,38814175.47,2056,9074,7018,7192.970954,758.9441621
Cell R118,3500,725,38921545.25,5522,8344,2822,7167.244138,483.8829294
Cell R119,3500,724,38867860.36,2104,8210,6106,6756.437845,1090.916943
Cell R120,3500,723,38814175.47,4487,8655,4168,7703.319502,778.7358813
Cell R121,3500,722,38760490.58,6617,8791,2174,8094.362881,352.0036257
Cell R123,3500,722,38760490.58,6373,9542,3169,7558.041551,430.1362001
Cell R124,3500,721,38706805.69,5169,8311,3142,7365.499307,509.0609209
Cell R125,3500,726,38975230.14,1894,8555,6661,6764.603306,1299.989186
Cell R126,3500,721,38706805.69,3582,8551,4969,7410.384189,886.1207597
Cell R15,3500,722,38760490.58,-1428,7777,9205,5289.091413,1987.347115
Cell R16,3500,727,39028915.03,-76,9550,9626,5667.45392,2121.589394
Cell R17,3500,720,38653120.8,1694,9057,7363,7237.980556,1424.806257
Cell R18,3500,724,38867860.36,1796,9292,7496,6558.440608,1594.276081
Cell R19,3500,724,38867860.36,1750,8969,7219,7572.470994,1213.489027
Cell R20,3500,717,38492066.13,4134,8437,4303,7591.962343,636.2348386
Cell R21,3500,718,38545751.02,5496,8692,3196,7640.82312,356.7048758
Cell R22,3500,719,38599435.91,6867,8733,1866,7968.821975,316.7774525
Cell R24,3500,727,39028915.03,-1836,9736,11572,6055.462173,1784.125862
Cell R25,3500,723,38814175.47,674,9804,9130,3654.517289,2343.94749
Cell R26,3500,722,38760490.58,1277,9147,7870,6653.556787,2083.818275
Cell R27,3500,721,38706805.69,3651,9287,5636,7955.475728,783.1957541
Cell R28,3500,722,38760490.58,1474,9571,8097,6450.685596,2094.912547
Cell R29,3500,717,38492066.13,2003,9548,7545,7517.481172,1164.130482
Cell R30,3500,723,38814175.47,4926,8516,3590,7572.764869,611.9536794
Cell R31,3500,722,38760490.58,4978,8692,3714,7767.98338,497.2051052
Cell R35,3500,722,38760490.58,-1836,8397,10233,6181.836565,1666.906389
Cell R36,3500,723,38814175.47,1053,8869,7816,6723.409405,1349.540056
Cell R37,3500,726,38975230.14,1850,9787,7937,6996.717631,1648.488918
Cell R38,3500,726,38975230.14,1481,9787,8306,6921.479339,1854.867869
Cell R39,3500,724,38867860.36,1810,8970,7160,7213.04558,1349.576267
Cell R40,3500,719,38599435.91,2206,8914,6708,7279.981919,1283.091612
Cell R46,3500,723,38814175.47,631,9704,9073,4909.753804,2383.169213
Cell R47,3500,723,38814175.47,1374,9882,8508,6416.448133,2029.081733
Cell R48,3500,726,38975230.14,1100,8628,7528,5887.015152,2197.821088
Cell R49,3500,724,38867860.36,956,8632,7676,6301.168508,1964.441218
Cell R5,3500,723,38814175.47,-1428,8079,9507,5601.828492,1808.351347
Cell R50,3500,725,38921545.25,1336,9150,7814,5318.695172,2152.516698
Cell R51,3500,723,38814175.47,2206,8970,6764,7324.369295,1245.683713
Cell R52,3500,720,38653120.8,2214,8779,6565,7569.936111,922.0740699
Cell R53,3500,721,38706805.69,4412,8779,4367,7757.28294,530.5586414
Cell R54,3500,725,38921545.25,6238,8692,2454,8045.828966,379.7435447
Cell R58,3500,719,38599435.91,-706,8907,9613,4293.27121,2391.368357
Cell R59,3500,722,38760490.58,701,9338,8637,6783.128809,1726.295887
Cell R6,3500,719,38599435.91,4204,8598,4394,7567.680111,691.3430182
Cell R60,3500,719,38599435.91,3292,9268,5976,7363.312935,650.8560711
Cell R61,3500,723,38814175.47,1040,9950,8910,4726.316736,2856.412837
Cell R62,3500,721,38706805.69,1104,8810,7706,4551.911234,2441.387908
Cell R63,3500,718,38545751.02,1205,8912,7707,6943.876045,1648.897303
Cell R64,3500,721,38706805.69,4051,8585,4534,7946.786408,470.8557546
Cell R65,3500,724,38867860.36,6794,8967,2173,8102.448895,344.2122665
Cell R66,3500,724,38867860.36,6337,8921,2584,8401.120166,427.5399476
Cell R69,3500,719,38599435.91,262,9547,9285,4201.869263,2520.573939
Cell R7,3500,719,38599435.91,-1851,9266,11117,7146.439499,1481.985701
Cell R70,3500,726,38975230.14,-834,9693,10527,5801.322314,2276.094344
Cell R71,3500,720,38653120.8,1284,8787,7503,6604.386111,1609.1235
Cell R72,3500,717,38492066.13,418,9677,9259,4979.672245,2519.800547
Cell R73,3500,722,38760490.58,1277,9950,8673,6471.836565,2196.909814
Cell R74,3500,720,38653120.8,1387,9400,8013,6912.093056,2003.847892
Cell R75,3500,723,38814175.47,5854,8671,2817,8077.644537,310.4282003
Cell R76,3500,724,38867860.36,6858,8980,2122,8303.005525,403.1728924
Cell R77,3500,724,38867860.36,6445,8777,2332,7968.993094,387.1136302
Cell R8,3500,723,38814175.47,-1958,9038,10996,7401.443983,1535.974103
Cell R80,3500,724,38867860.36,-1781,9597,11378,5122.031768,2794.131797
Cell R81,3500,723,38814175.47,989,9972,8983,6853.525588,1924.117405
Cell R82,3500,724,38867860.36,418,9298,8880,4345.973757,2789.191735
Cell R83,3500,721,38706805.69,853,9121,8268,5632.510402,2718.77677
Cell R84,3500,720,38653120.8,1292,8783,7491,4966.751389,2348.136702
Cell R85,3500,725,38921545.25,1292,8783,7491,6672.613793,1853.748071
Cell R86,3500,719,38599435.91,6391,8671,2280,7765,368.9511767
Cell R87,3500,725,38921545.25,7076,8732,1656,8085.493793,343.1719449
Cell R9,3500,723,38814175.47,-1067,9038,10105,7289.329184,1419.534092
Cell R90,3500,719,38599435.91,1120,8847,7727,6727.570236,2000.377665
Cell R91,3500,722,38760490.58,2686,8847,6161,7821.293629,751.340075
Cell R92,3500,721,38706805.69,1304,9904,8600,3842.445215,2330.578531
Cell R93,3500,725,38921545.25,1499,9510,8011,7259.342069,1299.412549
Cell R97,3500,723,38814175.47,1487,9135,7648,6718.69018,1984.631908
Cell R98,3500,722,38760490.58,5313,8616,3303,8016.357341,378.4891598
Cell R99,3500,720,38653120.8,2707,8616,5909,7867.994444,507.5092555
Cell S102,3500,719,38599435.91,6670,9085,2415,8221.618915,426.8156172
Cell S108,3500,721,38706805.69,6477,8903,2426,8209.403606,472.0303822
Cell S13,3500,718,38545751.02,6589,8945,2356,7999.091922,386.4652109
Cell S14,3500,726,38975230.14,5036,8640,3604,7902.071625,509.6583259
Cell S2,3500,726,38975230.14,5788,8726,2938,7989.442149,383.1053108
Cell S23,3500,721,38706805.69,6235,8741,2506,8109.883495,345.0271617
Cell S32,3500,718,38545751.02,5457,8742,3285,8010.143454,492.4598682
Cell S33,3500,721,38706805.69,6215,8739,2524,7927.31484,363.4419743
Cell S34,3500,724,38867860.36,6891,8963,2072,7996.44337,342.3238602
Cell S41,3500,719,38599435.91,6638,8727,2089,7916.065369,345.7899061
Cell S42,3500,726,38975230.14,6737,8920,2183,8352.88292,342.0679677
Cell S44,3500,723,38814175.47,6187,9061,2874,7978.48686,404.9660516
Cell S56,3500,721,38706805.69,6104,8938,2834,7728.092926,443.4470648
Cell S67,3500,723,38814175.47,5623,8875,3252,7783.493776,564.6029005
Cell S78,3500,720,38653120.8,6681,9059,2378,8355.405556,394.1948855
Cell S88,3500,723,38814175.47,6869,8920,2051,8259.608575,365.3704239
Cell S94,3500,724,38867860.36,7120,9085,1965,8307.288674,356.264402
Cell S95,3500,727,39028915.03,6670,8980,2310,8176.378267,380.2177993
W287,3500,722,38760490.58,941,8828,7887,4249.396122,1838.340557
W295,3500,720,38653120.8,2167,8718,6551,6816.405556,1440.434777
W338,3500,725,38921545.25,982,9399,8417,5207.173793,2491.652984
W342,3500,725,38921545.25,1568,8515,6947,5713.22069,2024.523413
W345,3500,722,38760490.58,3500,8372,4872,7434.299169,442.9065567
W387,3500,721,38706805.69,1121,9175,8054,5308.227462,2233.928002
W393,3500,725,38921545.25,1213,8560,7347,6601.710345,1621.326782
W440,3500,723,38814175.47,1161,7367,6206,4805.932227,1722.327414
W441,3500,719,38599435.91,4554,8095,3541,7212.077886,682.9804658
W445,3500,724,38867860.36,5262,7914,2652,6877.133978,570.7134117
W500,3500,717,38492066.13,1306,8546,7240,5802.375174,2167.166835
1,3750,826,44343719.14,4204,8605,4401,7570.831719,678.7038562
2,3750,828,44451088.92,1796,8812,7016,6558.43599,1452.988218
3,3750,833,44719513.37,5422,8883,3461,7892.981993,383.3746545
4,3750,830,44558458.7,2900,8447,5547,7513.407229,808.7419774
5,3750,830,44558458.7,-1836,8397,10233,6223.128916,1629.253463
6,3750,830,44558458.7,1929,9287,7358,7646.891566,1244.856434
7,3750,828,44451088.92,2052,9571,7519,7360.36715,1254.253787
8,3750,832,44665828.48,2165,8415,6250,6707.393029,1465.226311
9,3750,836,44880568.04,5982,8742,2760,8014.83134,431.6245672
10,3750,827,44397404.03,713,9882,9169,6241.58162,1996.858937
11,3750,824,44236349.36,791,8628,7837,5784.867718,2234.07043
12,3750,821,44075294.69,1336,9418,8082,5162.323995,2196.316999
13,3750,826,44343719.14,2206,9182,6976,7311.761501,1264.608433
14,3750,832,44665828.48,6238,8775,2537,8076.735577,378.3218287
16,3750,825,44290034.25,262,9547,9285,4451.518788,2530.687257
17,3750,830,44558458.7,2037,9565,7528,7319.655422,797.836677
18,3750,829,44504773.81,705,9950,9245,4294.518697,2700.034144
19,3750,832,44665828.48,1104,8810,7706,4751.507212,2466.446246
20,3750,832,44665828.48,5854,8671,2817,8084.969952,318.3575643
21,3750,829,44504773.81,6445,8777,2332,8003.88661,383.8915762
22,3750,828,44451088.92,-1781,9834,11615,4875.219807,2839.66913
23,3750,834,44773198.26,418,9298,8880,4402.390887,2753.171843
24,3750,827,44397404.03,1443,8847,7404,7716.881499,1060.033087
25,3750,835,44826883.15,1499,9510,8011,7248.413174,1344.790217
26,3750,831,44612143.59,7076,8732,1656,8095.504212,343.9632248
27,3750,830,44558458.7,5313,8647,3334,8006.460241,391.7086208
28,3750,830,44558458.7,5448,8586,3138,7796.756627,528.2430036
29,3750,827,44397404.03,4521,9230,4709,7753.916566,596.4837
31,3750,830,44558458.7,5576,8754,3178,7872.083133,603.6630386
32,3750,829,44504773.81,1681,8542,6861,6898.3269,1536.480168
33,3750,826,44343719.14,5522,8344,2822,7201.996368,501.9052839
34,3750,832,44665828.48,5169,8482,3313,7306.199519,571.3826547
10A,3750,826,44343719.14,1004,9882,8878,6293.912833,2106.217396
10NE,3750,829,44504773.81,629,9882,9253,6254.332931,2170.075968
10NW,3750,831,44612143.59,251,8869,8618,6586.7858,1526.726058
10SW,3750,823,44182664.47,631,9882,9251,5057.383961,2299.280589
11NE,3750,830,44558458.7,1850,9787,7937,6958.306024,1670.713802
11NW,3750,827,44397404.03,-92,8783,8875,5924.822249,2525.663634
11SE,3750,830,44558458.7,956,8632,7676,6209.595181,2081.966793
17NW,3750,830,44558458.7,701,9338,8637,6667.827711,1885.289016
17SE,3750,828,44451088.92,1267,8787,7520,6573.472222,1642.064826
17SW,3750,824,44236349.36,-834,9823,10657,5769.481796,2325.776389
22S,3750,832,44665828.48,-1781,9597,11378,4628.909856,2891.583447
23S,3750,821,44075294.69,1386,9002,7616,3596.52497,1760.666661
24S,3750,831,44612143.59,1336,8847,7511,7694.398315,1091.791753
27A,3750,828,44451088.92,1487,9135,7648,6657.928744,2098.633966
2A,3750,830,44558458.7,1796,9292,7496,6471.243373,1687.306986
5NE,3750,831,44612143.59,614,9736,9122,5207.694344,2219.496404
5NW,3750,828,44451088.92,1063,9736,8673,5691.9843,2098.763759
5SE,3750,827,44397404.03,674,9804,9130,3758.934704,2407.395031
6NE,3750,831,44612143.59,1796,8842,7046,7122.21781,1641.614053
6NW,3750,831,44612143.59,1254,9147,7893,6523.472924,2197.669041
6SW,3750,831,44612143.59,1038,9287,8249,6771.968712,2206.883566
Cell 1 2011/12,3750,826,44343719.14,4204,8605,4401,7570.831719,678.7038562
Cell 1 SW 2013,3750,826,44343719.14,-1428,7845,9273,5205.242131,2004.821862
Cell 10 2011/12,3750,827,44397404.03,713,9882,9169,6241.58162,1996.858937
Cell 10 NE 2011/12,3750,829,44504773.81,629,9882,9253,6254.332931,2170.075968
Cell 10 NW 2011/12,3750,831,44612143.59,251,8869,8618,6586.7858,1526.726058
Cell 10 SE 2013,3750,831,44612143.59,1254,9147,7893,6523.472924,2197.669041
Cell 10 SW 2011/12,3750,823,44182664.47,631,9882,9251,5057.383961,2299.280589
Cell 10-A 2011/12,3750,826,44343719.14,1004,9882,8878,6293.912833,2106.217396
Cell 11 NE 2011/12,3750,830,44558458.7,1850,9787,7937,6958.306024,1670.713802
Cell 11 NW 2013,3750,830,44558458.7,1796,9292,7496,6539.990361,1610.588412
Cell 11 SW 2013,3750,831,44612143.59,1835,9287,7452,7731.581227,1206.674467
Cell 12 2013,3750,831,44612143.59,2052,9571,7519,7364.944645,1254.678671
Cell 13 2013,3750,832,44665828.48,2165,8415,6250,6620.572115,1518.511061
Cell 14 2013,3750,830,44558458.7,6867,8733,1866,7954.514458,333.330451
Cell 15 2013,3750,828,44451088.92,6718,8739,2021,7972.88285,349.0897405
Cell 15-A 2013,3750,833,44719513.37,6215,8739,2524,7937.07563,366.1347869
Cell 16 2013,3750,832,44665828.48,6398,8963,2565,7933.828125,376.6277691
Cell 17 NW 2011/12,3750,830,44558458.7,701,9338,8637,6667.827711,1885.289016
Cell 17 NW 2013,3750,829,44504773.81,-1836,9736,11572,6022.527141,1794.455464
Cell 17 SE 2013,3750,831,44612143.59,251,8869,8618,6586.7858,1526.726058
Cell 17 SW 2013,3750,825,44290034.25,-1836,8397,10233,6202.275152,1639.190196
Cell 18 2011/12,3750,829,44504773.81,705,9950,9245,4294.518697,2700.034144
Cell 18 NE 2013,3750,828,44451088.92,1038,9287,8249,6725.759662,2252.395367
Cell 18 NW 2013,3750,832,44665828.48,674,9804,9130,3648.669471,2338.923762
Cell 18 SE 2013,3750,830,44558458.7,1850,9787,7937,6958.306024,1670.713802
Cell 18 SSE 2013,3750,828,44451088.92,-92,8783,8875,5885.294686,2454.891384
Cell 19 NW 2013,3750,829,44504773.81,2214,9287,7073,7851.084439,981.2531881
Cell 2 2011/12,3750,828,44451088.92,1796,8812,7016,6558.43599,1452.988218
Cell 2 NE 2013,3750,832,44665828.48,-1954,9266,11220,6553.508413,1911.238658
Cell 2 SW 2013,3750,826,44343719.14,4204,8605,4401,7572.583535,677.3823234
Cell 20 2013,3750,830,44558458.7,1951,9548,7597,7400.762651,1334.340606
Cell 21 2013,3750,831,44612143.59,2206,8914,6708,7325.11071,1256.035171
Cell 22 2013,3750,831,44612143.59,5930,8742,2812,7922.641396,479.169708
Cell 23 2013,3750,833,44719513.37,6488,8920,2432,8328.663866,365.0448703
Cell 24 2013,3750,830,44558458.7,6891,8963,2072,7996.954217,343.3331275
Cell 25 NE 2013,3750,826,44343719.14,713,9882,9169,6247.079903,1991.80117
Cell 25 SE 2013,3750,823,44182664.47,631,9882,9251,5057.383961,2299.280589
Cell 26 NE 2013,3750,824,44236349.36,791,8628,7837,5784.867718,2234.07043
Cell 26 NNW 2013,3750,830,44558458.7,629,9882,9253,6248.339759,2175.622222
Cell 26 NW 2013,3750,826,44343719.14,1004,9882,8878,6293.912833,2106.217396
Cell 27 NW 2013,3750,830,44558458.7,956,8632,7676,6209.595181,2081.966793
Cell 28 2013,3750,821,44075294.69,1336,9418,8082,5162.323995,2196.316999
Cell 29 2013,3750,828,44451088.92,2206,9182,6976,7309.554348,1264.271416
Cell 3 NE 2013,3750,832,44665828.48,-1958,9038,10996,7284.009615,1508.705722
Cell 3 NW 2013,3750,828,44451088.92,-1851,9266,11117,7076.655797,1554.303032
Cell 30 2013,3750,831,44612143.59,6794,8967,2173,8107.371841,346.0280765
Cell 31 2013,3750,824,44236349.36,6238,8775,2537,8060.225728,383.765876
Cell 32 2013,3750,832,44665828.48,5623,8875,3252,7804.393029,553.0349508
Cell 33 NE 2013,3750,830,44558458.7,701,9338,8637,6667.827711,1885.289016
Cell 33 SE 2013,3750,825,44290034.25,-834,9823,10657,5764.104242,2329.486566
Cell 33 SW 2013,3750,831,44612143.59,-29,9547,9576,4300.930205,2582.037387
Cell 34 N 2013,3750,831,44612143.59,1502,8852,7350,6932.600481,1420.640096
Cell 34 NW 2013,3750,830,44558458.7,2037,9565,7528,7319.655422,797.836677
Cell 34 SE 2013,3750,827,44397404.03,1284,8787,7503,6581.096735,1632.003215
Cell 35 2013,3750,835,44826883.15,1040,9950,8910,4746.275449,2814.492925
Cell 37 2013,3750,829,44504773.81,5854,8671,2817,8079.110977,319.4595364
Cell 38 2013,3750,825,44290034.25,6445,8777,2332,7999.527273,383.3725771
Cell 39 2013,3750,832,44665828.48,6681,9059,2378,8357.872596,395.5698003
Cell 4 2013,3750,831,44612143.59,6698,8437,1739,7788.951865,315.394754
Cell 40 NE 2013,3750,835,44826883.15,-1781,9693,11474,5086.900599,2798.987122
Cell 41 N 2013,3750,824,44236349.36,-1781,9972,11753,6980.317961,2009.794125
Cell 41 NW 2013,3750,826,44343719.14,-1781,9972,11753,6035.641646,2706.335048
Cell 42 NW 2013,3750,824,44236349.36,418,9298,8880,4340.673544,2755.966225
Cell 43 2013,3750,822,44128979.58,1292,8783,7491,6597.886861,1915.945005
Cell 44 2013,3750,825,44290034.25,5854,8671,2817,7868.592727,467.0605426
Cell 45 2013,3750,831,44612143.59,7076,8732,1656,8096.545126,342.7489987
Cell 47 2013,3750,832,44665828.48,1120,8847,7727,6550.308894,2122.597078
Cell 48 2013,3750,830,44558458.7,1336,8847,7511,7694.224096,1092.445193
Cell 49 2013,3750,835,44826883.15,1499,9510,8011,7248.413174,1344.790217
Cell 5 2011/12 Summer,3750,825,44290034.25,-1836,8397,10233,6202.275152,1639.190196
Cell 5 2013,3750,831,44612143.59,6707,8710,2003,7943.269555,362.8824131
Cell 50 2013,3750,827,44397404.03,4521,9230,4709,7753.916566,596.4837
Cell 51 2013,3750,822,44128979.58,6670,8980,2310,8186.057178,378.0416472
Cell 52 2013,3750,832,44665828.48,2225,8616,6391,7823.040865,663.1191271
Cell 53 2013,3750,830,44558458.7,5448,8586,3138,7796.756627,528.2430036
Cell 54 2013,3750,828,44451088.92,5568,8970,3402,8135.25,578.5362122
Cell 55 2013,3750,833,44719513.37,6477,8903,2426,8203.89916,472.9553016
Cell 56 2013,3750,824,44236349.36,5522,8344,2822,7202.203883,501.13416
Cell 57 2013,3750,829,44504773.81,1681,8542,6861,6898.607961,1536.59395
Cell 58 2013,3750,832,44665828.48,6833,8885,2052,8416.430288,271.6444269
Cell 59 2013,3750,831,44612143.59,6045,8233,2188,7328.99639,415.940387
Cell 6 2011/12,3750,830,44558458.7,1929,9287,7358,7646.891566,1244.856434
Cell 6 2013,3750,830,44558458.7,5788,8726,2938,7998.354217,372.3556045
Cell 6 NE 2011/12,3750,831,44612143.59,1796,8842,7046,7122.21781,1641.614053
Cell 6 NW 2011/12,3750,831,44612143.59,1254,9147,7893,6523.472924,2197.669041
Cell 6 SW 2011/12,3750,831,44612143.59,1038,9287,8249,6771.968712,2206.883566
Cell 60 2013,3750,825,44290034.25,5169,8482,3313,7357.093333,522.1165106
Cell 61 2013,3750,832,44665828.48,3582,8736,5154,7612.063702,777.6279001
Cell 7 2013,3750,822,44128979.58,5036,8694,3658,7865.734793,535.9926895
Cell 9 NW 2013,3750,828,44451088.92,-76,9550,9626,5539.140097,2180.792848
Cell 9 SE 2013,3750,831,44612143.59,614,9736,9122,5207.694344,2219.496404
Cell 9 SW 2013,3750,827,44397404.03,1063,9736,8673,5692.657799,2099.942852
Cell R1,3750,829,44504773.81,1358,8197,6839,5926.276236,1960.87463
Cell R10,3750,831,44612143.59,6698,8437,1739,7788.951865,315.394754
Cell R100,3750,827,44397404.03,4521,9230,4709,7753.916566,596.4837
Cell R101,3750,830,44558458.7,6311,8748,2437,8015.907229,408.0560141
Cell R104,3750,832,44665828.48,1869,9360,7491,7485.082933,1610.278029
Cell R105,3750,830,44558458.7,5448,8586,3138,7796.756627,528.2430036
Cell R106,3750,828,44451088.92,1520,8550,7030,7136.257246,1534.518124
Cell R107,3750,828,44451088.92,5568,8970,3402,8133.522947,579.0028708
Cell R11,3750,831,44612143.59,6707,8710,2003,7943.269555,362.8824131
Cell R111,3750,832,44665828.48,1562,9468,7906,7156.375,2074.025464
Cell R112,3750,832,44665828.48,6656,8565,1909,8057.052885,319.8947988
Cell R113,3750,829,44504773.81,1681,8542,6861,6898.607961,1536.59395
Cell R114,3750,832,44665828.48,6833,8885,2052,8416.430288,271.6444269
Cell R117,3750,832,44665828.48,1605,9074,7469,7131.239183,935.6945997
Cell R118,3750,825,44290034.25,5522,8344,2822,7201.886061,500.9134387
Cell R119,3750,831,44612143.59,1815,8394,6579,6727.191336,1178.538195
Cell R120,3750,834,44773198.26,2412,8655,6243,7666.434053,833.6607181
Cell R121,3750,832,44665828.48,6617,8791,2174,8095.121394,362.8516775
Cell R123,3750,828,44451088.92,6373,9542,3169,7565.426329,454.4571568
Cell R124,3750,827,44397404.03,4246,8482,4236,7360.868198,523.0792175
Cell R125,3750,826,44343719.14,1894,8555,6661,6742.186441,1297.937866
Cell R126,3750,829,44504773.81,3582,8551,4969,7426.250905,867.6009251
Cell R15,3750,825,44290034.25,-1428,7845,9273,5206.414545,2005.753526
Cell R16,3750,828,44451088.92,-76,9550,9626,5548.927536,2170.345218
Cell R17,3750,826,44343719.14,1694,9057,7363,7218.863196,1443.589471
Cell R18,3750,820,44021609.8,1796,9292,7496,6534.442683,1612.359736
Cell R19,3750,829,44504773.81,1681,8969,7288,7459.337756,1414.974853
Cell R20,3750,831,44612143.59,3132,8467,5335,7586.844765,703.046365
Cell R21,3750,832,44665828.48,5200,8692,3492,7645.27524,394.0030688
Cell R22,3750,831,44612143.59,6867,8733,1866,7952.398315,334.7143962
Cell R24,3750,829,44504773.81,-1836,9736,11572,6022.527141,1794.455464
Cell R25,3750,832,44665828.48,674,9804,9130,3648.669471,2338.923762
Cell R26,3750,832,44665828.48,1277,9147,7870,6555.301683,2163.822879
Cell R27,3750,829,44504773.81,2214,9287,7073,7851.084439,981.2531881
Cell R28,3750,830,44558458.7,1373,9571,8198,6412.143373,2117.481702
Cell R29,3750,830,44558458.7,1951,9548,7597,7400.762651,1334.340606
Cell R30,3750,830,44558458.7,4196,8516,4320,7542.226506,656.8026967
Cell R31,3750,825,44290034.25,4978,8693,3715,7793.358788,490.0832976
Cell R35,3750,825,44290034.25,-1836,8397,10233,6202.275152,1639.190196
Cell R36,3750,831,44612143.59,251,8869,8618,6586.7858,1526.726058
Cell R37,3750,830,44558458.7,1850,9787,7937,6958.306024,1670.713802
Cell R38,3750,825,44290034.25,1481,9787,8306,6743.329697,1984.071745
Cell R39,3750,828,44451088.92,1810,8970,7160,7172.811594,1372.21124
Cell R40,3750,832,44665828.48,2206,8914,6708,7326.233173,1255.697083
Cell R46,3750,827,44397404.03,344,9704,9360,5081.096735,2404.398657
Cell R47,3750,826,44343719.14,1004,9882,8878,6293.912833,2106.217396
Cell R48,3750,824,44236349.36,791,8628,7837,5784.867718,2234.07043
Cell R49,3750,830,44558458.7,956,8632,7676,6209.595181,2081.966793
Cell R5,3750,830,44558458.7,-1428,8079,9507,5599.274699,1801.234817
Cell R50,3750,821,44075294.69,1336,9418,8082,5162.323995,2196.316999
Cell R51,3750,826,44343719.14,2206,9182,6976,7310.829298,1261.909367
Cell R52,3750,828,44451088.92,2213,8779,6566,7560.649758,937.8635955
Cell R53,3750,831,44612143.59,4412,8779,4367,7762.631769,525.7679219
Cell R54,3750,824,44236349.36,6238,8775,2537,8060.225728,383.765876
Cell R58,3750,829,44504773.81,-812,9043,9855,4268.160434,2390.257276
Cell R59,3750,830,44558458.7,701,9338,8637,6667.827711,1885.289016
Cell R6,3750,826,44343719.14,4204,8605,4401,7572.583535,677.3823234
Cell R60,3750,830,44558458.7,2037,9565,7528,7319.655422,797.836677
Cell R61,3750,835,44826883.15,1040,9950,8910,4746.275449,2814.492925
Cell R62,3750,828,44451088.92,1104,8810,7706,4612.562802,2446.024905
Cell R63,3750,832,44665828.48,1205,8912,7707,6897.853365,1690.322008
Cell R64,3750,833,44719513.37,4051,8585,4534,7936.295318,458.7891618
Cell R65,3750,830,44558458.7,6794,8967,2173,8107.587952,346.1804131
Cell R66,3750,825,44290034.25,6337,8921,2584,8389.355152,435.0100423
Cell R69,3750,831,44612143.59,-29,9547,9576,4300.930205,2582.037387
Cell R7,3750,828,44451088.92,-1851,9266,11117,7076.655797,1554.303032
Cell R70,3750,825,44290034.25,-834,9823,10657,5764.104242,2329.486566
Cell R71,3750,826,44343719.14,1284,8787,7503,6581.588378,1632.929605
Cell R72,3750,833,44719513.37,418,9677,9259,5083.966387,2537.555667
Cell R73,3750,825,44290034.25,1253,9950,8697,6246.121212,2330.667366
Cell R74,3750,830,44558458.7,1387,9400,8013,6903.113253,2013.480509
Cell R75,3750,829,44504773.81,5854,8671,2817,8079.110977,319.4595364
Cell R76,3750,826,44343719.14,6787,8980,2193,8284.033898,410.9747538
Cell R77,3750,825,44290034.25,6445,8777,2332,7999.527273,383.3725771
Cell R8,3750,830,44558458.7,-1958,9038,10996,7397.228916,1472.160921
Cell R80,3750,833,44719513.37,-1781,9693,11474,5082.771909,2801.054517
Cell R81,3750,830,44558458.7,989,9972,8983,6716.618072,2083.166102
Cell R82,3750,824,44236349.36,418,9298,8880,4340.673544,2755.966225
Cell R83,3750,828,44451088.92,853,9571,8718,5580.969807,2712.272491
Cell R84,3750,828,44451088.92,1292,8939,7647,4986.150966,2348.787829
Cell R85,3750,822,44128979.58,1292,8783,7491,6597.886861,1915.945005
Cell R86,3750,828,44451088.92,6104,8671,2567,7773.595411,382.5256227
Cell R87,3750,831,44612143.59,7076,8732,1656,8096.545126,342.7489987
Cell R9,3750,833,44719513.37,-1958,9038,10996,7305.445378,1433.629089
Cell R90,3750,831,44612143.59,1120,8847,7727,6551.969916,2123.33336
Cell R91,3750,830,44558458.7,1336,8847,7511,7694.224096,1092.445193
Cell R92,3750,828,44451088.92,1304,9904,8600,3915.271739,2328.085559
Cell R93,3750,835,44826883.15,1499,9510,8011,7248.413174,1344.790217
Cell R97,3750,825,44290034.25,1487,9135,7648,6754.346667,1971.403324
Cell R98,3750,830,44558458.7,5313,8647,3334,8005.980723,391.7101149
Cell R99,3750,832,44665828.48,2225,8616,6391,7823.040865,663.1191271
Cell S102,3750,827,44397404.03,6670,9085,2415,8222.453446,426.4168714
Cell S108,3750,834,44773198.26,6477,8903,2426,8203.595923,472.7526881
Cell S13,3750,831,44612143.59,6589,8945,2356,8003.642599,381.7009194
Cell S14,3750,821,44075294.69,5036,8694,3658,7864.725944,535.5384911
Cell S2,3750,830,44558458.7,5788,8726,2938,7998.428916,372.4066784
Cell S23,3750,832,44665828.48,6235,8741,2506,8088.878606,358.022921
Cell S32,3750,831,44612143.59,5457,8778,3321,7965.672684,525.9974777
Cell S33,3750,833,44719513.37,6215,8739,2524,7937.07563,366.1347869
Cell S34,3750,830,44558458.7,6891,8963,2072,7996.954217,343.3331275
Cell S41,3750,831,44612143.59,6320,8727,2407,7911.606498,364.834823
Cell S42,3750,832,44665828.48,6488,8920,2432,8328.598558,365.259319
Cell S44,3750,828,44451088.92,6035,9061,3026,7983.210145,414.0250223
Cell S56,3750,825,44290034.25,6104,8938,2834,7733.869091,444.3331481
Cell S67,3750,832,44665828.48,5623,8875,3252,7804.393029,553.0349508
Cell S78,3750,832,44665828.48,6681,9059,2378,8357.872596,395.5698003
Cell S88,3750,832,44665828.48,6869,9017,2148,8259.479567,374.09332
Cell S94,3750,830,44558458.7,7120,9085,1965,8302.804819,349.606878
Cell S95,3750,822,44128979.58,6670,8980,2310,8186.057178,378.0416472
W287,3750,830,44558458.7,941,8828,7887,4203.918072,1832.453469
W295,3750,830,44558458.7,2167,8785,6618,6831.940964,1455.470704
W338,3750,830,44558458.7,982,9399,8417,4963.93253,2553.591409
W342,3750,831,44612143.59,1568,8515,6947,5678.369434,2052.853424
W345,3750,829,44504773.81,3500,8372,4872,7445.320869,430.7500747
W387,3750,830,44558458.7,1121,9175,8054,5305.053012,2272.699656
W393,3750,828,44451088.92,1118,8560,7442,6483.024155,1760.123408
W440,3750,827,44397404.03,1161,7367,6206,4771.677146,1774.746165
W441,3750,830,44558458.7,4477,8112,3635,7151.478313,719.3701052
W445,3750,831,44612143.59,2669,8093,5424,6854.599278,631.7214248
W500,3750,829,44504773.81,1306,8546,7240,5908.62123,2089.427154
1,4000,944,50678536.16,3031,8995,5964,7546.425847,703.9278261
2,4000,948,50893275.72,1796,8812,7016,6538.291139,1490.974345
3,4000,940,50463796.6,3466,8969,5503,7861.473404,488.5875913
4,4000,941,50517481.49,2900,8447,5547,7500.517535,867.5842215
5,4000,940,50463796.6,-1836,8397,10233,6232.22234,1620.156429
6,4000,944,50678536.16,1868,9287,7419,7543.394068,1341.842073
7,4000,947,50839590.83,1880,9571,7691,7289.516367,1355.90701
8,4000,942,50571166.38,2165,8415,6250,6744.475584,1456.592042
9,4000,940,50463796.6,5982,8742,2760,8009.961702,438.4489619
10,4000,945,50732221.05,713,9882,9169,6212.507937,2026.547962
11,4000,939,50410111.71,791,8632,7841,5707.482428,2261.787254
12,4000,939,50410111.71,1336,9418,8082,4987.088392,2238.893833
13,4000,941,50517481.49,2206,9182,6976,7272.100956,1303.678534
14,4000,942,50571166.38,6238,8787,2549,8076.031847,381.7842637
16,4000,941,50517481.49,262,9547,9285,4516.333688,2582.438275
17,4000,939,50410111.71,2037,9565,7528,7268.458999,900.8825842
18,4000,949,50946960.61,705,9950,9245,4377.726027,2704.176707
19,4000,940,50463796.6,1104,8810,7706,4771.392553,2460.440479
20,4000,942,50571166.38,5854,8786,2932,8086.489384,325.5721852
21,4000,947,50839590.83,6445,8777,2332,8035.909187,381.3579502
22,4000,948,50893275.72,-1781,9834,11615,4891.901899,2854.423765
23,4000,947,50839590.83,418,9298,8880,4478.995776,2753.258139
24,4000,941,50517481.49,1336,8847,7511,7602.409139,1300.034964
25,4000,947,50839590.83,1499,9510,8011,7231.671595,1357.947911
26,4000,944,50678536.16,7076,8732,1656,8106.456568,342.0089828
27,4000,942,50571166.38,4787,8647,3860,7989.633758,431.9036033
28,4000,943,50624851.27,5253,8602,3349,7788.573701,537.5368775
29,4000,941,50517481.49,2396,9230,6834,7722.038257,695.7724418
31,4000,946,50785905.94,5117,8754,3637,7874.234672,604.1693649
32,4000,947,50839590.83,1681,8980,7299,6912.689546,1542.450126
33,4000,941,50517481.49,5522,8409,2887,7222.42933,522.7416124
34,4000,950,51000645.5,5008,8482,3474,7283.505263,588.2729741
10A,4000,940,50463796.6,1004,9882,8878,6181.415957,2160.592327
10NE,4000,941,50517481.49,629,9882,9253,6100.293305,2277.100465
10NW,4000,940,50463796.6,251,8869,8618,6401.401064,1725.064416
10SW,4000,942,50571166.38,201,9882,9681,5101.158174,2301.110328
11NE,4000,949,50946960.61,1345,9787,8442,6912.275026,1728.87092
11NW,4000,941,50517481.49,-92,8834,8926,5829.398512,2537.246807
11SE,4000,944,50678536.16,956,8632,7676,6114.065678,2175.740095
17NW,4000,945,50732221.05,655,9338,8683,6542.700529,2025.747436
17SE,4000,942,50571166.38,1267,8787,7520,6545.884289,1693.138717
17SW,4000,941,50517481.49,-1781,9823,11604,5661.596174,2401.953821
22S,4000,941,50517481.49,-1781,9647,11428,4663.925611,2892.719337
23S,4000,939,50410111.71,1386,9002,7616,3662.812567,1811.463663
24S,4000,941,50517481.49,1336,8847,7511,7587.520723,1314.33666
27A,4000,942,50571166.38,1487,9135,7648,6723.683652,2070.612409
2A,4000,939,50410111.71,1668,9292,7624,6494.923323,1672.796201
5NE,4000,941,50517481.49,614,9736,9122,5048.056323,2270.362578
5NW,4000,948,50893275.72,-1428,9736,11164,5679.080169,2144.82537
5SE,4000,943,50624851.27,674,9804,9130,3757.102863,2397.724006
6NE,4000,947,50839590.83,1796,9050,7254,7143.170011,1627.793727
6NW,4000,945,50732221.05,1254,9253,7999,6397.256085,2300.728796
6SW,4000,941,50517481.49,1036,9287,8251,6742.479277,2225.50196
Cell 1 2011/12,4000,944,50678536.16,3031,8995,5964,7546.425847,703.9278261
Cell 1 SW 2013,4000,942,50571166.38,-1428,8335,9763,5171.213376,2014.96063
Cell 10 2011/12,4000,945,50732221.05,713,9882,9169,6212.507937,2026.547962
Cell 10 NE 2011/12,4000,941,50517481.49,629,9882,9253,6100.293305,2277.100465
Cell 10 NW 2011/12,4000,940,50463796.6,251,8869,8618,6401.401064,1725.064416
Cell 10 SE 2013,4000,945,50732221.05,1254,9253,7999,6397.256085,2300.728796
Cell 10 SW 2011/12,4000,942,50571166.38,201,9882,9681,5101.158174,2301.110328
Cell 10-A 2011/12,4000,940,50463796.6,1004,9882,8878,6181.415957,2160.592327
Cell 11 NE 2011/12,4000,949,50946960.61,1345,9787,8442,6912.275026,1728.87092
Cell 11 NW 2013,4000,940,50463796.6,1796,9292,7496,6517.593617,1641.76224
Cell 11 SW 2013,4000,941,50517481.49,1835,9287,7452,7593.069075,1407.301882
Cell 12 2013,4000,945,50732221.05,1880,9571,7691,7297.939683,1348.096531
Cell 13 2013,4000,940,50463796.6,2165,8415,6250,6682.470213,1523.716222
Cell 14 2013,4000,941,50517481.49,6867,8733,1866,7940.687566,343.106853
Cell 15 2013,4000,945,50732221.05,6718,8739,2021,7959.93545,362.8978387
Cell 15-A 2013,4000,941,50517481.49,6215,8739,2524,7943.191286,372.8428136
Cell 16 2013,4000,943,50624851.27,6368,8963,2595,7935.085896,383.2434057
Cell 17 NW 2011/12,4000,945,50732221.05,655,9338,8683,6542.700529,2025.747436
Cell 17 NW 2013,4000,947,50839590.83,-1836,9736,11572,5978.422386,1836.538148
Cell 17 SE 2013,4000,940,50463796.6,251,8869,8618,6401.401064,1725.064416
Cell 17 SW 2013,4000,938,50356426.82,-1836,8397,10233,6215.358209,1632.602123
Cell 18 2011/12,4000,949,50946960.61,705,9950,9245,4377.726027,2704.176707
Cell 18 NE 2013,4000,940,50463796.6,1036,9287,8251,6701.054255,2264.275435
Cell 18 NW 2013,4000,948,50893275.72,674,9804,9130,3671.551688,2350.139238
Cell 18 SE 2013,4000,949,50946960.61,1345,9787,8442,6912.275026,1728.87092
Cell 18 SSE 2013,4000,947,50839590.83,-92,8783,8875,5817.904963,2469.244384
Cell 19 NW 2013,4000,943,50624851.27,1254,9287,8033,7703.811241,1227.646777
Cell 2 2011/12,4000,948,50893275.72,1796,8812,7016,6538.291139,1490.974345
Cell 2 NE 2013,4000,941,50517481.49,-1954,9266,11220,6585.660999,1867.011944
Cell 2 SW 2013,4000,944,50678536.16,3031,8995,5964,7547.919492,704.2074911
Cell 20 2013,4000,940,50463796.6,1536,9548,8012,7287.354255,1494.745031
Cell 21 2013,4000,941,50517481.49,2206,8914,6708,7389.839532,1212.165504
Cell 22 2013,4000,942,50571166.38,5845,8778,2933,7939.635881,477.0911819
Cell 23 2013,4000,946,50785905.94,6172,8920,2748,8302.884778,391.5953336
Cell 24 2013,4000,949,50946960.61,6891,8963,2072,7997.226554,341.4755256
Cell 25 NE 2013,4000,945,50732221.05,713,9882,9169,6212.507937,2026.547962
Cell 25 SE 2013,4000,942,50571166.38,201,9882,9681,5101.158174,2301.110328
Cell 26 NE 2013,4000,940,50463796.6,791,8632,7841,5709.77766,2261.677718
Cell 26 NNW 2013,4000,941,50517481.49,629,9882,9253,6100.293305,2277.100465
Cell 26 NW 2013,4000,940,50463796.6,1004,9882,8878,6181.415957,2160.592327
Cell 27 NW 2013,4000,944,50678536.16,956,8632,7676,6114.065678,2175.740095
Cell 28 2013,4000,939,50410111.71,1336,9418,8082,4987.088392,2238.893833
Cell 29 2013,4000,942,50571166.38,2206,9182,6976,7276.398089,1301.756931
Cell 3 NE 2013,4000,940,50463796.6,-1958,9038,10996,7293.151064,1470.239968
Cell 3 NW 2013,4000,942,50571166.38,-1954,9266,11220,7042.22293,1579.970237
Cell 30 2013,4000,950,51000645.5,6794,8967,2173,8111.583158,350.2190156
Cell 31 2013,4000,941,50517481.49,5717,8901,3184,8074.706695,402.0926412
Cell 32 2013,4000,943,50624851.27,5623,8875,3252,7822.271474,539.4542512
Cell 33 NE 2013,4000,946,50785905.94,655,9338,8683,6539.336152,2027.316271
Cell 33 SE 2013,4000,941,50517481.49,-1781,9823,11604,5657.919235,2406.703456
Cell 33 SW 2013,4000,941,50517481.49,-29,9547,9576,4380.697131,2631.821047
Cell 34 N 2013,4000,941,50517481.49,1022,8852,7830,6853.760893,1556.464613
Cell 34 NW 2013,4000,940,50463796.6,2037,9565,7528,7268.23617,900.4291539
Cell 34 SE 2013,4000,943,50624851.27,1267,8787,7520,6547.490986,1692.93103
Cell 35 2013,4000,947,50839590.83,1040,9950,8910,4748.131996,2771.112482
Cell 37 2013,4000,948,50893275.72,5854,8786,2932,8085.617089,324.9606533
Cell 38 2013,4000,941,50517481.49,6445,8777,2332,8033.075452,381.0800436
Cell 39 2013,4000,941,50517481.49,6681,9059,2378,8361.056323,401.2103129
Cell 4 2013,4000,942,50571166.38,6698,8536,1838,7795.667728,316.8137601
Cell 40 NE 2013,4000,947,50839590.83,-1781,9693,11474,5087.768743,2783.732086
Cell 41 N 2013,4000,940,50463796.6,-1781,9972,11753,6861.740426,2084.776692
Cell 41 NW 2013,4000,945,50732221.05,-1781,9972,11753,5933.386243,2702.956849
Cell 42 NW 2013,4000,940,50463796.6,418,9298,8880,4435.256383,2743.016969
Cell 43 2013,4000,941,50517481.49,1292,8939,7647,6568.623804,1954.511454
Cell 44 2013,4000,941,50517481.49,5854,8671,2817,7866.086079,462.5563837
Cell 45 2013,4000,943,50624851.27,7076,8732,1656,8107.283139,341.0527016
Cell 47 2013,4000,941,50517481.49,1120,8931,7811,6463.976621,2158.78847
Cell 48 2013,4000,941,50517481.49,1336,8847,7511,7586.317747,1314.552572
Cell 49 2013,4000,947,50839590.83,1499,9510,8011,7231.671595,1357.947911
Cell 5 2011/12 Summer,4000,938,50356426.82,-1836,8397,10233,6215.358209,1632.602123
Cell 5 2013,4000,940,50463796.6,6705,8738,2033,7953.729787,365.2468902
Cell 50 2013,4000,941,50517481.49,2396,9230,6834,7722.038257,695.7724418
Cell 51 2013,4000,940,50463796.6,6670,8980,2310,8196.171277,368.3025546
Cell 52 2013,4000,941,50517481.49,1418,8616,7198,7756.317747,893.318782
Cell 53 2013,4000,943,50624851.27,5253,8602,3349,7788.573701,537.5368775
Cell 54 2013,4000,947,50839590.83,5568,8970,3402,8110.227033,611.8020073
Cell 55 2013,4000,942,50571166.38,6477,8903,2426,8199.791932,475.7862743
Cell 56 2013,4000,940,50463796.6,5522,8409,2887,7223.034043,519.1757839
Cell 57 2013,4000,948,50893275.72,1681,8980,7299,6910.825949,1542.00917
Cell 58 2013,4000,943,50624851.27,6660,8912,2252,8400.647932,299.9109043
Cell 59 2013,4000,949,50946960.61,6045,8233,2188,7333.070601,424.0834116
Cell 6 2011/12,4000,944,50678536.16,1868,9287,7419,7543.394068,1341.842073
Cell 6 2013,4000,945,50732221.05,5788,8726,2938,8000.530159,365.6161363
Cell 6 NE 2011/12,4000,947,50839590.83,1796,9050,7254,7143.170011,1627.793727
Cell 6 NW 2011/12,4000,945,50732221.05,1254,9253,7999,6397.256085,2300.728796
Cell 6 SW 2011/12,4000,941,50517481.49,1036,9287,8251,6742.479277,2225.50196
Cell 60 2013,4000,942,50571166.38,4246,8482,4236,7357.767516,554.5725617
Cell 61 2013,4000,946,50785905.94,3582,8736,5154,7609.59408,807.273759
Cell 7 2013,4000,940,50463796.6,5036,8935,3899,7850.153191,545.2129956
Cell 9 NW 2013,4000,944,50678536.16,-76,9550,9626,5397.940678,2213.540588
Cell 9 SE 2013,4000,940,50463796.6,614,9736,9122,5046.018085,2270.709248
Cell 9 SW 2013,4000,949,50946960.61,-1428,9736,11164,5670.838778,2144.54184
Cell R1,4000,949,50946960.61,1239,8197,6958,5877.020021,1985.449272
Cell R10,4000,942,50571166.38,6698,8536,1838,7795.667728,316.8137601
Cell R100,4000,941,50517481.49,2396,9230,6834,7722.038257,695.7724418
Cell R101,4000,944,50678536.16,6249,8748,2499,8021.080508,416.8089835
Cell R104,4000,942,50571166.38,1301,9360,8059,7375.230361,1758.006852
Cell R105,4000,943,50624851.27,5253,8602,3349,7788.573701,537.5368775
Cell R106,4000,948,50893275.72,1520,9524,8004,7190.839662,1531.854677
Cell R107,4000,948,50893275.72,5568,8970,3402,8108.166667,614.7576601
Cell R11,4000,940,50463796.6,6705,8738,2033,7952.869149,365.1309397
Cell R111,4000,943,50624851.27,1562,9468,7906,7134.553552,2066.694565
Cell R112,4000,942,50571166.38,6656,8688,2032,8052.935244,319.5451369
Cell R113,4000,948,50893275.72,1681,8980,7299,6910.825949,1542.00917
Cell R114,4000,943,50624851.27,6660,8912,2252,8400.647932,299.9109043
Cell R117,4000,949,50946960.61,1430,9074,7644,7046.328767,1117.922092
Cell R118,4000,940,50463796.6,5522,8409,2887,7223.034043,519.1757839
Cell R119,4000,942,50571166.38,1746,8394,6648,6692.863057,1302.751192
Cell R120,4000,949,50946960.61,2412,8655,6243,7628.559536,867.3833705
Cell R121,4000,942,50571166.38,6617,8791,2174,8092.301486,370.8720491
Cell R123,4000,942,50571166.38,3441,9542,6101,7553.789809,495.3723882
Cell R124,4000,941,50517481.49,4022,8482,4460,7339.922423,588.216564
Cell R125,4000,942,50571166.38,1894,8555,6661,6745.558386,1284.061621
Cell R126,4000,940,50463796.6,3582,8551,4969,7450.682979,847.1886458
Cell R15,4000,942,50571166.38,-1428,8335,9763,5171.213376,2014.96063
Cell R16,4000,947,50839590.83,-76,9550,9626,5393.593453,2214.28407
Cell R17,4000,941,50517481.49,1694,9057,7363,7204.019129,1453.633447
Cell R18,4000,937,50302741.93,1796,9292,7496,6503.165422,1643.366339
Cell R19,4000,947,50839590.83,1653,8969,7316,7358.32735,1537.2088
Cell R20,4000,940,50463796.6,2900,8536,5636,7569.528723,797.783188
Cell R21,4000,940,50463796.6,4600,8730,4130,7651.311702,441.4700246
Cell R22,4000,940,50463796.6,6867,8733,1866,7941.135106,343.0146853
Cell R24,4000,947,50839590.83,-1836,9736,11572,5978.422386,1836.538148
Cell R25,4000,948,50893275.72,674,9804,9130,3676.837553,2353.562918
Cell R26,4000,941,50517481.49,1254,9147,7893,6432.859724,2267.551625
Cell R27,4000,945,50732221.05,1254,9287,8033,7702.391534,1227.856908
Cell R28,4000,942,50571166.38,1373,9571,8198,6386.930998,2135.871257
Cell R29,4000,940,50463796.6,1536,9548,8012,7287.354255,1494.745031
Cell R30,4000,941,50517481.49,3570,8516,4946,7503.245484,711.7398765
Cell R31,4000,942,50571166.38,4978,8693,3715,7807.44586,492.2711942
Cell R35,4000,938,50356426.82,-1836,8397,10233,6215.358209,1632.602123
Cell R36,4000,939,50410111.71,251,8869,8618,6400.791267,1725.881475
Cell R37,4000,949,50946960.61,1345,9787,8442,6912.275026,1728.87092
Cell R38,4000,941,50517481.49,1425,9787,8362,6559.861849,2106.792312
Cell R39,4000,948,50893275.72,1810,8970,7160,7152.778481,1368.647356
Cell R40,4000,941,50517481.49,2206,8914,6708,7389.839532,1212.165504
Cell R46,4000,943,50624851.27,-476,9704,10180,5213.283139,2440.493862
Cell R47,4000,940,50463796.6,1004,9882,8878,6181.415957,2160.592327
Cell R48,4000,940,50463796.6,791,8632,7841,5709.77766,2261.677718
Cell R49,4000,945,50732221.05,956,8632,7676,6112.079365,2175.444804
Cell R5,4000,945,50732221.05,-1428,8335,9763,5558.859259,1835.379351
Cell R50,4000,939,50410111.71,1336,9418,8082,4987.088392,2238.893833
Cell R51,4000,940,50463796.6,2206,9182,6976,7278.714894,1296.382614
Cell R52,4000,941,50517481.49,2213,8779,6566,7536.685441,957.0146577
Cell R53,4000,940,50463796.6,4412,8779,4367,7763.924468,521.9171264
Cell R54,4000,940,50463796.6,5717,8901,3184,8075.731915,401.0753397
Cell R58,4000,941,50517481.49,-908,9179,10087,4223.323061,2398.800081
Cell R59,4000,945,50732221.05,655,9338,8683,6542.700529,2025.747436
Cell R6,4000,946,50785905.94,3031,8995,5964,7542.693446,716.7114374
Cell R60,4000,939,50410111.71,2037,9565,7528,7267.460064,900.5941946
Cell R61,4000,947,50839590.83,1040,9950,8910,4748.131996,2771.112482
Cell R62,4000,941,50517481.49,1104,8810,7706,4658.368757,2448.581443
Cell R63,4000,941,50517481.49,1205,8912,7707,6875.713071,1683.243582
Cell R64,4000,942,50571166.38,4051,8585,4534,7923.860934,449.8073293
Cell R65,4000,950,51000645.5,6794,8967,2173,8111.583158,350.2190156
Cell R66,4000,943,50624851.27,6337,8929,2592,8382.16649,432.5302518
Cell R69,4000,941,50517481.49,-29,9547,9576,4380.697131,2631.821047
Cell R7,4000,942,50571166.38,-1954,9266,11220,7042.22293,1579.970237
Cell R70,4000,941,50517481.49,-1781,9823,11604,5657.919235,2406.703456
Cell R71,4000,942,50571166.38,1267,8787,7520,6546.234607,1693.389925
Cell R72,4000,940,50463796.6,418,9677,9259,5114.098936,2545.944726
Cell R73,4000,941,50517481.49,970,9950,8980,6020.165781,2429.499757
Cell R74,4000,943,50624851.27,1387,9400,8013,6899.806999,2013.646922
Cell R75,4000,948,50893275.72,5854,8786,2932,8085.617089,324.9606533
Cell R76,4000,942,50571166.38,6787,8980,2193,8269.926752,418.53453
Cell R77,4000,941,50517481.49,6445,8777,2332,8033.075452,381.0800436
Cell R8,4000,940,50463796.6,-1958,9038,10996,7387.073404,1433.907191
Cell R80,4000,947,50839590.83,-1781,9693,11474,5087.768743,2783.732086
Cell R81,4000,946,50785905.94,989,9972,8983,6593.984144,2167.876043
Cell R82,4000,940,50463796.6,418,9298,8880,4435.256383,2743.016969
Cell R83,4000,943,50624851.27,853,9571,8718,5558.186638,2702.49649
Cell R84,4000,946,50785905.94,1292,9052,7760,4985.620507,2369.29885
Cell R85,4000,941,50517481.49,1292,8939,7647,6568.623804,1954.511454
Cell R86,4000,943,50624851.27,6104,8671,2567,7778.615058,398.1382912
Cell R87,4000,943,50624851.27,7076,8732,1656,8107.283139,341.0527016
Cell R9,4000,947,50839590.83,-1958,9038,10996,7317.390707,1409.472809
Cell R90,4000,941,50517481.49,1120,8931,7811,6463.976621,2158.78847
Cell R91,4000,942,50571166.38,1336,8847,7511,7586.66879,1313.898771
Cell R92,4000,941,50517481.49,1304,9904,8600,4011.248672,2340.94879
Cell R93,4000,947,50839590.83,1499,9510,8011,7231.671595,1357.947911
Cell R97,4000,941,50517481.49,1487,9135,7648,6795.139214,1943.661556
Cell R98,4000,942,50571166.38,4787,8647,3860,7989.633758,431.9036033
Cell R99,4000,941,50517481.49,1418,8616,7198,7756.317747,893.318782
Cell S102,4000,945,50732221.05,6670,9085,2415,8218.774603,422.7579654
Cell S108,4000,941,50517481.49,6477,8903,2426,8199.532412,475.9723738
Cell S13,4000,940,50463796.6,6589,8945,2356,8000.938298,377.1121093
Cell S14,4000,942,50571166.38,5036,8935,3899,7849.876858,544.7118813
Cell S2,4000,945,50732221.05,5788,8726,2938,8000.530159,365.6161363
Cell S23,4000,941,50517481.49,6235,8741,2506,8072.05526,368.5857931
Cell S32,4000,940,50463796.6,5457,8778,3321,7945.585106,530.5389975
Cell S33,4000,941,50517481.49,6215,8739,2524,7943.191286,372.8428136
Cell S34,4000,948,50893275.72,6891,8963,2072,7997.014768,341.5932819
Cell S41,4000,940,50463796.6,6169,8727,2558,7906.217021,381.3571311
Cell S42,4000,946,50785905.94,6172,8920,2748,8302.884778,391.5953336
Cell S44,4000,942,50571166.38,6035,9061,3026,7990.140127,423.3415619
Cell S56,4000,943,50624851.27,6104,8938,2834,7736.892895,441.6386773
Cell S67,4000,943,50624851.27,5623,8875,3252,7822.679745,539.8696057
Cell S78,4000,941,50517481.49,6681,9059,2378,8361.056323,401.2103129
Cell S88,4000,944,50678536.16,6869,9041,2172,8258.455508,380.0753272
Cell S94,4000,942,50571166.38,7120,9085,1965,8300.264331,341.594617
Cell S95,4000,940,50463796.6,6670,8980,2310,8196.171277,368.3025546
W287,4000,940,50463796.6,941,8828,7887,4159.788298,1842.29853
W295,4000,942,50571166.38,1794,8785,6991,6841.742038,1475.476275
W338,4000,945,50732221.05,982,9399,8417,4774.263492,2582.683659
W342,4000,943,50624851.27,1568,8515,6947,5632.049841,2103.421993
W345,4000,942,50571166.38,3500,8481,4981,7462.264331,424.2794406
W387,4000,943,50624851.27,1121,9175,8054,5307.553552,2295.183786
W393,4000,946,50785905.94,1118,8560,7442,6367.637421,1876.832601
W440,4000,940,50463796.6,1161,7705,6544,4761.846809,1826.779339
W441,4000,940,50463796.6,4403,8144,3741,7102.746809,748.0197601
W445,4000,946,50785905.94,2669,8131,5462,6841.134249,703.6828293
W500,4000,938,50356426.82,1306,8546,7240,5987.294243,2027.270584
1,4250,1066,57228092.74,1693,8995,7302,7483.893058,822.329873
2,4250,1066,57228092.74,1796,8812,7016,6491.368668,1548.014669
3,4250,1065,57174407.85,2311,8969,6658,7791.529577,684.5084987
4,4250,1066,57228092.74,2592,8447,5855,7487.134146,934.8260114
5,4250,1061,56959668.29,-1836,8397,10233,6242.085768,1617.575021
6,4250,1067,57281777.63,1810,9287,7477,7429.929709,1462.983105
7,4250,1069,57389147.41,1868,9571,7703,7225.265669,1445.762258
8,4250,1063,57067038.07,2165,8415,6250,6791.989652,1456.957001
9,4250,1063,57067038.07,5982,8778,2796,7993.805268,453.0360348
10,4250,1067,57281777.63,713,9882,9169,6137.032802,2083.314397
11,4250,1055,56637558.95,791,8632,7841,5643.436019,2283.154382
12,4250,1058,56798613.62,1111,9418,8307,4828.838374,2268.108138
13,4250,1063,57067038.07,2206,9552,7346,7241.007526,1341.355206
14,4250,1066,57228092.74,6238,8901,2663,8079.21576,385.4295359
16,4250,1057,56744928.73,-29,9547,9576,4552.830653,2628.217684
17,4250,1066,57228092.74,1933,9565,7632,7200.074109,1027.694381
18,4250,1067,57281777.63,705,9950,9245,4458.949391,2714.752401
19,4250,1064,57120722.96,1104,8810,7706,4804.31109,2456.444763
20,4250,1065,57174407.85,5854,8786,2932,8080.524883,330.082365
21,4250,1065,57174407.85,6445,8777,2332,8063.640376,378.4877263
22,4250,1066,57228092.74,-1781,9834,11615,4899.397749,2866.965912
23,4250,1068,57335462.52,418,9298,8880,4570.761236,2741.909131
24,4250,1063,57067038.07,1336,8847,7511,7479.770461,1510.809212
25,4250,1069,57389147.41,1499,9510,8011,7227.962582,1359.876299
26,4250,1067,57281777.63,6391,8737,2346,8103.169634,353.0548626
27,4250,1063,57067038.07,3646,8647,5001,7948.843838,533.8867142
28,4250,1064,57120722.96,4477,8602,4125,7762.358083,580.8365763
29,4250,1063,57067038.07,1974,9230,7256,7662.347131,831.6633476
31,4250,1067,57281777.63,2259,8985,6726,7854.492034,694.110466
32,4250,1067,57281777.63,1681,8980,7299,6932.403936,1525.514421
33,4250,1064,57120722.96,5522,8409,2887,7232.953008,543.1731606
34,4250,1069,57389147.41,4682,8482,3800,7251.637979,617.7018869
10A,4250,1060,56905983.4,629,9882,9253,6073.769811,2207.929717
10NE,4250,1063,57067038.07,629,9882,9253,5954.449671,2367.709542
10NW,4250,1066,57228092.74,251,8869,8618,6190.445591,1921.733919
10SW,4250,1056,56691243.84,-419,9882,10301,5134.986742,2334.437308
11NE,4250,1064,57120722.96,1345,9787,8442,6855.356203,1771.362683
11NW,4250,1064,57120722.96,-92,8834,8926,5772.534774,2550.786218
11SE,4250,1068,57335462.52,956,8681,7725,6023.853933,2230.94084
17NW,4250,1067,57281777.63,655,9470,8815,6467.820993,2085.836585
17SE,4250,1067,57281777.63,1267,9959,8692,6517.388941,1735.366022
17SW,4250,1055,56637558.95,-1781,9823,11604,5575.473934,2455.252111
22S,4250,1066,57228092.74,-1781,9834,11615,4708.966229,2897.068699
23S,4250,1058,56798613.62,1350,9548,8198,3704.92344,1854.702223
24S,4250,1068,57335462.52,1336,8847,7511,7453.818352,1539.477021
27A,4250,1064,57120722.96,1487,9135,7648,6786.574248,2034.658907
2A,4250,1067,57281777.63,1668,9292,7624,6487.653233,1669.493953
5NE,4250,1068,57335462.52,-76,9736,9812,4886.231273,2308.758945
5NW,4250,1066,57228092.74,-1836,9736,11572,5647.307692,2187.04053
5SE,4250,1062,57013353.18,649,9804,9155,3755.935028,2402.141037
6NE,4250,1066,57228092.74,1796,9050,7254,7161.201689,1610.089212
6NW,4250,1068,57335462.52,1065,9253,8188,6306.264045,2373.867614
6SW,4250,1063,57067038.07,1036,9287,8251,6719.546566,2217.559166
Cell 1 2011/12,4250,1066,57228092.74,1693,8995,7302,7483.893058,822.329873
Cell 1 SW 2013,4250,1061,56959668.29,-1428,8335,9763,5138.950047,2023.697858
Cell 10 2011/12,4250,1067,57281777.63,713,9882,9169,6137.032802,2083.314397
Cell 10 NE 2011/12,4250,1063,57067038.07,629,9882,9253,5954.449671,2367.709542
Cell 10 NW 2011/12,4250,1066,57228092.74,251,8869,8618,6190.445591,1921.733919
Cell 10 SE 2013,4250,1068,57335462.52,1065,9253,8188,6306.264045,2373.867614
Cell 10 SW 2011/12,4250,1056,56691243.84,-419,9882,10301,5134.986742,2334.437308
Cell 10-A 2011/12,4250,1060,56905983.4,629,9882,9253,6073.769811,2207.929717
Cell 11 NE 2011/12,4250,1064,57120722.96,1345,9787,8442,6855.356203,1771.362683
Cell 11 NW 2013,4250,1065,57174407.85,1796,9292,7496,6496.589671,1649.279312
Cell 11 SW 2013,4250,1065,57174407.85,1796,9287,7491,7437.58216,1584.563507
Cell 12 2013,4250,1067,57281777.63,1868,9571,7703,7228.371134,1446.628081
Cell 13 2013,4250,1063,57067038.07,1872,8415,6543,6731.11571,1534.136856
Cell 14 2013,4250,1064,57120722.96,6867,8733,1866,7931.924812,348.7879416
Cell 15 2013,4250,1067,57281777.63,6718,8739,2021,7954.130272,366.6964286
Cell 15-A 2013,4250,1063,57067038.07,6215,8739,2524,7954.912512,385.2466057
Cell 16 2013,4250,1067,57281777.63,6215,8963,2748,7941.162137,393.0824727
Cell 17 NW 2011/12,4250,1067,57281777.63,655,9470,8815,6467.820993,2085.836585
Cell 17 NW 2013,4250,1065,57174407.85,-1836,9736,11572,5933.950235,1897.897588
Cell 17 SE 2013,4250,1065,57174407.85,251,8869,8618,6194.570892,1917.912307
Cell 17 SW 2013,4250,1061,56959668.29,-1836,8397,10233,6234.874647,1623.973112
Cell 18 2011/12,4250,1067,57281777.63,705,9950,9245,4458.949391,2714.752401
Cell 18 NE 2013,4250,1063,57067038.07,1036,9287,8251,6703.322672,2244.98953
Cell 18 NW 2013,4250,1068,57335462.52,649,9804,9155,3676.914794,2353.368746
Cell 18 SE 2013,4250,1065,57174407.85,1345,9787,8442,6855.076056,1770.554444
Cell 18 SSE 2013,4250,1068,57335462.52,-92,8783,8875,5741.679775,2479.17168
Cell 19 NW 2013,4250,1067,57281777.63,1254,9287,8033,7551.024367,1437.277739
Cell 2 2011/12,4250,1066,57228092.74,1796,8812,7016,6491.368668,1548.014669
Cell 2 NE 2013,4250,1067,57281777.63,-1954,9266,11220,6627.008435,1814.076259
Cell 2 SW 2013,4250,1067,57281777.63,1693,8995,7302,7484.935333,821.4845561
Cell 20 2013,4250,1065,57174407.85,1536,9548,8012,7175.377465,1622.004724
Cell 21 2013,4250,1066,57228092.74,2206,8914,6708,7440.302064,1165.5494
Cell 22 2013,4250,1065,57174407.85,5845,8903,3058,7958.394366,474.1511955
Cell 23 2013,4250,1070,57442832.3,6084,8920,2836,8283.585981,411.2314236
Cell 24 2013,4250,1069,57389147.41,6871,8963,2092,7992.532273,346.6884311
Cell 25 NE 2013,4250,1067,57281777.63,713,9882,9169,6137.032802,2083.314397
Cell 25 SE 2013,4250,1056,56691243.84,-419,9882,10301,5134.986742,2334.437308
Cell 26 NE 2013,4250,1055,56637558.95,791,8632,7841,5643.436019,2283.154382
Cell 26 NNW 2013,4250,1062,57013353.18,629,9882,9253,5957.80226,2366.300758
Cell 26 NW 2013,4250,1061,56959668.29,629,9882,9253,6069.581527,2211.097733
Cell 27 NW 2013,4250,1068,57335462.52,956,8681,7725,6023.853933,2230.94084
Cell 28 2013,4250,1058,56798613.62,1111,9418,8307,4828.838374,2268.108138
Cell 29 2013,4250,1063,57067038.07,2206,9552,7346,7240.623706,1341.366313
Cell 3 NE 2013,4250,1067,57281777.63,-1958,9038,10996,7300.096532,1429.395504
Cell 3 NW 2013,4250,1067,57281777.63,-1954,9266,11220,6963.147142,1609.858426
Cell 30 2013,4250,1069,57389147.41,6794,8967,2173,8112.762395,354.3854397
Cell 31 2013,4250,1062,57013353.18,5717,8901,3184,8093.22693,408.5457148
Cell 32 2013,4250,1066,57228092.74,5623,8938,3315,7833.484053,535.3191209
Cell 33 NE 2013,4250,1067,57281777.63,655,9470,8815,6467.820993,2085.836585
Cell 33 SE 2013,4250,1058,56798613.62,-1781,9823,11604,5567.375236,2461.571293
Cell 33 SW 2013,4250,1064,57120722.96,-147,9547,9694,4440.075188,2677.330183
Cell 34 N 2013,4250,1066,57228092.74,1022,8852,7830,6792.461538,1657.331795
Cell 34 NW 2013,4250,1067,57281777.63,1933,9565,7632,7200.620431,1027.367544
Cell 34 SE 2013,4250,1065,57174407.85,1267,9959,8692,6522.279812,1730.851199
Cell 35 2013,4250,1068,57335462.52,705,9950,9245,4710.383895,2726.158963
Cell 37 2013,4250,1066,57228092.74,5854,8786,2932,8078.888368,332.8168787
Cell 38 2013,4250,1061,56959668.29,6445,8777,2332,8064.29312,379.9830393
Cell 39 2013,4250,1066,57228092.74,6533,9081,2548,8364.257036,410.0749206
Cell 4 2013,4250,1067,57281777.63,6081,8536,2455,7803.450797,324.9069626
Cell 40 NE 2013,4250,1068,57335462.52,-1781,9823,11604,5044.458801,2776.497148
Cell 41 N 2013,4250,1058,56798613.62,-1781,9972,11753,6782.481096,2118.558942
Cell 41 NW 2013,4250,1066,57228092.74,-1781,9972,11753,5818.65666,2739.143744
Cell 42 NW 2013,4250,1061,56959668.29,418,9298,8880,4528.163054,2738.776663
Cell 43 2013,4250,1055,56637558.95,1292,9070,7778,6574.165877,1974.823928
Cell 44 2013,4250,1058,56798613.62,5854,8671,2817,7859.398866,466.1289583
Cell 45 2013,4250,1068,57335462.52,6391,8737,2346,8103.397004,352.9676828
Cell 47 2013,4250,1065,57174407.85,1120,8956,7836,6434.688263,2181.583203
Cell 48 2013,4250,1067,57281777.63,1336,8847,7511,7453.281162,1540.098203
Cell 49 2013,4250,1069,57389147.41,1499,9510,8011,7227.962582,1359.876299
Cell 5 2011/12 Summer,4250,1061,56959668.29,-1836,8397,10233,6234.874647,1623.973112
Cell 5 2013,4250,1069,57389147.41,6705,8750,2045,7959.565014,369.0006486
Cell 50 2013,4250,1063,57067038.07,1974,9230,7256,7662.347131,831.6633476
Cell 51 2013,4250,1058,56798613.62,6670,8980,2310,8207.750473,368.0673817
Cell 52 2013,4250,1064,57120722.96,1415,8616,7201,7705.488722,1027.851985
Cell 53 2013,4250,1064,57120722.96,4477,8602,4125,7762.358083,580.8365763
Cell 54 2013,4250,1068,57335462.52,5568,8970,3402,8083.902622,639.4380256
Cell 55 2013,4250,1064,57120722.96,6477,8903,2426,8191.179511,488.6102652
Cell 56 2013,4250,1060,56905983.4,5522,8409,2887,7233.341509,543.1420332
Cell 57 2013,4250,1066,57228092.74,1681,8980,7299,6931.296435,1525.800977
Cell 58 2013,4250,1066,57228092.74,6660,8912,2252,8382.483114,328.4418616
Cell 59 2013,4250,1068,57335462.52,5522,8448,2926,7344.088015,442.2364614
Cell 6 2011/12,4250,1067,57281777.63,1810,9287,7477,7429.929709,1462.983105
Cell 6 2013,4250,1067,57281777.63,5788,8726,2938,8008.702905,358.779793
Cell 6 NE 2011/12,4250,1066,57228092.74,1796,9050,7254,7161.201689,1610.089212
Cell 6 NW 2011/12,4250,1068,57335462.52,1065,9253,8188,6306.264045,2373.867614
Cell 6 SW 2011/12,4250,1063,57067038.07,1036,9287,8251,6719.546566,2217.559166
Cell 60 2013,4250,1062,57013353.18,4246,8482,4236,7335.193974,604.2284305
Cell 61 2013,4250,1067,57281777.63,3582,8736,5154,7615.484536,810.5518863
Cell 7 2013,4250,1056,56691243.84,5036,8935,3899,7851.755682,542.9323816
Cell 9 NW 2013,4250,1067,57281777.63,-76,9550,9626,5235.108716,2275.622947
Cell 9 SE 2013,4250,1067,57281777.63,-76,9736,9812,4883.963449,2308.651288
Cell 9 SW 2013,4250,1066,57228092.74,-1836,9736,11572,5651.153846,2176.342119
Cell R1,4250,1066,57228092.74,1239,8197,6958,5839.865854,2004.365956
Cell R10,4250,1067,57281777.63,6081,8536,2455,7803.450797,324.9069626
Cell R100,4250,1064,57120722.96,1974,9230,7256,7662.673872,831.340694
Cell R101,4250,1068,57335462.52,5543,8748,3205,8026.765918,430.021835
Cell R104,4250,1067,57281777.63,1301,9468,8167,7288.304592,1874.369719
Cell R105,4250,1064,57120722.96,4477,8602,4125,7762.358083,580.8365763
Cell R106,4250,1068,57335462.52,1520,9524,8004,7240.72191,1511.463902
Cell R107,4250,1068,57335462.52,5568,8970,3402,8083.902622,639.4380256
Cell R11,4250,1070,57442832.3,6705,8750,2045,7959.684112,368.8487333
Cell R111,4250,1066,57228092.74,1562,9468,7906,7107.974672,2058.283129
Cell R112,4250,1066,57228092.74,6656,8688,2032,8044.636023,329.1723899
Cell R113,4250,1067,57281777.63,1681,8980,7299,6931.076851,1525.102665
Cell R114,4250,1067,57281777.63,6660,8912,2252,8382.303655,328.3402006
Cell R117,4250,1068,57335462.52,1430,9074,7644,6931.245318,1324.075109
Cell R118,4250,1058,56798613.62,5522,8409,2887,7234.563327,542.4096627
Cell R119,4250,1068,57335462.52,1681,8447,6766,6663.176966,1400.744336
Cell R120,4250,1070,57442832.3,2412,8655,6243,7598.735514,884.8011066
Cell R121,4250,1063,57067038.07,6617,8799,2182,8094.822201,375.4855162
Cell R123,4250,1066,57228092.74,2269,9542,7273,7512.319887,615.8141074
Cell R124,4250,1066,57228092.74,3730,8546,4816,7303.974672,665.1779927
Cell R125,4250,1059,56852298.51,1894,8780,6886,6766.431539,1267.048662
Cell R126,4250,1064,57120722.96,3582,8655,5073,7475.841165,827.6688219
Cell R15,4250,1060,56905983.4,-1428,8335,9763,5141.091509,2023.450262
Cell R16,4250,1065,57174407.85,-76,9550,9626,5240.071362,2271.767124
Cell R17,4250,1065,57174407.85,1371,9057,7686,7191.604695,1490.825882
Cell R18,4250,1058,56798613.62,1796,9292,7496,6479.389414,1655.19147
Cell R19,4250,1068,57335462.52,1635,8969,7334,7270.095506,1647.7577
Cell R20,4250,1067,57281777.63,2900,8536,5636,7553.88941,855.8779414
Cell R21,4250,1065,57174407.85,4576,8730,4154,7653.779343,506.8993003
Cell R22,4250,1064,57120722.96,6867,8733,1866,7931.924812,348.7879416
Cell R24,4250,1065,57174407.85,-1836,9736,11572,5933.950235,1897.897588
Cell R25,4250,1068,57335462.52,649,9804,9155,3676.914794,2353.368746
Cell R26,4250,1064,57120722.96,1065,9253,8188,6303.921992,2368.865351
Cell R27,4250,1067,57281777.63,1254,9287,8033,7551.024367,1437.277739
Cell R28,4250,1064,57120722.96,1373,9571,8198,6351.711466,2150.042307
Cell R29,4250,1065,57174407.85,1536,9548,8012,7177.633803,1621.649952
Cell R30,4250,1063,57067038.07,3078,8644,5566,7476.067733,759.991789
Cell R31,4250,1061,56959668.29,4978,8727,3749,7821.191329,487.5743073
Cell R35,4250,1061,56959668.29,-1836,8397,10233,6234.874647,1623.973112
Cell R36,4250,1066,57228092.74,251,8869,8618,6190.445591,1921.733919
Cell R37,4250,1064,57120722.96,1345,9787,8442,6855.356203,1771.362683
Cell R38,4250,1055,56637558.95,1415,9787,8372,6402.966825,2181.037402
Cell R39,4250,1069,57389147.41,1810,8970,7160,7155.580917,1350.578662
Cell R40,4250,1066,57228092.74,2206,8914,6708,7440.302064,1165.5494
Cell R46,4250,1063,57067038.07,-476,9882,10358,5321.269991,2469.294188
Cell R47,4250,1059,56852298.51,629,9882,9253,6074.863078,2208.685139
Cell R48,4250,1056,56691243.84,791,8632,7841,5638.925189,2286.771584
Cell R49,4250,1067,57281777.63,956,8681,7725,6022.240862,2231.363411
Cell R5,4250,1068,57335462.52,-1428,8335,9763,5513.928839,1888.376507
Cell R50,4250,1058,56798613.62,1111,9418,8307,4828.838374,2268.108138
Cell R51,4250,1063,57067038.07,2206,9552,7346,7238.840075,1344.01267
Cell R52,4250,1062,57013353.18,2213,8860,6647,7543.419021,951.398795
Cell R53,4250,1068,57335462.52,4412,8779,4367,7758.083333,519.6628693
Cell R54,4250,1061,56959668.29,5717,8901,3184,8094.162111,407.6004518
Cell R58,4250,1067,57281777.63,-908,9470,10378,4222.878163,2435.71065
Cell R59,4250,1067,57281777.63,655,9470,8815,6467.820993,2085.836585
Cell R6,4250,1067,57281777.63,1693,8995,7302,7484.935333,821.4845561
Cell R60,4250,1066,57228092.74,1933,9565,7632,7199.964353,1027.625869
Cell R61,4250,1068,57335462.52,705,9950,9245,4710.383895,2726.158963
Cell R62,4250,1066,57228092.74,1104,8810,7706,4748.602251,2451.559522
Cell R63,4250,1066,57228092.74,1205,8912,7707,6864.990619,1670.368232
Cell R64,4250,1062,57013353.18,4051,8585,4534,7920.02919,438.4133717
Cell R65,4250,1068,57335462.52,6794,8967,2173,8113.083333,354.3959988
Cell R66,4250,1058,56798613.62,6337,8967,2630,8374.203214,439.3605438
Cell R69,4250,1065,57174407.85,-147,9547,9694,4443.874178,2678.940518
Cell R7,4250,1067,57281777.63,-1954,9266,11220,6963.147142,1609.858426
Cell R70,4250,1057,56744928.73,-1781,9823,11604,5571.796594,2458.532813
Cell R71,4250,1065,57174407.85,1267,9959,8692,6522.279812,1730.851199
Cell R72,4250,1067,57281777.63,418,9677,9259,5142.014058,2545.845526
Cell R73,4250,1061,56959668.29,586,9950,9364,5793.081056,2517.569275
Cell R74,4250,1067,57281777.63,1387,9400,8013,6885.932521,2008.297469
Cell R75,4250,1066,57228092.74,5854,8786,2932,8078.888368,332.8168787
Cell R76,4250,1058,56798613.62,6787,8980,2193,8265.18242,416.0138728
Cell R77,4250,1061,56959668.29,6445,8777,2332,8064.29312,379.9830393
Cell R8,4250,1062,57013353.18,-1958,9038,10996,7353.832392,1409.36753
Cell R80,4250,1067,57281777.63,-1781,9823,11604,5046.854733,2776.694157
Cell R81,4250,1067,57281777.63,989,9972,8983,6487.370197,2242.759376
Cell R82,4250,1061,56959668.29,418,9298,8880,4528.163054,2738.776663
Cell R83,4250,1063,57067038.07,853,9571,8718,5536.546566,2672.096467
Cell R84,4250,1068,57335462.52,1292,9652,8360,5033.581461,2380.212044
Cell R85,4250,1055,56637558.95,1292,9070,7778,6574.165877,1974.823928
Cell R86,4250,1067,57281777.63,6104,8671,2567,7792.841612,397.4960784
Cell R87,4250,1067,57281777.63,6391,8737,2346,8103.169634,353.0548626
Cell R9,4250,1068,57335462.52,-1958,9038,10996,7313.819288,1380.671975
Cell R90,4250,1066,57228092.74,1120,8956,7836,6432.933396,2181.311615
Cell R91,4250,1067,57281777.63,1336,8847,7511,7453.281162,1540.098203
Cell R92,4250,1065,57174407.85,1304,9904,8600,4078.202817,2320.333058
Cell R93,4250,1068,57335462.52,1499,9510,8011,7227.348315,1360.36455
Cell R97,4250,1063,57067038.07,1487,9152,7665,6838.765757,1927.995856
Cell R98,4250,1062,57013353.18,3646,8647,5001,7948.707156,534.1194241
Cell R99,4250,1064,57120722.96,1415,8616,7201,7705.488722,1027.851985
Cell S102,4250,1067,57281777.63,6614,9085,2471,8208.46298,425.959858
Cell S108,4250,1064,57120722.96,6477,8903,2426,8191.179511,488.6102652
Cell S13,4250,1066,57228092.74,6589,8945,2356,8003.042214,370.7656738
Cell S14,4250,1058,56798613.62,5036,8935,3899,7850.522684,543.3782777
Cell S2,4250,1067,57281777.63,5788,8726,2938,8008.702905,358.779793
Cell S23,4250,1063,57067038.07,6149,8741,2592,8048.733772,390.6976509
Cell S32,4250,1065,57174407.85,4978,8903,3925,7935.807512,535.518945
Cell S33,4250,1062,57013353.18,6215,8739,2524,7954.69774,385.3643273
Cell S34,4250,1068,57335462.52,6871,8963,2092,7992.565543,346.8489947
Cell S41,4250,1065,57174407.85,5404,8727,3323,7904.710798,404.8153986
Cell S42,4250,1070,57442832.3,6084,8920,2836,8283.585981,411.2314236
Cell S44,4250,1063,57067038.07,6035,9061,3026,8001.815616,428.9793087
Cell S56,4250,1067,57281777.63,5837,8938,3101,7727.907216,460.4930651
Cell S67,4250,1066,57228092.74,5623,8938,3315,7833.484053,535.3191209
Cell S78,4250,1067,57281777.63,6533,9081,2548,8364.573571,410.0129824
Cell S88,4250,1065,57174407.85,6869,9041,2172,8256.039437,385.9370164
Cell S94,4250,1063,57067038.07,7120,9085,1965,8296.654751,340.5835708
Cell S95,4250,1058,56798613.62,6670,8980,2310,8207.750473,368.0673817
W287,4250,1062,57013353.18,941,8828,7887,4138.359699,1889.634988
W295,4250,1067,57281777.63,1785,8785,7000,6831.987816,1511.530296
W338,4250,1067,57281777.63,982,9399,8417,4611.787254,2593.601612
W342,4250,1068,57335462.52,1511,8515,7004,5588.554307,2137.674906
W345,4250,1063,57067038.07,3500,8481,4981,7481.829727,423.2452527
W387,4250,1065,57174407.85,1121,9470,8349,5347.242254,2300.661996
W393,4250,1064,57120722.96,1118,8560,7442,6268.307331,1937.390478
W440,4250,1061,56959668.29,1161,7936,6775,4765.303487,1880.472415
W441,4250,1062,57013353.18,3680,8144,4464,7064.13936,768.0324443
W445,4250,1067,57281777.63,2669,8212,5543,6812.462043,763.0060938
W500,4250,1065,57174407.85,1306,8546,7240,6048.893897,1973.106316
1,4500,1194,64099758.66,1518,8995,7477,7398.050251,991.2767206
2,4500,1199,64368183.11,1796,9292,7496,6419.539616,1610.953075
3,4500,1192,63992388.88,1780,9270,7490,7721.95302,846.7312699
4,4500,1192,63992388.88,2592,8536,5944,7493.754195,969.0024601
5,4500,1190,63885019.1,-1836,8397,10233,6229.178151,1629.928755
6,4500,1195,64153443.55,1647,9287,7640,7303.550628,1615.203562
7,4500,1196,64207128.44,1868,9571,7703,7164.187291,1532.697536
8,4500,1194,64099758.66,1872,8415,6543,6828.645729,1479.486271
9,4500,1191,63938703.99,5930,8778,2848,7973.853065,469.2946145
10,4500,1195,64153443.55,631,9882,9251,6029.31046,2156.788289
11,4500,1190,63885019.1,278,8632,8354,5547.768908,2304.743719
12,4500,1188,63777649.32,1111,9418,8307,4682.829125,2283.656008
13,4500,1194,64099758.66,2041,9552,7511,7183.046064,1393.621221
14,4500,1195,64153443.55,6238,8901,2663,8081.389121,383.9029951
16,4500,1192,63992388.88,-147,9547,9694,4599.221477,2662.292129
17,4500,1195,64153443.55,1933,9565,7632,7106.224268,1203.612881
18,4500,1196,64207128.44,705,9950,9245,4509.684783,2700.9653
19,4500,1192,63992388.88,1104,8912,7808,4843.495805,2456.84855
20,4500,1189,63831334.21,5854,8786,2932,8072.405383,337.2160708
21,4500,1197,64260813.33,6445,8789,2344,8093.492899,378.7565983
22,4500,1195,64153443.55,-1781,9972,11753,4904.825941,2891.13284
23,4500,1199,64368183.11,418,9298,8880,4711.645538,2741.607678
24,4500,1192,63992388.88,1175,8847,7672,7354.333893,1687.121861
25,4500,1198,64314498.22,1499,9510,8011,7221.449082,1369.542287
26,4500,1196,64207128.44,6391,8737,2346,8099.999164,360.3370855
27,4500,1193,64046073.77,1543,8762,7219,7868.828164,809.9114963
28,4500,1193,64046073.77,2005,8602,6597,7698.538139,760.9573659
29,4500,1193,64046073.77,1974,9692,7718,7607.311819,956.3607536
31,4500,1197,64260813.33,1816,8985,7169,7821.849624,832.3685799
32,4500,1195,64153443.55,1681,8980,7299,6952.83682,1506.667613
33,4500,1194,64099758.66,5522,8409,2887,7240.592965,555.6578534
34,4500,1196,64207128.44,3678,8482,4804,7212.372074,681.1659254
10A,4500,1192,63992388.88,44,9882,9838,5938.244966,2273.717639
10NE,4500,1190,63885019.1,463,9882,9419,5820.388235,2430.549613
10NW,4500,1188,63777649.32,251,8869,8618,5992.497475,2083.804385
10SW,4500,1189,63831334.21,-476,9882,10358,5187.37931,2366.885596
11NE,4500,1197,64260813.33,264,9787,9523,6790.863826,1867.31001
11NW,4500,1192,63992388.88,-92,8834,8926,5701.080537,2559.066927
11SE,4500,1194,64099758.66,956,8734,7778,5960.242044,2258.528145
17NW,4500,1193,64046073.77,655,9470,8815,6414.336966,2089.625891
17SE,4500,1193,64046073.77,457,9959,9502,6481.838223,1779.220027
17SW,4500,1190,63885019.1,-1781,9823,11604,5436.820168,2514.8016
22S,4500,1190,63885019.1,-1781,9834,11615,4714.537815,2893.510253
23S,4500,1188,63777649.32,1335,9548,8213,3741.978114,1901.592787
24S,4500,1193,64046073.77,1175,8847,7672,7358.544007,1675.535806
27A,4500,1193,64046073.77,1487,9135,7648,6847.664711,2000.814252
2A,4500,1196,64207128.44,1668,9292,7624,6473.126254,1676.003564
5NE,4500,1194,64099758.66,-76,9736,9812,4785.200168,2306.617059
5NW,4500,1197,64260813.33,-1836,9736,11572,5598.658312,2211.223227
5SE,4500,1193,64046073.77,649,9804,9155,3763.584241,2391.779747
6NE,4500,1196,64207128.44,1796,9050,7254,7177.940635,1592.187757
6NW,4500,1196,64207128.44,1065,9253,8188,6174.638796,2458.117123
6SW,4500,1193,64046073.77,1036,9287,8251,6708.50964,2180.512656
Cell 1 2011/12,4500,1194,64099758.66,1518,8995,7477,7398.050251,991.2767206
Cell 1 SW 2013,4500,1194,64099758.66,-1428,9210,10638,5117.948074,2048.968463
Cell 10 2011/12,4500,1195,64153443.55,631,9882,9251,6029.31046,2156.788289
Cell 10 NE 2011/12,4500,1190,63885019.1,463,9882,9419,5820.388235,2430.549613
Cell 10 NW 2011/12,4500,1188,63777649.32,251,8869,8618,5992.497475,2083.804385
Cell 10 SE 2013,4500,1196,64207128.44,1065,9253,8188,6174.638796,2458.117123
Cell 10 SW 2011/12,4500,1189,63831334.21,-476,9882,10358,5187.37931,2366.885596
Cell 10-A 2011/12,4500,1192,63992388.88,44,9882,9838,5938.244966,2273.717639
Cell 11 NE 2011/12,4500,1197,64260813.33,264,9787,9523,6790.863826,1867.31001
Cell 11 NW 2013,4500,1191,63938703.99,1796,9292,7496,6493.140218,1652.54152
Cell 11 SW 2013,4500,1190,63885019.1,1254,9287,8033,7329.883193,1676.384452
Cell 12 2013,4500,1192,63992388.88,1868,9571,7703,7163.843121,1535.113601
Cell 13 2013,4500,1189,63831334.21,1872,8415,6543,6764.811606,1552.517183
Cell 14 2013,4500,1193,64046073.77,6867,8733,1866,7933.878458,352.5599274
Cell 15 2013,4500,1195,64153443.55,6215,8739,2524,7940.661088,375.4029888
Cell 15-A 2013,4500,1193,64046073.77,6215,8791,2576,7964.20285,389.9874296
Cell 16 2013,4500,1193,64046073.77,6215,8963,2748,7943.129086,399.015654
Cell 17 NW 2011/12,4500,1193,64046073.77,655,9470,8815,6414.336966,2089.625891
Cell 17 NW 2013,4500,1195,64153443.55,-1836,9736,11572,5906.109623,1933.06307
Cell 17 SE 2013,4500,1188,63777649.32,251,8869,8618,5992.497475,2083.804385
Cell 17 SW 2013,4500,1194,64099758.66,-1836,8397,10233,6225.997487,1631.479552
Cell 18 2011/12,4500,1196,64207128.44,705,9950,9245,4509.684783,2700.9653
Cell 18 NE 2013,4500,1193,64046073.77,1036,9287,8251,6718.577536,2198.780008
Cell 18 NW 2013,4500,1195,64153443.55,649,9804,9155,3713.39749,2359.588739
Cell 18 SE 2013,4500,1196,64207128.44,264,9787,9523,6791.26505,1868.038919
Cell 18 SSE 2013,4500,1195,64153443.55,-92,8783,8875,5659.061088,2499.052885
Cell 19 NW 2013,4500,1194,64099758.66,1254,9287,8033,7381.036851,1645.976728
Cell 2 2011/12,4500,1199,64368183.11,1796,9292,7496,6419.539616,1610.953075
Cell 2 NE 2013,4500,1189,63831334.21,-1954,9266,11220,6651.345669,1770.543653
Cell 2 SW 2013,4500,1194,64099758.66,1518,8995,7477,7399.30067,989.7502642
Cell 20 2013,4500,1192,63992388.88,1474,9548,8074,7086.437919,1705.95035
Cell 21 2013,4500,1191,63938703.99,2206,8970,6764,7470.195634,1137.119493
Cell 22 2013,4500,1193,64046073.77,5845,8903,3058,7968.905281,475.3253849
Cell 23 2013,4500,1196,64207128.44,6084,8920,2836,8266.851171,426.0613989
Cell 24 2013,4500,1197,64260813.33,6790,8963,2173,7985.177109,354.367933
Cell 25 NE 2013,4500,1195,64153443.55,631,9882,9251,6029.31046,2156.788289
Cell 25 SE 2013,4500,1188,63777649.32,-476,9882,10358,5185.489899,2366.985098
Cell 26 NE 2013,4500,1190,63885019.1,278,8632,8354,5547.768908,2304.743719
Cell 26 NNW 2013,4500,1190,63885019.1,463,9882,9419,5820.388235,2430.549613
Cell 26 NW 2013,4500,1191,63938703.99,44,9882,9838,5941.916877,2271.136493
Cell 27 NW 2013,4500,1194,64099758.66,956,8734,7778,5960.242044,2258.528145
Cell 28 2013,4500,1188,63777649.32,1111,9418,8307,4682.829125,2283.656008
Cell 29 2013,4500,1192,63992388.88,2041,9552,7511,7183.564597,1393.762286
Cell 3 NE 2013,4500,1195,64153443.55,-1958,9038,10996,7307.933891,1387.265983
Cell 3 NW 2013,4500,1194,64099758.66,-1954,9266,11220,6929.345059,1620.646195
Cell 30 2013,4500,1197,64260813.33,6794,8980,2186,8117.99081,363.646246
Cell 31 2013,4500,1194,64099758.66,5717,8921,3204,8105.782245,407.3641581
Cell 32 2013,4500,1191,63938703.99,5623,8938,3315,7846.820319,535.3971317
Cell 33 NE 2013,4500,1193,64046073.77,655,9470,8815,6414.336966,2089.625891
Cell 33 SE 2013,4500,1191,63938703.99,-1781,9823,11604,5434.361041,2515.176608
Cell 33 SW 2013,4500,1190,63885019.1,-147,9547,9694,4492.37563,2711.073812
Cell 34 N 2013,4500,1190,63885019.1,1022,8852,7830,6737.10084,1741.009215
Cell 34 NW 2013,4500,1195,64153443.55,1933,9565,7632,7106.224268,1203.612881
Cell 34 SE 2013,4500,1193,64046073.77,457,9959,9502,6482.735122,1779.211313
Cell 35 2013,4500,1199,64368183.11,705,9950,9245,4689.876564,2709.538306
Cell 37 2013,4500,1196,64207128.44,5854,8786,2932,8071.600334,337.0607373
Cell 38 2013,4500,1197,64260813.33,6445,8789,2344,8096.063492,380.4040691
Cell 39 2013,4500,1191,63938703.99,6412,9081,2669,8365.874895,415.7623231
Cell 4 2013,4500,1195,64153443.55,6081,8536,2455,7808.729707,330.1945384
Cell 40 NE 2013,4500,1198,64314498.22,-1781,9823,11604,5001.77212,2762.631717
Cell 41 N 2013,4500,1194,64099758.66,-1781,9972,11753,6666.985762,2177.299188
Cell 41 NW 2013,4500,1195,64153443.55,-1781,9972,11753,5775.430126,2748.220367
Cell 42 NW 2013,4500,1195,64153443.55,418,9298,8880,4669.752301,2733.950539
Cell 43 2013,4500,1188,63777649.32,1292,9070,7778,6576.314815,1984.518455
Cell 44 2013,4500,1193,64046073.77,5854,8671,2817,7851.294216,468.4610639
Cell 45 2013,4500,1193,64046073.77,6391,8737,2346,8101.207879,360.1834268
Cell 47 2013,4500,1190,63885019.1,1029,8956,7927,6476.567227,2190.854034
Cell 48 2013,4500,1195,64153443.55,1175,8847,7672,7340.233473,1701.839668
Cell 49 2013,4500,1199,64368183.11,1499,9510,8011,7220.044204,1369.834372
Cell 5 2011/12 Summer,4500,1192,63992388.88,-1836,8397,10233,6228.048658,1630.368253
Cell 5 2013,4500,1196,64207128.44,6017,8750,2733,7964.566054,375.5201318
Cell 50 2013,4500,1193,64046073.77,1974,9692,7718,7607.311819,956.3607536
Cell 51 2013,4500,1188,63777649.32,6670,8980,2310,8220.329125,361.3765376
Cell 52 2013,4500,1189,63831334.21,1415,8638,7223,7642.705635,1184.222342
Cell 53 2013,4500,1193,64046073.77,2005,8602,6597,7698.538139,760.9573659
Cell 54 2013,4500,1196,64207128.44,5568,8970,3402,8070.658863,645.5898698
Cell 55 2013,4500,1194,64099758.66,6477,8903,2426,8186.58794,494.2201607
Cell 56 2013,4500,1194,64099758.66,5522,8409,2887,7239.813233,555.1318972
Cell 57 2013,4500,1198,64314498.22,1681,8980,7299,6950.381469,1505.455887
Cell 58 2013,4500,1195,64153443.55,6153,8912,2759,8363.373222,357.6013483
Cell 59 2013,4500,1197,64260813.33,5522,9079,3557,7351.919799,458.6016233
Cell 6 2011/12,4500,1195,64153443.55,1647,9287,7640,7303.550628,1615.203562
Cell 6 2013,4500,1196,64207128.44,5788,8726,2938,8012.801839,357.3013119
Cell 6 NE 2011/12,4500,1196,64207128.44,1796,9050,7254,7177.940635,1592.187757
Cell 6 NW 2011/12,4500,1196,64207128.44,1065,9253,8188,6174.638796,2458.117123
Cell 6 SW 2011/12,4500,1193,64046073.77,1036,9287,8251,6708.50964,2180.512656
Cell 60 2013,4500,1196,64207128.44,3998,8482,4484,7292.523411,671.5126179
Cell 61 2013,4500,1199,64368183.11,3582,8736,5154,7623.413678,803.1001861
Cell 7 2013,4500,1190,63885019.1,5036,8935,3899,7852.489916,537.5968698
Cell 9 NW 2013,4500,1194,64099758.66,-76,9550,9626,5089.213568,2308.188646
Cell 9 SE 2013,4500,1194,64099758.66,-76,9736,9812,4785.200168,2306.617059
Cell 9 SW 2013,4500,1197,64260813.33,-1836,9736,11572,5599.46533,2211.701621
Cell R1,4500,1201,64475552.89,1239,8226,6987,5828.858451,2008.119685
Cell R10,4500,1193,64046073.77,6081,8536,2455,7807.760268,329.4481395
Cell R100,4500,1193,64046073.77,1974,9692,7718,7607.311819,956.3607536
Cell R101,4500,1195,64153443.55,5543,8816,3273,8026.864435,442.1136396
Cell R104,4500,1192,63992388.88,1301,9468,8167,7192.14849,1987.055982
Cell R105,4500,1194,64099758.66,1581,8602,7021,7693.414573,780.9535853
Cell R106,4500,1196,64207128.44,1520,9524,8004,7286.869565,1488.112932
Cell R107,4500,1195,64153443.55,5568,8970,3402,8070.279498,645.7266677
Cell R11,4500,1196,64207128.44,6017,8750,2733,7964.566054,375.5201318
Cell R111,4500,1191,63938703.99,1562,9468,7906,7079.145256,2073.860551
Cell R112,4500,1195,64153443.55,6535,8688,2153,8031.035146,344.4154159
Cell R113,4500,1200,64421868,1681,8980,7299,6949.949167,1504.254993
Cell R114,4500,1196,64207128.44,6153,8912,2759,8363.116221,357.5622064
Cell R117,4500,1196,64207128.44,1430,9074,7644,6838.338629,1481.750794
Cell R118,4500,1194,64099758.66,5522,8409,2887,7239.813233,555.1318972
Cell R119,4500,1193,64046073.77,1681,8454,6773,6676.274937,1434.293343
Cell R120,4500,1201,64475552.89,2412,8655,6243,7560.033306,918.1053467
Cell R121,4500,1195,64153443.55,6617,8799,2182,8098.20251,380.8525857
Cell R123,4500,1191,63938703.99,1737,9542,7805,7453.968934,772.5120863
Cell R124,4500,1193,64046073.77,3203,8555,5352,7276.437552,740.7032903
Cell R125,4500,1192,63992388.88,1894,8780,6886,6789.286913,1247.277297
Cell R126,4500,1194,64099758.66,3582,8655,5073,7507.829983,811.7442469
Cell R15,4500,1194,64099758.66,-1428,9210,10638,5117.948074,2048.968463
Cell R16,4500,1196,64207128.44,-76,9550,9626,5076.758361,2313.822502
Cell R17,4500,1192,63992388.88,1371,9147,7776,7141.395973,1564.683619
Cell R18,4500,1184,63562909.76,1796,9292,7496,6467.6875,1662.873372
Cell R19,4500,1197,64260813.33,1635,9498,7863,7203.896408,1720.197579
Cell R20,4500,1193,64046073.77,2592,8536,5944,7527.10394,929.6552196
Cell R21,4500,1192,63992388.88,2706,8733,6027,7633.846477,631.1269422
Cell R22,4500,1193,64046073.77,6867,8733,1866,7933.878458,352.5599274
Cell R24,4500,1195,64153443.55,-1836,9736,11572,5906.109623,1933.06307
Cell R25,4500,1195,64153443.55,649,9804,9155,3713.39749,2359.588739
Cell R26,4500,1189,63831334.21,1065,9253,8188,6190.118587,2441.847492
Cell R27,4500,1192,63992388.88,1254,9287,8033,7386.836409,1640.71238
Cell R28,4500,1192,63992388.88,1373,9571,8198,6362.900168,2140.788833
Cell R29,4500,1193,64046073.77,1474,9548,8074,7087.302598,1705.496516
Cell R30,4500,1193,64046073.77,2876,8723,5847,7465.125733,811.4851788
Cell R31,4500,1196,64207128.44,4978,8727,3749,7824.309365,483.6996926
Cell R35,4500,1192,63992388.88,-1836,8397,10233,6228.048658,1630.368253
Cell R36,4500,1190,63885019.1,251,8869,8618,5993.37395,2082.500738
Cell R37,4500,1196,64207128.44,264,9787,9523,6791.26505,1868.038919
Cell R38,4500,1189,63831334.21,1161,9787,8626,6258.792262,2255.557766
Cell R39,4500,1196,64207128.44,1810,8970,7160,7154.331104,1355.607905
Cell R40,4500,1191,63938703.99,2206,8970,6764,7470.195634,1137.119493
Cell R46,4500,1191,63938703.99,-1005,9882,10887,5387.975651,2513.396944
Cell R47,4500,1192,63992388.88,44,9882,9838,5938.244966,2273.717639
Cell R48,4500,1190,63885019.1,278,8632,8354,5547.768908,2304.743719
Cell R49,4500,1194,64099758.66,956,8734,7778,5960.242044,2258.528145
Cell R5,4500,1196,64207128.44,-1428,8335,9763,5481.797659,1929.525618
Cell R50,4500,1187,63723964.43,1111,9418,8307,4685.361415,2282.949893
Cell R51,4500,1194,64099758.66,2041,9552,7511,7177.380235,1398.335869
Cell R52,4500,1193,64046073.77,2213,8860,6647,7524.005868,974.7163393
Cell R53,4500,1196,64207128.44,4412,8779,4367,7754.406355,531.7247073
Cell R54,4500,1194,64099758.66,5717,8921,3204,8105.782245,407.3641581
Cell R58,4500,1194,64099758.66,-908,9470,10378,4225.216918,2459.763634
Cell R59,4500,1194,64099758.66,655,9470,8815,6412.313233,2089.919908
Cell R6,4500,1194,64099758.66,1518,8995,7477,7399.30067,989.7502642
Cell R60,4500,1195,64153443.55,1933,9565,7632,7106.224268,1203.612881
Cell R61,4500,1199,64368183.11,705,9950,9245,4689.876564,2709.538306
Cell R62,4500,1192,63992388.88,1104,9375,8271,4776.364094,2448.234211
Cell R63,4500,1196,64207128.44,1205,8912,7707,6851.464047,1664.212305
Cell R64,4500,1194,64099758.66,4051,8585,4534,7919.824121,424.0930623
Cell R65,4500,1198,64314498.22,6794,8980,2186,8118.01419,363.4953421
Cell R66,4500,1191,63938703.99,5623,8980,3357,8361.056255,453.1588794
Cell R69,4500,1190,63885019.1,-147,9547,9694,4492.37563,2711.073812
Cell R7,4500,1194,64099758.66,-1954,9266,11220,6929.345059,1620.646195
Cell R70,4500,1190,63885019.1,-1781,9823,11604,5436.820168,2514.8016
Cell R71,4500,1194,64099758.66,457,9959,9502,6483.737018,1778.802737
Cell R72,4500,1194,64099758.66,418,9677,9259,5154.783082,2549.790788
Cell R73,4500,1196,64207128.44,586,9950,9364,5556.915552,2594.31066
Cell R74,4500,1194,64099758.66,1387,9400,8013,6854.401173,2013.500966
Cell R75,4500,1197,64260813.33,5854,8786,2932,8071.410192,336.9840778
Cell R76,4500,1192,63992388.88,6787,8980,2193,8255.30453,411.738266
Cell R77,4500,1197,64260813.33,6445,8789,2344,8096.063492,380.4040691
Cell R8,4500,1189,63831334.21,-1958,9038,10996,7327.480235,1393.519844
Cell R80,4500,1198,64314498.22,-1781,9823,11604,5001.77212,2762.631717
Cell R81,4500,1193,64046073.77,989,9972,8983,6415.455993,2267.554191
Cell R82,4500,1196,64207128.44,418,9298,8880,4672.485786,2734.440518
Cell R83,4500,1192,63992388.88,853,9571,8718,5564.322148,2622.677671
Cell R84,4500,1193,64046073.77,1292,9652,8360,5088.549874,2396.169176
Cell R85,4500,1188,63777649.32,1292,9070,7778,6576.314815,1984.518455
Cell R86,4500,1194,64099758.66,6104,8671,2567,7799.924623,391.7983227
Cell R87,4500,1193,64046073.77,6391,8737,2346,8101.207879,360.1834268
Cell R9,4500,1197,64260813.33,-1958,9038,10996,7313.199666,1339.395774
Cell R90,4500,1190,63885019.1,1029,8956,7927,6476.567227,2190.854034
Cell R91,4500,1195,64153443.55,1175,8847,7672,7340.233473,1701.839668
Cell R92,4500,1193,64046073.77,1304,9904,8600,4167.209556,2334.336096
Cell R93,4500,1199,64368183.11,1499,9510,8011,7220.044204,1369.834372
Cell R97,4500,1193,64046073.77,1487,9152,7665,6869.764459,1929.461498
Cell R98,4500,1193,64046073.77,1543,8762,7219,7868.828164,809.9114963
Cell R99,4500,1189,63831334.21,1415,8638,7223,7642.705635,1184.222342
Cell S102,4500,1196,64207128.44,6098,9085,2987,8198.516722,431.5661808
Cell S108,4500,1194,64099758.66,6477,8903,2426,8186.58794,494.2201607
Cell S13,4500,1194,64099758.66,6589,8945,2356,7995.995812,371.0181485
Cell S14,4500,1189,63831334.21,5036,8935,3899,7852.53995,537.8201238
Cell S2,4500,1196,64207128.44,5788,8726,2938,8012.801839,357.3013119
Cell S23,4500,1190,63885019.1,6149,8741,2592,8036.001681,398.5377727
Cell S32,4500,1192,63992388.88,4978,8903,3925,7939.625,526.7476898
Cell S33,4500,1193,64046073.77,6215,8791,2576,7964.20285,389.9874296
Cell S34,4500,1197,64260813.33,6790,8963,2173,7985.177109,354.367933
Cell S41,4500,1192,63992388.88,5404,8727,3323,7897.703859,427.1544941
Cell S42,4500,1196,64207128.44,6084,8920,2836,8266.851171,426.0613989
Cell S44,4500,1193,64046073.77,6035,9061,3026,8009.290863,433.5763304
Cell S56,4500,1197,64260813.33,5756,8938,3182,7708.794486,486.0272308
Cell S67,4500,1191,63938703.99,5623,8938,3315,7846.820319,535.3971317
Cell S78,4500,1191,63938703.99,6412,9081,2669,8365.874895,415.7623231
Cell S88,4500,1194,64099758.66,6869,9081,2212,8258.798157,392.8548587
Cell S94,4500,1192,63992388.88,6670,9085,2415,8299.015101,342.3217531
Cell S95,4500,1188,63777649.32,6670,8980,2310,8220.329125,361.3765376
W287,4500,1188,63777649.32,941,8828,7887,4122.920034,1933.975882
W295,4500,1194,64099758.66,1705,8785,7080,6818.38861,1570.705125
W338,4500,1196,64207128.44,697,9399,8702,4472.012542,2593.266245
W342,4500,1197,64260813.33,1236,8573,7337,5556.263158,2179.720063
W345,4500,1190,63885019.1,3500,8481,4981,7487.409244,445.4381373
W387,4500,1194,64099758.66,1121,9470,8349,5355.774707,2307.534434
W393,4500,1196,64207128.44,1118,8560,7442,6201.040134,1987.849291
W440,4500,1192,63992388.88,1161,8009,6848,4795.747483,1927.080887
W441,4500,1193,64046073.77,2711,8290,5579,7038.66052,788.6508249
W445,4500,1196,64207128.44,2669,8519,5850,6810.831104,786.1564176
W500,4500,1195,64153443.55,1306,8546,7240,6103.562343,1936.706602
1,4750,1332,71508273.48,1518,8995,7477,7287.985736,1148.662871
2,4750,1334,71615643.26,1796,9292,7496,6370.482009,1647.050255
3,4750,1328,71293533.92,1681,9270,7589,7641.149849,1000.19609
4,4750,1328,71293533.92,2497,8536,6039,7486.287651,1011.245106
5,4750,1329,71347218.81,-1836,8397,10233,6211.382242,1645.082126
6,4750,1330,71400903.7,1254,9287,8033,7149.428571,1785.895669
7,4750,1330,71400903.7,1474,9571,8097,7090.155639,1616.803794
8,4750,1327,71239849.03,1872,8423,6551,6872.33685,1485.870057
9,4750,1329,71347218.81,5930,8903,2973,7958.505643,481.4890327
10,4750,1331,71454588.59,631,9882,9251,5903.398197,2228.782175
11,4750,1327,71239849.03,264,8632,8368,5463.354182,2327.469678
12,4750,1333,71561958.37,1111,9418,8307,4598.975244,2299.213917
13,4750,1327,71239849.03,2041,9552,7511,7123.282592,1434.780772
14,4750,1330,71400903.7,6238,8901,2663,8087.538346,379.3900829
16,4750,1328,71293533.92,-147,9547,9694,4656.053464,2688.260033
17,4750,1328,71293533.92,1669,9565,7896,6998.556476,1359.458009
18,4750,1333,71561958.37,705,9950,9245,4507.465866,2676.989186
19,4750,1332,71508273.48,1104,9375,8271,4901.181682,2478.96651
20,4750,1331,71454588.59,5854,8786,2932,8065.256198,339.7195573
21,4750,1330,71400903.7,6445,8820,2375,8120.729323,378.447933
22,4750,1330,71400903.7,-1781,9972,11753,4929.41203,2905.432118
23,4750,1330,71400903.7,418,9298,8880,4837.752632,2730.824446
24,4750,1328,71293533.92,1175,8847,7672,7244,1825.261786
25,4750,1333,71561958.37,1499,9510,8011,7209.366842,1388.422183
26,4750,1332,71508273.48,6391,8737,2346,8094.357357,370.9667003
27,4750,1330,71400903.7,1543,8787,7244,7788.079699,1023.870881
28,4750,1334,71615643.26,1436,8602,7166,7598.365067,1036.071505
29,4750,1328,71293533.92,1685,9692,8007,7541.125,1097.89108
31,4750,1331,71454588.59,1816,8985,7169,7799.350864,895.8354483
32,4750,1333,71561958.37,1681,8980,7299,6973.342086,1484.293104
33,4750,1328,71293533.92,5522,8542,3020,7252.262048,561.2399936
34,4750,1332,71508273.48,3375,8482,5107,7173.676426,746.9234203
10A,4750,1329,71347218.81,44,9882,9838,5811.916479,2336.513096
10NE,4750,1329,71347218.81,190,9882,9692,5709.702032,2462.587938
10NW,4750,1331,71454588.59,251,8869,8618,5827.529677,2175.040978
10SW,4750,1329,71347218.81,-1005,9882,10887,5246.764485,2406.67932
11NE,4750,1332,71508273.48,264,9787,9523,6722.954204,1970.284452
11NW,4750,1329,71347218.81,-92,9787,9879,5642.969902,2568.565588
11SE,4750,1331,71454588.59,956,8734,7778,5915.926371,2258.636282
17NW,4750,1331,71454588.59,655,9470,8815,6383.91435,2095.238552
17SE,4750,1330,71400903.7,457,9959,9502,6440.704511,1819.427106
17SW,4750,1327,71239849.03,-1781,9823,11604,5395.321778,2551.081999
22S,4750,1331,71454588.59,-1781,9834,11615,4726.945154,2886.721773
23S,4750,1333,71561958.37,1335,9548,8213,3779.141035,1964.560912
24S,4750,1331,71454588.59,1175,8847,7672,7239.480841,1824.733234
27A,4750,1330,71400903.7,1487,9135,7648,6908.571429,1971.445034
2A,4750,1327,71239849.03,1668,9292,7624,6450.793519,1685.452456
5NE,4750,1328,71293533.92,-76,9736,9812,4703.241717,2317.393644
5NW,4750,1334,71615643.26,-1836,9736,11572,5536.453523,2210.892153
5SE,4750,1329,71347218.81,649,9804,9155,3787.733634,2378.634989
6NE,4750,1330,71400903.7,1796,9253,7457,7189.087218,1568.387992
6NW,4750,1331,71454588.59,674,9287,8613,6114.876033,2497.136932
6SW,4750,1329,71347218.81,1036,9804,8768,6721.6614,2136.007636
Cell 1 2011/12,4750,1332,71508273.48,1518,8995,7477,7287.985736,1148.662871
Cell 1 SW 2013,4750,1325,71132479.25,-1428,9210,10638,5116.982642,2058.800418
Cell 10 2011/12,4750,1331,71454588.59,631,9882,9251,5903.398197,2228.782175
Cell 10 NE 2011/12,4750,1329,71347218.81,190,9882,9692,5709.702032,2462.587938
Cell 10 NW 2011/12,4750,1331,71454588.59,251,8869,8618,5827.529677,2175.040978
Cell 10 SE 2013,4750,1331,71454588.59,674,9287,8613,6114.876033,2497.136932
Cell 10 SW 2011/12,4750,1329,71347218.81,-1005,9882,10887,5246.764485,2406.67932
Cell 10-A 2011/12,4750,1329,71347218.81,44,9882,9838,5811.916479,2336.513096
Cell 11 NE 2011/12,4750,1332,71508273.48,264,9787,9523,6722.954204,1970.284452
Cell 11 NW 2013,4750,1326,71186164.14,1668,9292,7624,6480.733786,1650.916462
Cell 11 SW 2013,4750,1330,71400903.7,1254,9287,8033,7226.066917,1757.591879
Cell 12 2013,4750,1333,71561958.37,1474,9571,8097,7090.066017,1616.12018
Cell 13 2013,4750,1331,71454588.59,1806,8423,6617,6810.572502,1551.252312
Cell 14 2013,4750,1329,71347218.81,6764,8863,2099,7932.050414,357.4779262
Cell 15 2013,4750,1333,71561958.37,6215,8777,2562,7938.27907,374.3204497
Cell 15-A 2013,4750,1331,71454588.59,6215,8798,2583,7975.196844,390.9283009
Cell 16 2013,4750,1334,71615643.26,6215,8963,2748,7953.182159,400.0353496
Cell 17 NW 2011/12,4750,1331,71454588.59,655,9470,8815,6383.91435,2095.238552
Cell 17 NW 2013,4750,1331,71454588.59,-1836,9736,11572,5872.850488,1965.214542
Cell 17 SE 2013,4750,1331,71454588.59,251,8869,8618,5827.529677,2175.040978
Cell 17 SW 2013,4750,1327,71239849.03,-1836,8397,10233,6212.453655,1650.927251
Cell 18 2011/12,4750,1333,71561958.37,705,9950,9245,4507.465866,2676.989186
Cell 18 NE 2013,4750,1327,71239849.03,1036,9287,8251,6739.797287,2150.327196
Cell 18 NW 2013,4750,1330,71400903.7,649,9804,9155,3746.249624,2354.064558
Cell 18 SE 2013,4750,1332,71508273.48,264,9787,9523,6722.954204,1970.284452
Cell 18 SSE 2013,4750,1330,71400903.7,-92,9787,9879,5590.933083,2525.48654
Cell 19 NW 2013,4750,1329,71347218.81,1254,9287,8033,7199.148232,1820.284838
Cell 2 2011/12,4750,1334,71615643.26,1796,9292,7496,6370.482009,1647.050255
Cell 2 NE 2013,4750,1330,71400903.7,-1954,9266,11220,6656.005263,1743.74693
Cell 2 SW 2013,4750,1332,71508273.48,1518,8995,7477,7287.147898,1148.512288
Cell 20 2013,4750,1328,71293533.92,1474,9548,8074,7019.003765,1748.149551
Cell 21 2013,4750,1330,71400903.7,2206,8970,6764,7476.695489,1130.424395
Cell 22 2013,4750,1330,71400903.7,5845,8903,3058,7984.062406,474.1707251
Cell 23 2013,4750,1332,71508273.48,5982,8920,2938,8246.157658,443.9539405
Cell 24 2013,4750,1330,71400903.7,6790,8963,2173,7979.394737,361.4701599
Cell 25 NE 2013,4750,1331,71454588.59,631,9882,9251,5903.398197,2228.782175
Cell 25 SE 2013,4750,1328,71293533.92,-1005,9882,10887,5244.563253,2406.247558
Cell 26 NE 2013,4750,1327,71239849.03,264,8632,8368,5463.354182,2327.469678
Cell 26 NNW 2013,4750,1330,71400903.7,190,9882,9692,5706.801504,2463.931951
Cell 26 NW 2013,4750,1328,71293533.92,44,9882,9838,5810.00753,2336.356431
Cell 27 NW 2013,4750,1331,71454588.59,956,8734,7778,5915.926371,2258.636282
Cell 28 2013,4750,1333,71561958.37,1111,9418,8307,4598.802701,2299.437005
Cell 29 2013,4750,1329,71347218.81,2041,9552,7511,7124.161776,1433.901365
Cell 3 NE 2013,4750,1328,71293533.92,-1958,9038,10996,7312.968373,1344.686664
Cell 3 NW 2013,4750,1330,71400903.7,-1954,9266,11220,6878.725564,1634.237874
Cell 30 2013,4750,1332,71508273.48,6794,8980,2186,8125.225225,364.8520191
Cell 31 2013,4750,1330,71400903.7,5717,8921,3204,8109.292481,413.2801024
Cell 32 2013,4750,1332,71508273.48,5623,8938,3315,7860.831832,530.9447104
Cell 33 NE 2013,4750,1332,71508273.48,655,9470,8815,6384.394895,2094.525276
Cell 33 SE 2013,4750,1327,71239849.03,-1781,9823,11604,5396.27581,2551.914616
Cell 33 SW 2013,4750,1329,71347218.81,-159,9547,9706,4530.086531,2728.828815
Cell 34 N 2013,4750,1330,71400903.7,1022,9728,8706,6703.919549,1781.706469
Cell 34 NW 2013,4750,1328,71293533.92,1669,9565,7896,6998.556476,1359.458009
Cell 34 SE 2013,4750,1330,71400903.7,457,9959,9502,6439.920301,1818.239449
Cell 35 2013,4750,1331,71454588.59,705,9950,9245,4655.946657,2687.867308
Cell 37 2013,4750,1331,71454588.59,5854,8786,2932,8061.791886,340.6958334
Cell 38 2013,4750,1328,71293533.92,6445,8820,2375,8122.480422,379.9909137
Cell 39 2013,4750,1330,71400903.7,6412,9081,2669,8360.461654,419.975621
Cell 4 2013,4750,1330,71400903.7,5514,8536,3022,7817.34812,334.0619408
Cell 40 NE 2013,4750,1332,71508273.48,-1781,9823,11604,4934.839339,2774.363083
Cell 41 N 2013,4750,1328,71293533.92,-1781,9972,11753,6539.207831,2237.717483
Cell 41 NW 2013,4750,1332,71508273.48,-1781,9972,11753,5745.694444,2734.65692
Cell 42 NW 2013,4750,1327,71239849.03,418,9298,8880,4788.284853,2726.025519
Cell 43 2013,4750,1331,71454588.59,1292,9652,8360,6558.323817,2007.253406
Cell 44 2013,4750,1331,71454588.59,5529,8672,3143,7844.734035,476.9903658
Cell 45 2013,4750,1336,71723013.04,6391,8737,2346,8095.116018,370.7371067
Cell 47 2013,4750,1330,71400903.7,1029,8956,7927,6528.842857,2180.482459
Cell 48 2013,4750,1332,71508273.48,1175,8847,7672,7235.924174,1827.891251
Cell 49 2013,4750,1332,71508273.48,1499,9510,8011,7208.916667,1388.846014
Cell 5 2011/12 Summer,4750,1327,71239849.03,-1836,8397,10233,6212.453655,1650.927251
Cell 5 2013,4750,1329,71347218.81,6017,8750,2733,7965.436418,380.7469342
Cell 50 2013,4750,1329,71347218.81,1685,9692,8007,7541.781038,1097.738314
Cell 51 2013,4750,1334,71615643.26,6670,9074,2404,8231.39955,355.9647638
Cell 52 2013,4750,1331,71454588.59,1415,8787,7372,7598.871525,1287.295753
Cell 53 2013,4750,1333,71561958.37,1436,8602,7166,7598.102776,1036.415782
Cell 54 2013,4750,1333,71561958.37,5568,8970,3402,8064.750188,638.8403972
Cell 55 2013,4750,1330,71400903.7,6255,8903,2648,8178.632331,501.9968855
Cell 56 2013,4750,1330,71400903.7,5522,8542,3020,7252.232331,560.4837567
Cell 57 2013,4750,1334,71615643.26,1681,8980,7299,6973.625937,1483.772861
Cell 58 2013,4750,1329,71347218.81,5779,8912,3133,8342.30775,388.2064556
Cell 59 2013,4750,1333,71561958.37,5522,9079,3557,7353.910728,479.444526
Cell 6 2011/12,4750,1330,71400903.7,1254,9287,8033,7149.428571,1785.895669
Cell 6 2013,4750,1331,71454588.59,5788,8726,2938,8023.985725,350.1575611
Cell 6 NE 2011/12,4750,1330,71400903.7,1796,9253,7457,7189.087218,1568.387992
Cell 6 NW 2011/12,4750,1331,71454588.59,674,9287,8613,6114.876033,2497.136932
Cell 6 SW 2011/12,4750,1329,71347218.81,1036,9804,8768,6721.6614,2136.007636
Cell 60 2013,4750,1328,71293533.92,3678,8482,4804,7254.408133,726.2811006
Cell 61 2013,4750,1332,71508273.48,3582,8770,5188,7633.350601,792.0028832
Cell 7 2013,4750,1331,71454588.59,5036,8935,3899,7853.842975,539.5507635
Cell 9 NW 2013,4750,1331,71454588.59,-76,9550,9626,4961.264463,2321.45305
Cell 9 SE 2013,4750,1328,71293533.92,-76,9736,9812,4703.241717,2317.393644
Cell 9 SW 2013,4750,1331,71454588.59,-1836,9736,11572,5537.69722,2208.937364
Cell R1,4750,1321,70917739.69,1239,8226,6987,5846.529145,1985.960612
Cell R10,4750,1331,71454588.59,5514,8536,3022,7817.632607,334.0975547
Cell R100,4750,1330,71400903.7,1685,9692,8007,7542.52782,1097.663212
Cell R101,4750,1332,71508273.48,5543,8816,3273,8024.323574,448.223021
Cell R104,4750,1331,71454588.59,1301,9468,8167,7135.272727,2043.188392
Cell R105,4750,1333,71561958.37,1436,8602,7166,7598.102776,1036.415782
Cell R106,4750,1330,71400903.7,1520,9692,8172,7321.500752,1461.702784
Cell R107,4750,1333,71561958.37,5568,8970,3402,8064.852213,638.9442283
Cell R11,4750,1329,71347218.81,6017,8750,2733,7965.436418,380.7469342
Cell R111,4750,1330,71400903.7,1421,9468,8047,7042.408271,2107.987091
Cell R112,4750,1330,71400903.7,4775,8688,3913,8007.543609,385.4018565
Cell R113,4750,1334,71615643.26,1681,8980,7299,6973.625937,1483.772861
Cell R114,4750,1331,71454588.59,5779,8912,3133,8340.256198,393.3529773
Cell R117,4750,1332,71508273.48,1430,9074,7644,6717.722973,1664.525614
Cell R118,4750,1329,71347218.81,5522,8542,3020,7253.042137,559.9162624
Cell R119,4750,1334,71615643.26,1681,8542,6861,6689.532984,1447.320394
Cell R120,4750,1332,71508273.48,2412,8655,6243,7553.211712,914.3505828
Cell R121,4750,1331,71454588.59,6617,8799,2182,8106.829452,382.3981214
Cell R123,4750,1330,71400903.7,1645,9542,7897,7371.821053,982.4061689
Cell R124,4750,1330,71400903.7,3203,8555,5352,7238.844361,797.5422843
Cell R125,4750,1331,71454588.59,1894,8780,6886,6814.541698,1223.186652
Cell R126,4750,1328,71293533.92,3582,8736,5154,7522.034639,810.8300589
Cell R15,4750,1325,71132479.25,-1428,9210,10638,5116.982642,2058.800418
Cell R16,4750,1330,71400903.7,-76,9550,9626,4958.346617,2322.177497
Cell R17,4750,1330,71400903.7,1371,9513,8142,7057.130075,1661.535055
Cell R18,4750,1340,71937752.6,1668,9292,7624,6472.108209,1654.153636
Cell R19,4750,1329,71347218.81,1635,9498,7863,7133.421369,1800.982248
Cell R20,4750,1328,71293533.92,2592,8536,5944,7509.618976,971.9202105
Cell R21,4750,1329,71347218.81,2679,8733,6054,7615.340105,750.2436385
Cell R22,4750,1329,71347218.81,6764,8863,2099,7931.492099,357.4994337
Cell R24,4750,1331,71454588.59,-1836,9736,11572,5872.850488,1965.214542
Cell R25,4750,1328,71293533.92,649,9804,9155,3743.753765,2352.903879
Cell R26,4750,1330,71400903.7,674,9253,8579,6104.56015,2495.169096
Cell R27,4750,1331,71454588.59,1254,9287,8033,7192.347107,1827.373501
Cell R28,4750,1332,71508273.48,1373,9571,8198,6325.165916,2155.317491
Cell R29,4750,1328,71293533.92,1474,9548,8074,7019.003765,1748.149551
Cell R30,4750,1330,71400903.7,2677,8727,6050,7469.504511,841.6092312
Cell R31,4750,1329,71347218.81,4978,8727,3749,7825.910459,479.9995331
Cell R35,4750,1327,71239849.03,-1836,8397,10233,6212.453655,1650.927251
Cell R36,4750,1331,71454588.59,251,8869,8618,5827.529677,2175.040978
Cell R37,4750,1332,71508273.48,264,9787,9523,6722.954204,1970.284452
Cell R38,4750,1327,71239849.03,1111,9787,8676,6161.006029,2314.337123
Cell R39,4750,1332,71508273.48,1810,9487,7677,7127.732733,1396.859791
Cell R40,4750,1330,71400903.7,2206,8970,6764,7476.695489,1130.424395
Cell R46,4750,1327,71239849.03,-1005,9882,10887,5409.022607,2538.715171
Cell R47,4750,1329,71347218.81,44,9882,9838,5811.916479,2336.513096
Cell R48,4750,1326,71186164.14,264,8632,8368,5466.731523,2327.017356
Cell R49,4750,1331,71454588.59,956,8734,7778,5915.926371,2258.636282
Cell R5,4750,1331,71454588.59,-1428,8335,9763,5479.65139,1955.287916
Cell R50,4750,1334,71615643.26,1111,9418,8307,4596.66042,2299.905344
Cell R51,4750,1326,71186164.14,2041,9552,7511,7142.618401,1411.128281
Cell R52,4750,1329,71347218.81,2206,8860,6654,7509.700527,1015.739799
Cell R53,4750,1330,71400903.7,3451,8779,5328,7742.023308,561.1874121
Cell R54,4750,1329,71347218.81,5717,8921,3204,8109.459744,413.390556
Cell R58,4750,1329,71347218.81,-908,9470,10378,4237.312265,2475.828222
Cell R59,4750,1331,71454588.59,655,9470,8815,6383.91435,2095.238552
Cell R6,4750,1332,71508273.48,1518,8995,7477,7287.147898,1148.512288
Cell R60,4750,1328,71293533.92,1669,9565,7896,6998.623494,1359.388937
Cell R61,4750,1331,71454588.59,705,9950,9245,4655.946657,2687.867308
Cell R62,4750,1330,71400903.7,1104,9375,8271,4826.866165,2473.229941
Cell R63,4750,1327,71239849.03,1205,8912,7707,6827.57046,1659.36194
Cell R64,4750,1329,71347218.81,4051,8585,4534,7920.632054,419.1578725
Cell R65,4750,1333,71561958.37,6794,8980,2186,8125.412603,364.7792487
Cell R66,4750,1328,71293533.92,5623,8980,3357,8347.043675,467.8753724
Cell R69,4750,1329,71347218.81,-159,9547,9706,4530.086531,2728.828815
Cell R7,4750,1330,71400903.7,-1954,9266,11220,6878.725564,1634.237874
Cell R70,4750,1327,71239849.03,-1781,9823,11604,5396.27581,2551.914616
Cell R71,4750,1331,71454588.59,457,9959,9502,6441.205109,1818.160148
Cell R72,4750,1329,71347218.81,418,9677,9259,5198.124906,2544.314307
Cell R73,4750,1328,71293533.92,586,9950,9364,5387.756024,2632.714022
Cell R74,4750,1329,71347218.81,1387,9400,8013,6815.879609,2041.613613
Cell R75,4750,1331,71454588.59,5854,8786,2932,8061.791886,340.6958334
Cell R76,4750,1330,71400903.7,6787,8980,2193,8252.603008,406.0359742
Cell R77,4750,1329,71347218.81,6445,8820,2375,8122.62453,379.8842262
Cell R8,4750,1328,71293533.92,-1958,9038,10996,7320.908886,1356.789622
Cell R80,4750,1330,71400903.7,-1781,9823,11604,4934.95188,2774.490864
Cell R81,4750,1333,71561958.37,448,9972,9524,6365.167292,2285.708729
Cell R82,4750,1327,71239849.03,418,9298,8880,4788.284853,2726.025519
Cell R83,4750,1329,71347218.81,853,9571,8718,5595.382242,2594.534714
Cell R84,4750,1331,71454588.59,1250,9652,8402,5173.128475,2414.453506
Cell R85,4750,1331,71454588.59,1292,9652,8360,6555.766341,2007.689164
Cell R86,4750,1331,71454588.59,6104,8671,2567,7805.132983,391.124063
Cell R87,4750,1335,71669328.15,6391,8737,2346,8094.832959,370.7315935
Cell R9,4750,1332,71508273.48,-1958,9038,10996,7323.584084,1303.646925
Cell R90,4750,1330,71400903.7,1029,8956,7927,6528.842857,2180.482459
Cell R91,4750,1332,71508273.48,1175,8847,7672,7235.924174,1827.891251
Cell R92,4750,1330,71400903.7,1304,9904,8600,4269.47594,2356.09167
Cell R93,4750,1333,71561958.37,1499,9510,8011,7207.211553,1389.718998
Cell R97,4750,1327,71239849.03,1487,9152,7665,6900.908817,1935.362742
Cell R98,4750,1332,71508273.48,1543,8787,7244,7786.924174,1023.726158
Cell R99,4750,1331,71454588.59,1415,8787,7372,7598.871525,1287.295753
Cell S102,4750,1335,71669328.15,6098,9085,2987,8198.460674,435.7228216
Cell S108,4750,1330,71400903.7,6255,8903,2648,8178.632331,501.9968855
Cell S13,4750,1328,71293533.92,6092,8945,2853,7988.637801,381.4982204
Cell S14,4750,1331,71454588.59,5036,8935,3899,7853.842975,539.5507635
Cell S2,4750,1331,71454588.59,5788,8726,2938,8023.985725,350.1575611
Cell S23,4750,1329,71347218.81,5614,8741,3127,8018.778781,415.2279302
Cell S32,4750,1329,71347218.81,4978,8903,3925,7942.85553,520.8707665
Cell S33,4750,1331,71454588.59,6215,8798,2583,7975.196844,390.9283009
Cell S34,4750,1330,71400903.7,6790,8963,2173,7979.394737,361.4701599
Cell S41,4750,1330,71400903.7,4260,8727,4467,7884.991729,466.4791906
Cell S42,4750,1332,71508273.48,5982,8920,2938,8246.157658,443.9539405
Cell S44,4750,1330,71400903.7,6035,9061,3026,8017.581955,436.2869215
Cell S56,4750,1330,71400903.7,5649,8938,3289,7696.994737,495.9550739
Cell S67,4750,1332,71508273.48,5623,8938,3315,7860.831832,530.9447104
Cell S78,4750,1330,71400903.7,6412,9081,2669,8360.461654,419.975621
Cell S88,4750,1332,71508273.48,6639,9081,2442,8257.035285,403.7172707
Cell S94,4750,1332,71508273.48,6670,9085,2415,8299.201201,343.7460282
Cell S95,4750,1336,71723013.04,6670,9074,2404,8231.376497,355.7762867
W287,4750,1329,71347218.81,941,8943,8002,4104.069977,1972.640233
W295,4750,1329,71347218.81,1705,8785,7080,6813.893153,1612.263365
W338,4750,1331,71454588.59,697,9399,8702,4334.397446,2576.891395
W342,4750,1333,71561958.37,1147,8573,7426,5491.772693,2227.792398
W345,4750,1329,71347218.81,3500,8481,4981,7485.334086,474.1655628
W387,4750,1330,71400903.7,1121,9470,8349,5385.464662,2295.73799
W393,4750,1330,71400903.7,1118,8560,7442,6136.645865,2028.668261
W440,4750,1326,71186164.14,1161,8767,7606,4855.826546,1974.59548
W441,4750,1329,71347218.81,2711,8290,5579,7018.918736,795.7926229
W445,4750,1331,71454588.59,2669,8548,5879,6798.731781,830.7389771
W500,4750,1327,71239849.03,1306,8546,7240,6148.917106,1906.397483
1,5000,1473,79077842.97,1339,8995,7656,7170.810591,1310.588307
2,5000,1469,78863103.41,1796,9292,7496,6326.439755,1686.225326
3,5000,1477,79292582.53,1653,9270,7617,7564.809749,1121.857713
4,5000,1474,79131527.86,2251,8536,6285,7493.486431,1023.545241
5,5000,1477,79292582.53,-1836,9972,11808,6191.570074,1678.807211
6,5000,1471,78970473.19,1254,9287,8033,7027.002039,1897.275342
7,5000,1473,79077842.97,1474,9571,8097,7027.144603,1673.651335
8,5000,1478,79346267.42,1806,8423,6617,6904.928958,1510.203646
9,5000,1476,79238897.64,5930,8903,2973,7951.154472,485.0077059
10,5000,1473,79077842.97,631,9882,9251,5749.540394,2301.79933
11,5000,1475,79185212.75,190,8632,8442,5432.514576,2340.035405
12,5000,1474,79131527.86,1111,9418,8307,4560.514247,2309.545257
13,5000,1474,79131527.86,1889,9552,7663,7075.295794,1482.801066
14,5000,1478,79346267.42,6238,8901,2663,8089.215156,381.3341152
16,5000,1475,79185212.75,-159,9547,9706,4694.467797,2711.442265
17,5000,1475,79185212.75,1431,9565,8134,6927.465763,1425.771171
18,5000,1472,79024158.08,705,9950,9245,4566.319293,2651.219668
19,5000,1474,79131527.86,1104,9552,8448,4936.301221,2486.053381
20,5000,1475,79185212.75,5854,8786,2932,8054.731525,353.761072
21,5000,1473,79077842.97,6445,8888,2443,8146.296673,377.848696
22,5000,1471,78970473.19,-1781,9972,11753,4926.456832,2924.174567
23,5000,1477,79292582.53,418,9298,8880,4954.488829,2716.865447
24,5000,1474,79131527.86,1175,8847,7672,7144.628901,1922.266533
25,5000,1475,79185212.75,1499,9629,8130,7164.540339,1449.535433
26,5000,1471,78970473.19,6391,8737,2346,8087.281441,381.658839
27,5000,1480,79453637.2,1469,8787,7318,7687.669595,1235.692458
28,5000,1478,79346267.42,1436,8606,7170,7521.637348,1225.588656
29,5000,1473,79077842.97,1685,9692,8007,7497.806517,1192.411249
31,5000,1472,79024158.08,1816,9000,7184,7755.840353,997.3284727
32,5000,1475,79185212.75,1681,8980,7299,7002.237288,1463.626586
33,5000,1472,79024158.08,5522,8600,3078,7268.241848,569.4452033
34,5000,1473,79077842.97,3375,8482,5107,7131.11609,809.4653844
10A,5000,1472,79024158.08,-227,9882,10109,5679.547554,2417.698142
10NE,5000,1475,79185212.75,-92,9882,9974,5612.842034,2499.935637
10NW,5000,1473,79077842.97,251,8869,8618,5688.044807,2255.537451
10SW,5000,1473,79077842.97,-1005,9882,10887,5303.950441,2459.444639
11NE,5000,1473,79077842.97,-92,9787,9879,6639.331297,2088.367161
11NW,5000,1474,79131527.86,-92,9787,9879,5580.434871,2572.314336
11SE,5000,1468,78809418.52,956,9261,8305,5918.055858,2250.02097
17NW,5000,1469,78863103.41,655,9470,8815,6383.880871,2086.449618
17SE,5000,1473,79077842.97,457,9959,9502,6411.741344,1845.868107
17SW,5000,1475,79185212.75,-1781,9823,11604,5381.978983,2565.639188
22S,5000,1472,79024158.08,-1781,9972,11753,4714.179348,2905.906346
23S,5000,1473,79077842.97,1335,9548,8213,3824.105227,2013.811545
24S,5000,1474,79131527.86,1175,8847,7672,7134.49118,1929.487845
27A,5000,1474,79131527.86,1487,9152,7665,6957.736771,1942.635448
2A,5000,1473,79077842.97,1668,9292,7624,6451.583164,1671.234077
5NE,5000,1471,78970473.19,-76,9736,9812,4680.755269,2319.99682
5NW,5000,1470,78916788.3,-1836,9736,11572,5461.652381,2222.334212
5SE,5000,1475,79185212.75,649,9804,9155,3829.642712,2374.756383
6NE,5000,1473,79077842.97,1796,9253,7457,7164.050916,1571.522032
6NW,5000,1473,79077842.97,674,9287,8613,6044.068568,2535.320969
6SW,5000,1476,79238897.64,1036,9804,8768,6733.743902,2107.700379
Cell 1 2011/12,5000,1473,79077842.97,1339,8995,7656,7170.810591,1310.588307
Cell 1 SW 2013,5000,1472,79024158.08,-1428,9210,10638,5153.120924,2068.506288
Cell 10 2011/12,5000,1473,79077842.97,631,9882,9251,5749.540394,2301.79933
Cell 10 NE 2011/12,5000,1475,79185212.75,-92,9882,9974,5612.842034,2499.935637
Cell 10 NW 2011/12,5000,1473,79077842.97,251,8869,8618,5688.044807,2255.537451
Cell 10 SE 2013,5000,1473,79077842.97,674,9287,8613,6044.068568,2535.320969
Cell 10 SW 2011/12,5000,1473,79077842.97,-1005,9882,10887,5303.950441,2459.444639
Cell 10-A 2011/12,5000,1472,79024158.08,-227,9882,10109,5679.547554,2417.698142
Cell 11 NE 2011/12,5000,1473,79077842.97,-92,9787,9879,6639.331297,2088.367161
Cell 11 NW 2013,5000,1476,79238897.64,1668,9292,7624,6461.134824,1649.029331
Cell 11 SW 2013,5000,1476,79238897.64,1254,9287,8033,7150.409892,1796.887738
Cell 12 2013,5000,1470,78916788.3,1474,9571,8097,7027.431973,1671.794241
Cell 13 2013,5000,1476,79238897.64,1806,8423,6617,6842.027778,1553.378873
Cell 14 2013,5000,1475,79185212.75,6227,8863,2636,7929.242034,370.8687927
Cell 15 2013,5000,1474,79131527.86,6215,8777,2562,7940.102442,369.1077506
Cell 15-A 2013,5000,1478,79346267.42,6215,8798,2583,7987.572395,390.3362172
Cell 16 2013,5000,1473,79077842.97,6215,8963,2748,7962.48201,397.5194008
Cell 17 NW 2011/12,5000,1469,78863103.41,655,9470,8815,6383.880871,2086.449618
Cell 17 NW 2013,5000,1473,79077842.97,-1836,9736,11572,5847.923286,1980.641659
Cell 17 SE 2013,5000,1474,79131527.86,251,8869,8618,5685.627544,2256.680018
Cell 17 SW 2013,5000,1471,78970473.19,-1836,8397,10233,6190.212101,1677.720915
Cell 18 2011/12,5000,1472,79024158.08,705,9950,9245,4566.319293,2651.219668
Cell 18 NE 2013,5000,1471,78970473.19,1036,9804,8768,6764.502379,2116.153121
Cell 18 NW 2013,5000,1472,79024158.08,649,9804,9155,3809.339674,2355.57935
Cell 18 SE 2013,5000,1473,79077842.97,-92,9787,9879,6639.331297,2088.367161
Cell 18 SSE 2013,5000,1471,78970473.19,-92,9787,9879,5545.739633,2535.868877
Cell 19 NW 2013,5000,1471,78970473.19,1254,9287,8033,7063.015636,1925.146781
Cell 2 2011/12,5000,1469,78863103.41,1796,9292,7496,6326.439755,1686.225326
Cell 2 NE 2013,5000,1472,79024158.08,-1954,9266,11220,6638.648098,1733.661517
Cell 2 SW 2013,5000,1473,79077842.97,1339,8995,7656,7171.167685,1310.565879
Cell 20 2013,5000,1476,79238897.64,1474,9548,8074,6967.163279,1774.643579
Cell 21 2013,5000,1475,79185212.75,2206,8970,6764,7470.682034,1115.127694
Cell 22 2013,5000,1476,79238897.64,5845,8919,3074,7990.343496,478.7918731
Cell 23 2013,5000,1475,79185212.75,5845,8920,3075,8239.248136,449.7928511
Cell 24 2013,5000,1472,79024158.08,5858,8963,3105,7974.845788,375.181534
Cell 25 NE 2013,5000,1473,79077842.97,631,9882,9251,5749.540394,2301.79933
Cell 25 SE 2013,5000,1474,79131527.86,-1005,9882,10887,5304.823609,2458.838602
Cell 26 NE 2013,5000,1475,79185212.75,190,8632,8442,5432.514576,2340.035405
Cell 26 NNW 2013,5000,1475,79185212.75,-92,9882,9974,5612.842034,2499.935637
Cell 26 NW 2013,5000,1472,79024158.08,-227,9882,10109,5679.547554,2417.698142
Cell 27 NW 2013,5000,1468,78809418.52,956,9261,8305,5918.055858,2250.02097
Cell 28 2013,5000,1473,79077842.97,1111,9418,8307,4558.035302,2308.36793
Cell 29 2013,5000,1474,79131527.86,1889,9552,7663,7074.791723,1482.784253
Cell 3 NE 2013,5000,1475,79185212.75,-1958,9038,10996,7317.617627,1309.148215
Cell 3 NW 2013,5000,1475,79185212.75,-1954,9266,11220,6840.99322,1650.248411
Cell 30 2013,5000,1473,79077842.97,6794,8980,2186,8130.62797,367.4621207
Cell 31 2013,5000,1476,79238897.64,5717,8921,3204,8113.551491,416.8025511
Cell 32 2013,5000,1476,79238897.64,5623,8938,3315,7876.651762,527.7398689
Cell 33 NE 2013,5000,1469,78863103.41,655,9470,8815,6383.880871,2086.449618
Cell 33 SE 2013,5000,1475,79185212.75,-1781,9823,11604,5381.978983,2565.639188
Cell 33 SW 2013,5000,1474,79131527.86,-159,9547,9706,4611.786296,2744.080386
Cell 34 N 2013,5000,1474,79131527.86,1022,9728,8706,6688.078697,1798.489879
Cell 34 NW 2013,5000,1475,79185212.75,1431,9565,8134,6927.465763,1425.771171
Cell 34 SE 2013,5000,1474,79131527.86,457,9959,9502,6411.482361,1845.136901
Cell 35 2013,5000,1479,79399952.31,705,9950,9245,4616.713996,2652.620401
Cell 37 2013,5000,1471,78970473.19,5854,8786,2932,8055.443236,353.9726865
Cell 38 2013,5000,1473,79077842.97,6445,8888,2443,8148.289885,378.9270084
Cell 39 2013,5000,1475,79185212.75,6412,9081,2669,8348.564068,424.3450249
Cell 4 2013,5000,1473,79077842.97,5514,8536,3022,7824.378819,338.3745004
Cell 40 NE 2013,5000,1475,79185212.75,-1781,9823,11604,4927.170169,2789.248119
Cell 41 N 2013,5000,1474,79131527.86,-1781,9972,11753,6410.968792,2293.912403
Cell 41 NW 2013,5000,1473,79077842.97,-1781,9972,11753,5748.287169,2715.451485
Cell 42 NW 2013,5000,1473,79077842.97,418,9298,8880,4904.501697,2710.029941
Cell 43 2013,5000,1476,79238897.64,1292,9652,8360,6517.162602,2035.796554
Cell 44 2013,5000,1477,79292582.53,5529,8672,3143,7845.334462,481.9084499
Cell 45 2013,5000,1472,79024158.08,6391,8737,2346,8087.942935,381.862967
Cell 47 2013,5000,1476,79238897.64,1029,9372,8343,6588.7771,2168.230073
Cell 48 2013,5000,1473,79077842.97,1175,8847,7672,7136.840462,1923.468411
Cell 49 2013,5000,1475,79185212.75,1499,9629,8130,7164.540339,1449.535433
Cell 5 2011/12 Summer,5000,1471,78970473.19,-1836,8397,10233,6190.212101,1677.720915
Cell 5 2013,5000,1476,79238897.64,6017,8750,2733,7968.038618,377.6775635
Cell 50 2013,5000,1473,79077842.97,1685,9692,8007,7497.806517,1192.411249
Cell 51 2013,5000,1477,79292582.53,6670,9074,2404,8234.649289,353.1326298
Cell 52 2013,5000,1475,79185212.75,1415,8787,7372,7540.008814,1400.3405
Cell 53 2013,5000,1479,79399952.31,1436,8606,7170,7521.48952,1225.187437
Cell 54 2013,5000,1474,79131527.86,5568,8970,3402,8072.62483,626.0291746
Cell 55 2013,5000,1481,79507322.09,6255,8903,2648,8172.140446,511.5997528
Cell 56 2013,5000,1475,79185212.75,5522,8600,3078,7269.786441,570.4868903
Cell 57 2013,5000,1472,79024158.08,1681,8980,7299,6999.330163,1464.248019
Cell 58 2013,5000,1478,79346267.42,5779,8912,3133,8323.505413,413.9825893
Cell 59 2013,5000,1471,78970473.19,5522,9542,4020,7350.068661,506.6698611
Cell 6 2011/12,5000,1471,78970473.19,1254,9287,8033,7027.002039,1897.275342
Cell 6 2013,5000,1472,79024158.08,5788,8726,2938,8034.673913,345.7231428
Cell 6 NE 2011/12,5000,1473,79077842.97,1796,9253,7457,7164.050916,1571.522032
Cell 6 NW 2011/12,5000,1473,79077842.97,674,9287,8613,6044.068568,2535.320969
Cell 6 SW 2011/12,5000,1476,79238897.64,1036,9804,8768,6733.743902,2107.700379
Cell 60 2013,5000,1474,79131527.86,3203,8546,5343,7208.339891,790.9466619
Cell 61 2013,5000,1473,79077842.97,3582,8770,5188,7643.832994,786.5946218
Cell 7 2013,5000,1475,79185212.75,5036,8935,3899,7852.845424,544.5669197
Cell 9 NW 2013,5000,1469,78863103.41,-76,9550,9626,4880.479918,2315.791192
Cell 9 SE 2013,5000,1471,78970473.19,-76,9736,9812,4680.755269,2319.99682
Cell 9 SW 2013,5000,1471,78970473.19,-1836,9736,11572,5459.895989,2222.599097
Cell R1,5000,1479,79399952.31,1239,8485,7246,5854.207573,1963.030778
Cell R10,5000,1474,79131527.86,5514,8536,3022,7824.34057,338.2628852
Cell R100,5000,1474,79131527.86,1685,9692,8007,7494.41791,1199.08045
Cell R101,5000,1472,79024158.08,5543,9017,3474,8027.71875,453.3740339
Cell R104,5000,1474,79131527.86,1301,9468,8167,7085.601085,2086.075558
Cell R105,5000,1479,79399952.31,1436,8606,7170,7521.48952,1225.187437
Cell R106,5000,1475,79185212.75,1520,9692,8172,7350.147119,1440.962626
Cell R107,5000,1474,79131527.86,5568,8970,3402,8072.62483,626.0291746
Cell R11,5000,1475,79185212.75,6017,8750,2733,7967.981017,377.799087
Cell R111,5000,1473,79077842.97,1421,9468,8047,7001.604209,2147.494501
Cell R112,5000,1478,79346267.42,3574,8688,5114,7971.237483,474.8936179
Cell R113,5000,1472,79024158.08,1681,8980,7299,6999.330163,1464.248019
Cell R114,5000,1478,79346267.42,5779,8912,3133,8323.505413,413.9825893
Cell R117,5000,1474,79131527.86,1430,9079,7649,6641.424016,1770.800953
Cell R118,5000,1476,79238897.64,5522,8600,3078,7269.71206,570.3007578
Cell R119,5000,1475,79185212.75,1681,8542,6861,6720.805424,1442.753005
Cell R120,5000,1479,79399952.31,2412,8655,6243,7548.549696,923.7657863
Cell R121,5000,1478,79346267.42,6617,8799,2182,8113.237483,379.5961814
Cell R123,5000,1480,79453637.2,1473,9542,8069,7297.007432,1122.54219
Cell R124,5000,1475,79185212.75,3203,8555,5352,7192.269831,846.2764891
Cell R125,5000,1476,79238897.64,1894,8780,6886,6833.129404,1199.465185
Cell R126,5000,1475,79185212.75,3582,8736,5154,7533.774237,811.4328068
Cell R15,5000,1472,79024158.08,-1428,9210,10638,5153.120924,2068.506288
Cell R16,5000,1472,79024158.08,-76,9550,9626,4872.758152,2315.32464
Cell R17,5000,1475,79185212.75,1371,9513,8142,6970.375593,1742.134718
Cell R18,5000,1474,79131527.86,1668,9292,7624,6464.255767,1647.324907
Cell R19,5000,1472,79024158.08,1635,9498,7863,7099.438859,1821.77731
Cell R20,5000,1476,79238897.64,2497,8536,6039,7498.555556,1012.227943
Cell R21,5000,1476,79238897.64,2239,8863,6624,7577.223577,879.9204741
Cell R22,5000,1475,79185212.75,6227,8863,2636,7929.242034,370.8687927
Cell R24,5000,1473,79077842.97,-1836,9736,11572,5847.923286,1980.641659
Cell R25,5000,1470,78916788.3,649,9804,9155,3805.705442,2354.153497
Cell R26,5000,1473,79077842.97,674,9287,8613,6044.55465,2528.12737
Cell R27,5000,1471,78970473.19,1254,9287,8033,7063.015636,1925.146781
Cell R28,5000,1477,79292582.53,1373,9571,8198,6302.473257,2162.408881
Cell R29,5000,1476,79238897.64,1474,9548,8074,6967.163279,1774.643579
Cell R30,5000,1476,79238897.64,2677,8727,6050,7476.299458,872.2189539
Cell R31,5000,1474,79131527.86,4978,8727,3749,7828.788331,477.0447399
Cell R35,5000,1471,78970473.19,-1836,8397,10233,6190.212101,1677.720915
Cell R36,5000,1474,79131527.86,251,8869,8618,5685.627544,2256.680018
Cell R37,5000,1473,79077842.97,-92,9787,9879,6639.331297,2088.367161
Cell R38,5000,1475,79185212.75,1111,9787,8676,6086.911864,2373.285479
Cell R39,5000,1472,79024158.08,1734,9487,7753,7104.558424,1446.03765
Cell R40,5000,1474,79131527.86,2206,8970,6764,7470.446404,1115.469188
Cell R46,5000,1474,79131527.86,-1005,9882,10887,5383.51289,2574.152545
Cell R47,5000,1472,79024158.08,-227,9882,10109,5679.547554,2417.698142
Cell R48,5000,1475,79185212.75,190,8632,8442,5432.514576,2340.035405
Cell R49,5000,1469,78863103.41,956,9261,8305,5915.057862,2252.186145
Cell R5,5000,1473,79077842.97,-1428,8335,9763,5475.681602,1982.937062
Cell R50,5000,1473,79077842.97,1111,9418,8307,4557.12831,2309.012842
Cell R51,5000,1473,79077842.97,1889,9552,7663,7089.991853,1470.08953
Cell R52,5000,1472,79024158.08,2206,8860,6654,7496.924592,1014.376263
Cell R53,5000,1477,79292582.53,3451,8779,5328,7731.068382,582.8643139
Cell R54,5000,1475,79185212.75,5717,8921,3204,8113.691525,416.909105
Cell R58,5000,1473,79077842.97,-908,9470,10378,4275.131025,2500.261469
Cell R59,5000,1470,78916788.3,655,9470,8815,6385.188435,2086.341819
Cell R6,5000,1473,79077842.97,1339,8995,7656,7171.167685,1310.565879
Cell R60,5000,1475,79185212.75,1431,9565,8134,6927.465763,1425.771171
Cell R61,5000,1477,79292582.53,705,9950,9245,4618.072444,2653.348057
Cell R62,5000,1476,79238897.64,1104,9375,8271,4861.426152,2480.932619
Cell R63,5000,1476,79238897.64,1205,8912,7707,6807.354336,1667.908897
Cell R64,5000,1479,79399952.31,4051,8585,4534,7923.016903,417.9340691
Cell R65,5000,1473,79077842.97,6794,8980,2186,8130.62797,367.4621207
Cell R66,5000,1475,79185212.75,5623,8980,3357,8329.049492,483.0292193
Cell R69,5000,1474,79131527.86,-159,9547,9706,4611.786296,2744.080386
Cell R7,5000,1474,79131527.86,-1954,9266,11220,6842.842605,1649.279405
Cell R70,5000,1475,79185212.75,-1781,9823,11604,5381.978983,2565.639188
Cell R71,5000,1474,79131527.86,457,9959,9502,6411.482361,1845.136901
Cell R72,5000,1476,79238897.64,418,9677,9259,5227.289295,2544.106585
Cell R73,5000,1473,79077842.97,464,9950,9486,5262.700611,2655.607639
Cell R74,5000,1471,78970473.19,1387,9400,8013,6763.21482,2081.840429
Cell R75,5000,1471,78970473.19,5854,8786,2932,8055.443236,353.9726865
Cell R76,5000,1478,79346267.42,6787,8980,2193,8249.612314,406.1807317
Cell R77,5000,1473,79077842.97,6445,8888,2443,8148.289885,378.9270084
Cell R8,5000,1477,79292582.53,-1958,9038,10996,7310.078538,1319.155233
Cell R80,5000,1475,79185212.75,-1781,9823,11604,4927.170169,2789.248119
Cell R81,5000,1470,78916788.3,448,9972,9524,6375.246939,2273.34969
Cell R82,5000,1473,79077842.97,418,9298,8880,4904.501697,2710.029941
Cell R83,5000,1474,79131527.86,853,9571,8718,5636.578697,2583.460924
Cell R84,5000,1473,79077842.97,1175,9652,8477,5228.274949,2436.801193
Cell R85,5000,1476,79238897.64,1292,9652,8360,6517.162602,2035.796554
Cell R86,5000,1475,79185212.75,6104,8671,2567,7811.505085,397.1540168
Cell R87,5000,1472,79024158.08,6391,8737,2346,8087.942935,381.862967
Cell R9,5000,1477,79292582.53,-1958,9038,10996,7337.004739,1274.201215
Cell R90,5000,1476,79238897.64,1029,9372,8343,6588.7771,2168.230073
Cell R91,5000,1473,79077842.97,1175,8847,7672,7136.840462,1923.468411
Cell R92,5000,1475,79185212.75,1304,9904,8600,4401.576271,2406.329426
Cell R93,5000,1475,79185212.75,1499,9629,8130,7164.540339,1449.535433
Cell R97,5000,1473,79077842.97,1487,9152,7665,6937.634759,1933.601307
Cell R98,5000,1479,79399952.31,1469,8787,7318,7691.527383,1227.16833
Cell R99,5000,1474,79131527.86,1415,8787,7372,7542.608548,1397.25263
Cell S102,5000,1473,79077842.97,6098,9085,2987,8195.256619,440.2366896
Cell S108,5000,1480,79453637.2,6255,8903,2648,8172.10473,511.7707156
Cell S13,5000,1475,79185212.75,6034,8945,2911,7982.389153,398.6071586
Cell S14,5000,1475,79185212.75,5036,8935,3899,7852.845424,544.5669197
Cell S2,5000,1472,79024158.08,5788,8726,2938,8034.673913,345.7231428
Cell S23,5000,1477,79292582.53,4961,8741,3780,7998.166554,445.7901576
Cell S32,5000,1475,79185212.75,4978,8903,3925,7944.602712,522.967528
Cell S33,5000,1478,79346267.42,6215,8798,2583,7987.572395,390.3362172
Cell S34,5000,1472,79024158.08,5858,8963,3105,7974.845788,375.181534
Cell S41,5000,1476,79238897.64,4158,8727,4569,7862.605691,508.8264026
Cell S42,5000,1475,79185212.75,5845,8920,3075,8239.248136,449.7928511
Cell S44,5000,1477,79292582.53,6035,9061,3026,8019.389303,435.2642565
Cell S56,5000,1475,79185212.75,5649,8938,3289,7689.410847,501.1287997
Cell S67,5000,1475,79185212.75,5623,8938,3315,7877.301017,527.3291259
Cell S78,5000,1476,79238897.64,6412,9081,2669,8348.773035,424.2771639
Cell S88,5000,1479,79399952.31,6639,9081,2442,8253.076403,412.9583948
Cell S94,5000,1480,79453637.2,6670,9085,2415,8300.414865,340.3424977
Cell S95,5000,1476,79238897.64,6670,9074,2404,8234.487127,353.1972555
W287,5000,1474,79131527.86,941,9204,8263,4105.592944,2006.357828
W295,5000,1471,78970473.19,1705,8785,7080,6815.85724,1641.13884
W338,5000,1473,79077842.97,697,9399,8702,4214.693143,2566.175187
W342,5000,1471,78970473.19,1147,8946,7799,5462.063902,2268.599662
W345,5000,1476,79238897.64,3500,8481,4981,7482.917344,492.9684392
W387,5000,1470,78916788.3,1121,9470,8349,5394.917007,2283.637879
W393,5000,1472,79024158.08,1118,8560,7442,6068.310462,2071.931098
W440,5000,1473,79077842.97,1101,8767,7666,4926.985743,2015.322699
W441,5000,1475,79185212.75,2711,8290,5579,6992.797966,810.6816223
W445,5000,1474,79131527.86,2669,8548,5879,6803.837178,858.7350669
W500,5000,1473,79077842.97,1306,8546,7240,6167.668703,1893.595765
1,5250,1621,87023206.69,1334,8995,7661,7066.074645,1417.808743
2,5250,1624,87184261.36,1796,9292,7496,6309.10899,1706.972088
3,5250,1622,87076891.58,1653,9270,7617,7494.748459,1224.143957
4,5250,1624,87184261.36,2251,8536,6285,7484.993842,1047.249633
5,5250,1623,87130576.47,-1836,9972,11808,6178.629698,1695.59599
6,5250,1624,87184261.36,1254,9287,8033,6901.527709,2004.46207
7,5250,1621,87023206.69,1474,9571,8097,6943.740284,1735.370341
8,5250,1621,87023206.69,1806,8515,6709,6941.687847,1506.314844
9,5250,1625,87237946.25,5527,8903,3376,7943.675692,500.5563588
10,5250,1621,87023206.69,629,9882,9253,5623.009254,2353.081454
11,5250,1632,87613740.48,190,9787,9597,5451.117647,2361.979458
12,5250,1633,87667425.37,1111,9418,8307,4550.108389,2329.397197
13,5250,1625,87237946.25,1877,9552,7675,7012.673231,1554.011034
14,5250,1623,87130576.47,6238,8901,2663,8091.650031,380.693204
16,5250,1629,87452685.81,-159,9547,9706,4755.047268,2738.706193
17,5250,1624,87184261.36,457,9693,9236,6914.981527,1454.610812
18,5250,1624,87184261.36,705,9950,9245,4604.636084,2624.348478
19,5250,1628,87399000.92,1104,9552,8448,4955.074324,2486.509434
20,5250,1626,87291631.14,5854,8786,2932,8042.640221,366.1988387
21,5250,1623,87130576.47,6445,8956,2511,8168.264325,377.634783
22,5250,1622,87076891.58,-1781,9972,11753,4923.831689,2941.396354
23,5250,1618,86862152.02,418,9298,8880,5046.322002,2701.552961
24,5250,1627,87345316.03,1175,8847,7672,7054.415489,1981.616235
25,5250,1622,87076891.58,1436,9629,8193,7122.267571,1526.150924
26,5250,1626,87291631.14,6391,8763,2372,8087.206642,388.0715565
27,5250,1625,87237946.25,1443,8787,7344,7599.810462,1380.32508
28,5250,1627,87345316.03,1375,8606,7231,7450.174554,1372.901271
29,5250,1628,87399000.92,1685,9692,8007,7468.317568,1265.54593
31,5250,1624,87184261.36,1816,9074,7258,7701.658251,1108.665658
32,5250,1623,87130576.47,1681,8980,7299,7033.685767,1425.512742
33,5250,1627,87345316.03,5522,9074,3552,7289.936079,581.8281361
34,5250,1625,87237946.25,3318,8482,5164,7093.841231,862.782993
10A,5250,1626,87291631.14,-227,9882,10109,5516.766298,2512.87814
10NE,5250,1624,87184261.36,-92,9882,9974,5531.702586,2529.923893
10NW,5250,1626,87291631.14,-1566,8869,10435,5596.298278,2303.304861
10SW,5250,1631,87560055.59,-1005,9882,10887,5347.119559,2501.794008
11NE,5250,1623,87130576.47,-92,9787,9879,6572.192853,2172.970353
11NW,5250,1622,87076891.58,-92,9787,9879,5538.217633,2574.813256
11SE,5250,1624,87184261.36,956,9261,8305,5915.575739,2238.560884
17NW,5250,1624,87184261.36,655,9470,8815,6393.080049,2075.301094
17SE,5250,1625,87237946.25,457,9959,9502,6362.279385,1887.775003
17SW,5250,1631,87560055.59,-1781,9823,11604,5421.150215,2568.507057
22S,5250,1628,87399000.92,-1781,9972,11753,4697.802211,2933.532616
23S,5250,1632,87613740.48,1335,9548,8213,3883.458946,2059.194547
24S,5250,1628,87399000.92,1175,8847,7672,7039.469902,2000.680117
27A,5250,1625,87237946.25,1487,9152,7665,6999.499077,1926.701797
2A,5250,1624,87184261.36,1668,9292,7624,6451.440271,1656.349561
5NE,5250,1623,87130576.47,-76,9736,9812,4680.449168,2319.894144
5NW,5250,1624,87184261.36,-1836,9736,11572,5377.379926,2243.302316
5SE,5250,1623,87130576.47,649,9804,9155,3897.446704,2376.907404
6NE,5250,1623,87130576.47,1796,9253,7457,7120.200863,1606.79783
6NW,5250,1622,87076891.58,674,9287,8613,5994.384094,2562.849876
6SW,5250,1623,87130576.47,1036,9804,8768,6731.358595,2105.26754
Cell 1 2011/12,5250,1621,87023206.69,1334,8995,7661,7066.074645,1417.808743
Cell 1 SW 2013,5250,1624,87184261.36,-1428,9210,10638,5164.475369,2078.579912
Cell 10 2011/12,5250,1621,87023206.69,629,9882,9253,5623.009254,2353.081454
Cell 10 NE 2011/12,5250,1624,87184261.36,-92,9882,9974,5531.702586,2529.923893
Cell 10 NW 2011/12,5250,1626,87291631.14,-1566,8869,10435,5596.298278,2303.304861
Cell 10 SE 2013,5250,1622,87076891.58,674,9287,8613,5994.384094,2562.849876
Cell 10 SW 2011/12,5250,1631,87560055.59,-1005,9882,10887,5347.119559,2501.794008
Cell 10-A 2011/12,5250,1626,87291631.14,-227,9882,10109,5516.766298,2512.87814
Cell 11 NE 2011/12,5250,1623,87130576.47,-92,9787,9879,6572.192853,2172.970353
Cell 11 NW 2013,5250,1622,87076891.58,1668,9292,7624,6457.029593,1650.025794
Cell 11 SW 2013,5250,1622,87076891.58,1254,9287,8033,7082.390259,1837.663736
Cell 12 2013,5250,1624,87184261.36,1474,9571,8097,6943.121305,1733.885048
Cell 13 2013,5250,1624,87184261.36,1806,8423,6617,6888.431034,1538.174726
Cell 14 2013,5250,1624,87184261.36,4978,8863,3885,7919.583744,401.2340835
Cell 15 2013,5250,1622,87076891.58,5061,8777,3716,7939.556104,388.3262532
Cell 15-A 2013,5250,1624,87184261.36,6215,8798,2583,7999.975985,386.7179508
Cell 16 2013,5250,1626,87291631.14,6215,8963,2748,7969.855474,396.1220141
Cell 17 NW 2011/12,5250,1624,87184261.36,655,9470,8815,6393.080049,2075.301094
Cell 17 NW 2013,5250,1622,87076891.58,-1836,9736,11572,5834.134402,1995.490783
Cell 17 SE 2013,5250,1626,87291631.14,-1566,8869,10435,5599.025215,2303.01163
Cell 17 SW 2013,5250,1626,87291631.14,-1836,9972,11808,6180.583641,1700.255452
Cell 18 2011/12,5250,1624,87184261.36,705,9950,9245,4604.636084,2624.348478
Cell 18 NE 2013,5250,1624,87184261.36,1036,9804,8768,6777.810345,2099.857918
Cell 18 NW 2013,5250,1624,87184261.36,649,9804,9155,3886.910714,2352.328474
Cell 18 SE 2013,5250,1622,87076891.58,-92,9787,9879,6571.295314,2173.339321
Cell 18 SSE 2013,5250,1621,87023206.69,-92,9787,9879,5536.867366,2536.515628
Cell 19 NW 2013,5250,1623,87130576.47,1254,9287,8033,6922.388786,2017.958387
Cell 2 2011/12,5250,1624,87184261.36,1796,9292,7496,6309.10899,1706.972088
Cell 2 NE 2013,5250,1628,87399000.92,-1954,9266,11220,6644.723587,1706.546812
Cell 2 SW 2013,5250,1622,87076891.58,1334,8995,7661,7063.275586,1422.022666
Cell 20 2013,5250,1623,87130576.47,1474,9548,8074,6916.624153,1808.353303
Cell 21 2013,5250,1623,87130576.47,2206,8970,6764,7464.475662,1106.615776
Cell 22 2013,5250,1625,87237946.25,5845,8920,3075,8003.764923,478.6545002
Cell 23 2013,5250,1623,87130576.47,5845,8920,3075,8231.648182,449.9403521
Cell 24 2013,5250,1623,87130576.47,5858,8963,3105,7970.885397,389.1151872
Cell 25 NE 2013,5250,1621,87023206.69,629,9882,9253,5623.009254,2353.081454
Cell 25 SE 2013,5250,1630,87506370.7,-1005,9882,10887,5344.762577,2500.750352
Cell 26 NE 2013,5250,1633,87667425.37,190,9787,9597,5448.620943,2363.409339
Cell 26 NNW 2013,5250,1624,87184261.36,-92,9882,9974,5531.702586,2529.923893
Cell 26 NW 2013,5250,1626,87291631.14,-227,9882,10109,5516.766298,2512.87814
Cell 27 NW 2013,5250,1624,87184261.36,956,9261,8305,5915.575739,2238.560884
Cell 28 2013,5250,1632,87613740.48,1111,9418,8307,4550.547794,2330.043094
Cell 29 2013,5250,1623,87130576.47,1877,9552,7675,7013.553296,1552.223574
Cell 3 NE 2013,5250,1623,87130576.47,-1958,9038,10996,7331.14849,1275.041566
Cell 3 NW 2013,5250,1623,87130576.47,-1954,9266,11220,6817.100431,1663.716204
Cell 30 2013,5250,1626,87291631.14,6464,8980,2516,8132.082411,369.8491838
Cell 31 2013,5250,1631,87560055.59,5717,8921,3204,8120.367259,417.1526318
Cell 32 2013,5250,1628,87399000.92,5623,8938,3315,7893.145577,524.6411904
Cell 33 NE 2013,5250,1624,87184261.36,655,9470,8815,6393.080049,2075.301094
Cell 33 SE 2013,5250,1633,87667425.37,-1781,9823,11604,5423.405389,2567.929276
Cell 33 SW 2013,5250,1622,87076891.58,-159,9547,9706,4671.067818,2763.16805
Cell 34 N 2013,5250,1622,87076891.58,812,9728,8916,6682.912454,1817.765711
Cell 34 NW 2013,5250,1624,87184261.36,457,9693,9236,6914.981527,1454.610812
Cell 34 SE 2013,5250,1624,87184261.36,457,9959,9502,6365.567118,1885.994777
Cell 35 2013,5250,1619,86915836.91,705,9950,9245,4611.874614,2625.91597
Cell 37 2013,5250,1623,87130576.47,5854,8786,2932,8039.452865,369.458769
Cell 38 2013,5250,1630,87506370.7,6445,8956,2511,8170.213497,376.6175532
Cell 39 2013,5250,1624,87184261.36,6412,9081,2669,8338.054187,426.4383262
Cell 4 2013,5250,1626,87291631.14,5514,8536,3022,7833.915744,338.2206619
Cell 40 NE 2013,5250,1620,86969521.8,-1781,9834,11615,4947.777778,2801.067241
Cell 41 N 2013,5250,1629,87452685.81,-1781,9972,11753,6317.895641,2325.623951
Cell 41 NW 2013,5250,1621,87023206.69,-1781,9972,11753,5765.838371,2682.056843
Cell 42 NW 2013,5250,1627,87345316.03,418,9298,8880,5003.100799,2690.60004
Cell 43 2013,5250,1634,87721110.26,1292,9652,8360,6475.416769,2069.892841
Cell 44 2013,5250,1628,87399000.92,5329,8672,3343,7848.05344,494.5520622
Cell 45 2013,5250,1625,87237946.25,6391,8763,2372,8087.252308,388.1865773
Cell 47 2013,5250,1622,87076891.58,853,9372,8519,6640.72688,2164.274774
Cell 48 2013,5250,1628,87399000.92,1175,8847,7672,7032.007371,2008.970648
Cell 49 2013,5250,1623,87130576.47,1436,9629,8193,7119.823167,1528.853554
Cell 5 2011/12 Summer,5250,1626,87291631.14,-1836,9972,11808,6180.583641,1700.255452
Cell 5 2013,5250,1624,87184261.36,5788,8750,2962,7969.219828,378.3468143
Cell 50 2013,5250,1629,87452685.81,1685,9692,8007,7468.50706,1265.180531
Cell 51 2013,5250,1635,87774795.15,6670,9085,2415,8232.333945,356.8467695
Cell 52 2013,5250,1626,87291631.14,1382,8787,7405,7501.140836,1463.395612
Cell 53 2013,5250,1628,87399000.92,1375,8606,7231,7450.500614,1372.542567
Cell 54 2013,5250,1625,87237946.25,5568,8970,3402,8076.480615,615.2300241
Cell 55 2013,5250,1624,87184261.36,6255,8903,2648,8169.801724,519.8240384
Cell 56 2013,5250,1632,87613740.48,5522,9074,3552,7290.569853,581.6381542
Cell 57 2013,5250,1625,87237946.25,1681,8980,7299,7030.331077,1424.788872
Cell 58 2013,5250,1623,87130576.47,5633,8912,3279,8305.805299,444.6110476
Cell 59 2013,5250,1624,87184261.36,3164,9542,6378,7345.149631,543.1647981
Cell 6 2011/12,5250,1624,87184261.36,1254,9287,8033,6901.527709,2004.46207
Cell 6 2013,5250,1624,87184261.36,5788,8738,2950,8042.940887,343.9336722
Cell 6 NE 2011/12,5250,1623,87130576.47,1796,9253,7457,7120.200863,1606.79783
Cell 6 NW 2011/12,5250,1622,87076891.58,674,9287,8613,5994.384094,2562.849876
Cell 6 SW 2011/12,5250,1623,87130576.47,1036,9804,8768,6731.358595,2105.26754
Cell 60 2013,5250,1629,87452685.81,3203,8555,5352,7156.189073,863.6557046
Cell 61 2013,5250,1625,87237946.25,3582,8791,5209,7654.389538,783.695887
Cell 7 2013,5250,1636,87828480.04,4961,8935,3974,7852.216381,553.3865065
Cell 9 NW 2013,5250,1623,87130576.47,-76,9550,9626,4850.508934,2288.680348
Cell 9 SE 2013,5250,1623,87130576.47,-76,9736,9812,4680.449168,2319.894144
Cell 9 SW 2013,5250,1622,87076891.58,-1836,9736,11572,5376.225031,2244.44368
Cell R1,5250,1617,86808467.13,1239,8485,7246,5850.683364,1953.183899
Cell R10,5250,1626,87291631.14,5514,8536,3022,7833.915744,338.2206619
Cell R100,5250,1629,87452685.81,1685,9692,8007,7468.50706,1265.180531
Cell R101,5250,1625,87237946.25,5543,9085,3542,8027.080615,462.9011301
Cell R104,5250,1629,87452685.81,1301,9468,8167,7080.385513,2090.589904
Cell R105,5250,1627,87345316.03,1375,8606,7231,7449.955747,1372.788279
Cell R106,5250,1623,87130576.47,1520,9692,8172,7359.080099,1450.770248
Cell R107,5250,1624,87184261.36,5568,8970,3402,8077.216749,614.7035699
Cell R11,5250,1624,87184261.36,5788,8750,2962,7969.070813,378.3256026
Cell R111,5250,1628,87399000.92,1421,9468,8047,6958.711916,2186.893005
Cell R112,5250,1623,87130576.47,2289,8688,6399,7938.756007,558.815086
Cell R113,5250,1625,87237946.25,1681,8980,7299,7030.331077,1424.788872
Cell R114,5250,1623,87130576.47,5633,8912,3279,8305.805299,444.6110476
Cell R117,5250,1626,87291631.14,1430,9079,7649,6569.557811,1844.581532
Cell R118,5250,1631,87560055.59,5522,9074,3552,7290.179031,581.6021739
Cell R119,5250,1629,87452685.81,1681,8542,6861,6742.807244,1436.956692
Cell R120,5250,1620,86969521.8,2412,8736,6324,7547.688889,928.6133693
Cell R121,5250,1625,87237946.25,6617,8802,2185,8121.723692,377.3062571
Cell R123,5250,1626,87291631.14,1473,9542,8069,7224.539975,1234.345906
Cell R124,5250,1625,87237946.25,2179,8555,6376,7129.270769,920.2671287
Cell R125,5250,1634,87721110.26,1894,8780,6886,6848.831089,1183.979046
Cell R126,5250,1629,87452685.81,3582,8780,5198,7532.965009,816.9695394
Cell R15,5250,1625,87237946.25,-1428,9210,10638,5162.435692,2079.565336
Cell R16,5250,1622,87076891.58,-76,9550,9626,4843.451295,2292.044224
Cell R17,5250,1624,87184261.36,1371,9513,8142,6853.566502,1838.034343
Cell R18,5250,1632,87613740.48,1668,9292,7624,6450.595588,1646.775279
Cell R19,5250,1623,87130576.47,1623,9498,7875,7063.94886,1830.012903
Cell R20,5250,1623,87130576.47,2251,8536,6285,7486.979051,1033.86419
Cell R21,5250,1623,87130576.47,2161,8863,6702,7549.443007,964.9850967
Cell R22,5250,1623,87130576.47,4978,8863,3885,7919.356131,401.2528455
Cell R24,5250,1622,87076891.58,-1836,9736,11572,5834.477805,1995.790918
Cell R25,5250,1624,87184261.36,649,9804,9155,3886.910714,2352.328474
Cell R26,5250,1628,87399000.92,674,9287,8613,5995.860565,2557.445326
Cell R27,5250,1621,87023206.69,1254,9287,8033,6925.779149,2015.085597
Cell R28,5250,1626,87291631.14,1373,9571,8198,6256.607626,2186.281304
Cell R29,5250,1623,87130576.47,1474,9548,8074,6916.624153,1808.353303
Cell R30,5250,1625,87237946.25,2556,8727,6171,7472.934154,898.1837235
Cell R31,5250,1629,87452685.81,4978,8727,3749,7828.360344,474.7636648
Cell R35,5250,1626,87291631.14,-1836,9972,11808,6180.583641,1700.255452
Cell R36,5250,1626,87291631.14,-1566,8869,10435,5596.298278,2303.304861
Cell R37,5250,1623,87130576.47,-92,9787,9879,6572.192853,2172.970353
Cell R38,5250,1636,87828480.04,1111,9787,8676,6017.795844,2425.044072
Cell R39,5250,1623,87130576.47,1499,9487,7988,7059.691312,1518.698401
Cell R40,5250,1623,87130576.47,2206,8970,6764,7464.475662,1106.615776
Cell R46,5250,1622,87076891.58,-1005,9882,10887,5328.45746,2597.743864
Cell R47,5250,1626,87291631.14,-227,9882,10109,5516.766298,2512.87814
Cell R48,5250,1633,87667425.37,190,9787,9597,5448.620943,2363.409339
Cell R49,5250,1624,87184261.36,956,9261,8305,5915.575739,2238.560884
Cell R5,5250,1623,87130576.47,-1428,8408,9836,5497.078866,1987.818452
Cell R50,5250,1630,87506370.7,1111,9418,8307,4546.712883,2328.815382
Cell R51,5250,1625,87237946.25,1889,9552,7663,7028.516308,1535.256526
Cell R52,5250,1628,87399000.92,2206,8914,6708,7489.163391,1012.192578
Cell R53,5250,1624,87184261.36,3451,8794,5343,7718.160099,595.3686828
Cell R54,5250,1631,87560055.59,5717,8921,3204,8120.367259,417.1526318
Cell R58,5250,1623,87130576.47,-908,9470,10378,4328.796673,2539.310889
Cell R59,5250,1624,87184261.36,655,9470,8815,6393.080049,2075.301094
Cell R6,5250,1621,87023206.69,1334,8995,7661,7064.136336,1422.03875
Cell R60,5250,1623,87130576.47,457,9693,9236,6914.386938,1454.861562
Cell R61,5250,1621,87023206.69,705,9950,9245,4616.018507,2626.949961
Cell R62,5250,1624,87184261.36,1104,9552,8448,4864.261084,2493.320999
Cell R63,5250,1624,87184261.36,1205,8912,7707,6769.741379,1715.891071
Cell R64,5250,1624,87184261.36,4051,8622,4571,7928.50431,411.6209786
Cell R65,5250,1626,87291631.14,6464,8980,2516,8132.082411,369.8491838
Cell R66,5250,1634,87721110.26,5623,8980,3357,8313.707466,485.1805177
Cell R69,5250,1622,87076891.58,-159,9547,9706,4671.067818,2763.16805
Cell R7,5250,1623,87130576.47,-1954,9266,11220,6817.100431,1663.716204
Cell R70,5250,1633,87667425.37,-1781,9823,11604,5423.405389,2567.929276
Cell R71,5250,1624,87184261.36,457,9959,9502,6365.567118,1885.994777
Cell R72,5250,1623,87130576.47,418,9950,9532,5291.170672,2539.84361
Cell R73,5250,1628,87399000.92,418,9950,9532,5131.864865,2679.568957
Cell R74,5250,1625,87237946.25,1333,9400,8067,6701.595077,2139.701544
Cell R75,5250,1623,87130576.47,5854,8786,2932,8039.452865,369.458769
Cell R76,5250,1630,87506370.7,6787,8980,2193,8248.111656,407.891628
Cell R77,5250,1630,87506370.7,6445,8956,2511,8170.213497,376.6175532
Cell R8,5250,1624,87184261.36,-1958,9038,10996,7300.964286,1295.955179
Cell R80,5250,1621,87023206.69,-1781,9834,11615,4945.470697,2801.742338
Cell R81,5250,1624,87184261.36,448,9972,9524,6392.118842,2253.361934
Cell R82,5250,1628,87399000.92,418,9298,8880,5005.145577,2691.03781
Cell R83,5250,1625,87237946.25,853,9571,8718,5707.051077,2571.613033
Cell R84,5250,1624,87184261.36,1175,9652,8477,5278.663793,2439.372739
Cell R85,5250,1634,87721110.26,1292,9652,8360,6475.416769,2069.892841
Cell R86,5250,1625,87237946.25,6104,8671,2567,7824.082462,405.7230802
Cell R87,5250,1625,87237946.25,6391,8763,2372,8087.252308,388.1865773
Cell R9,5250,1621,87023206.69,-1958,9038,10996,7358.900679,1245.013305
Cell R90,5250,1622,87076891.58,853,9372,8519,6640.72688,2164.274774
Cell R91,5250,1626,87291631.14,1175,8847,7672,7036.793973,2005.318963
Cell R92,5250,1625,87237946.25,1304,9904,8600,4534.032615,2453.974573
Cell R93,5250,1621,87023206.69,1436,9629,8193,7118.792721,1529.512788
Cell R97,5250,1629,87452685.81,1382,9152,7770,6981.53407,1929.021856
Cell R98,5250,1625,87237946.25,1443,8787,7344,7599.810462,1380.32508
Cell R99,5250,1626,87291631.14,1382,8787,7405,7501.140836,1463.395612
Cell S102,5250,1624,87184261.36,5712,9085,3373,8187.005542,445.368617
Cell S108,5250,1622,87076891.58,6255,8903,2648,8169.607275,519.8699916
Cell S13,5250,1623,87130576.47,6034,8945,2911,7982.354898,406.0191406
Cell S14,5250,1638,87935849.82,4961,8935,3974,7852.297924,553.1387829
Cell S2,5250,1624,87184261.36,5788,8738,2950,8042.940887,343.9336722
Cell S23,5250,1625,87237946.25,4961,8741,3780,7988.884923,451.4284824
Cell S32,5250,1625,87237946.25,4978,8903,3925,7948.582769,522.3955478
Cell S33,5250,1624,87184261.36,6215,8798,2583,7999.975985,386.7179508
Cell S34,5250,1623,87130576.47,5858,8963,3105,7970.885397,389.1151872
Cell S41,5250,1622,87076891.58,4158,8727,4569,7847.213933,522.4594691
Cell S42,5250,1623,87130576.47,5845,8920,3075,8231.617375,449.9447775
Cell S44,5250,1627,87345316.03,6035,9061,3026,8027.172096,441.1223183
Cell S56,5250,1630,87506370.7,5649,8938,3289,7687.113497,508.8790195
Cell S67,5250,1627,87345316.03,5623,8938,3315,7893.458513,524.6504804
Cell S78,5250,1624,87184261.36,6412,9081,2669,8338.054187,426.4383262
Cell S88,5250,1626,87291631.14,6639,9081,2442,8249.676507,418.8514899
Cell S94,5250,1627,87345316.03,6670,9085,2415,8293.491703,343.6506948
Cell S95,5250,1636,87828480.04,6670,9085,2415,8232.610636,356.9130887
W287,5250,1623,87130576.47,894,9204,8310,4120.973506,2040.136597
W295,5250,1623,87130576.47,1705,8785,7080,6814.579791,1666.8217
W338,5250,1622,87076891.58,697,9399,8702,4107.200986,2551.479679
W342,5250,1622,87076891.58,1110,8946,7836,5422.634402,2316.383801
W345,5250,1625,87237946.25,2250,8580,6330,7477.921846,565.3198333
W387,5250,1623,87130576.47,1121,9470,8349,5387.869994,2264.577257
W393,5250,1622,87076891.58,1118,8786,7668,6021.084464,2101.075249
W440,5250,1621,87023206.69,1101,8767,7666,4984.36459,2054.22158
W441,5250,1623,87130576.47,1501,9239,7738,6964.581639,865.5605426
W445,5250,1620,86969521.8,2669,8548,5879,6808.508025,888.3394103
W500,5250,1622,87076891.58,1196,8546,7350,6183.225647,1880.942792
1,5500,1783,95720158.87,1267,8995,7728,6921.226584,1560.394273
2,5500,1776,95344364.64,1683,9292,7609,6305.209459,1735.868574
3,5500,1785,95827528.65,1653,9270,7617,7440.045378,1280.855556
4,5500,1786,95881213.54,1908,8536,6628,7473.945129,1076.514828
5,5500,1783,95720158.87,-1836,9972,11808,6154.358946,1732.214066
6,5500,1781,95612789.09,1254,9287,8033,6803.509264,2081.179639
7,5500,1782,95666473.98,1373,9571,8198,6854.895062,1797.242284
8,5500,1785,95827528.65,1806,8516,6710,6970.14958,1500.05664
9,5500,1789,96042268.21,4978,8903,3925,7932.126887,522.4157725
10,5500,1778,95451734.42,201,9882,9681,5519.805399,2399.210485
11,5500,1785,95827528.65,-92,9787,9879,5506.272829,2380.702933
12,5500,1788,95988583.32,1111,9418,8307,4557.82774,2345.674685
13,5500,1785,95827528.65,1877,9552,7675,6963.867787,1590.516496
14,5500,1787,95934898.43,6238,8901,2663,8092.601007,383.2447415
16,5500,1786,95881213.54,-159,9547,9706,4842.960806,2756.18474
17,5500,1786,95881213.54,457,9823,9366,6893.240202,1497.419347
18,5500,1774,95236994.86,705,9950,9245,4657.732244,2623.663514
19,5500,1782,95666473.98,1104,9552,8448,4943.972503,2490.294884
20,5500,1788,95988583.32,4051,8786,4735,8023.237696,401.6238334
21,5500,1781,95612789.09,6445,8956,2511,8184.576642,373.9018304
22,5500,1780,95559104.2,-1781,9972,11753,4910.362921,2970.148668
23,5500,1780,95559104.2,418,9298,8880,5140.145506,2684.931329
24,5500,1784,95773843.76,1175,8847,7672,6983.351457,2035.202468
25,5500,1781,95612789.09,1436,9629,8193,7074.614262,1613.650881
26,5500,1783,95720158.87,6104,8798,2694,8083.245653,402.394591
27,5500,1786,95881213.54,1443,8787,7344,7505.168533,1525.044254
28,5500,1786,95881213.54,1375,9129,7754,7390.12766,1498.395328
29,5500,1790,96095953.1,1375,9692,8317,7433.757542,1315.926759
31,5500,1782,95666473.98,1740,9074,7334,7649.094837,1206.24415
32,5500,1784,95773843.76,1681,8980,7299,7051.94787,1391.107559
33,5500,1789,96042268.21,5473,9074,3601,7311.990497,595.1432363
34,5500,1778,95451734.42,2484,8482,5998,7042.184477,930.0210774
10A,5500,1785,95827528.65,-507,9882,10389,5351.664986,2601.201828
10NE,5500,1785,95827528.65,-92,9882,9974,5427.008964,2571.237386
10NW,5500,1783,95720158.87,-1566,8869,10435,5514.775098,2343.190465
10SW,5500,1785,95827528.65,-1005,9882,10887,5383.729972,2537.256781
11NE,5500,1776,95344364.64,-92,9787,9879,6495.782095,2252.604424
11NW,5500,1787,95934898.43,-92,9787,9879,5511.855064,2556.339425
11SE,5500,1780,95559104.2,956,9261,8305,5939.231461,2236.031346
17NW,5500,1782,95666473.98,655,9693,9038,6381.618967,2068.990498
17SE,5500,1782,95666473.98,457,9959,9502,6299.425926,1946.433969
17SW,5500,1784,95773843.76,-1781,9823,11604,5433.838004,2577.121403
22S,5500,1784,95773843.76,-1781,9972,11753,4670.76065,2967.537906
23S,5500,1788,95988583.32,1335,9548,8213,3976.639821,2104.843125
24S,5500,1783,95720158.87,1175,8847,7672,6958.574313,2054.918892
27A,5500,1784,95773843.76,1487,9152,7665,7030.455717,1916.6317
2A,5500,1786,95881213.54,1668,9292,7624,6469.156215,1639.130168
5NE,5500,1783,95720158.87,-76,9736,9812,4688.555244,2312.4943
5NW,5500,1775,95290679.75,-1836,9736,11572,5310.721127,2253.254512
5SE,5500,1784,95773843.76,649,9804,9155,3995.794283,2388.79783
6NE,5500,1779,95505419.31,1796,9287,7491,7049.395728,1665.066406
6NW,5500,1777,95398049.53,674,9287,8613,5953.362971,2587.938167
6SW,5500,1783,95720158.87,989,9804,8815,6670.859226,2146.776091
Cell 1 2011/12,5500,1783,95720158.87,1267,8995,7728,6921.226584,1560.394273
Cell 1 SW 2013,5500,1784,95773843.76,-1428,9210,10638,5195.508969,2086.827902
Cell 10 2011/12,5500,1778,95451734.42,201,9882,9681,5519.805399,2399.210485
Cell 10 NE 2011/12,5500,1785,95827528.65,-92,9882,9974,5427.008964,2571.237386
Cell 10 NW 2011/12,5500,1783,95720158.87,-1566,8869,10435,5514.775098,2343.190465
Cell 10 SE 2013,5500,1777,95398049.53,674,9287,8613,5953.362971,2587.938167
Cell 10 SW 2011/12,5500,1785,95827528.65,-1005,9882,10887,5383.729972,2537.256781
Cell 10-A 2011/12,5500,1785,95827528.65,-507,9882,10389,5351.664986,2601.201828
Cell 11 NE 2011/12,5500,1776,95344364.64,-92,9787,9879,6495.782095,2252.604424
Cell 11 NW 2013,5500,1788,95988583.32,1668,9292,7624,6425.454698,1665.387596
Cell 11 SW 2013,5500,1784,95773843.76,1254,9287,8033,7007.914238,1870.929447
Cell 12 2013,5500,1782,95666473.98,1373,9571,8198,6858.220539,1794.178207
Cell 13 2013,5500,1787,95934898.43,1806,8515,6709,6927.608282,1523.248416
Cell 14 2013,5500,1787,95934898.43,4978,8863,3885,7908.056519,426.3112491
Cell 15 2013,5500,1785,95827528.65,5061,8777,3716,7941.365266,406.5018217
Cell 15-A 2013,5500,1789,96042268.21,6215,8933,2718,8010.267747,382.5389196
Cell 16 2013,5500,1780,95559104.2,6215,8963,2748,7973.629213,397.0993418
Cell 17 NW 2011/12,5500,1782,95666473.98,655,9693,9038,6381.618967,2068.990498
Cell 17 NW 2013,5500,1777,95398049.53,-1836,9736,11572,5788.84018,2017.294503
Cell 17 SE 2013,5500,1782,95666473.98,-1566,8869,10435,5515.047699,2343.819569
Cell 17 SW 2013,5500,1787,95934898.43,-1836,9972,11808,6165.047566,1727.322495
Cell 18 2011/12,5500,1774,95236994.86,705,9950,9245,4657.732244,2623.663514
Cell 18 NE 2013,5500,1787,95934898.43,1036,9804,8768,6763.424734,2110.955011
Cell 18 NW 2013,5500,1776,95344364.64,649,9804,9155,3981.818131,2370.86438
Cell 18 SE 2013,5500,1777,95398049.53,-92,9787,9879,6493.290377,2254.417389
Cell 18 SSE 2013,5500,1779,95505419.31,-92,9787,9879,5519.373243,2530.26083
Cell 19 NW 2013,5500,1783,95720158.87,1254,9287,8033,6821.587213,2084.674347
Cell 2 2011/12,5500,1776,95344364.64,1683,9292,7609,6305.209459,1735.868574
Cell 2 NE 2013,5500,1782,95666473.98,-1954,9266,11220,6643.443883,1693.854545
Cell 2 SW 2013,5500,1779,95505419.31,1267,8995,7728,6923.788645,1559.627502
Cell 20 2013,5500,1788,95988583.32,1474,9548,8074,6891.661633,1803.163888
Cell 21 2013,5500,1787,95934898.43,2206,8970,6764,7463.046447,1096.710336
Cell 22 2013,5500,1786,95881213.54,5845,8920,3075,8013.43505,472.3121091
Cell 23 2013,5500,1778,95451734.42,5845,8920,3075,8226.360517,443.6907877
Cell 24 2013,5500,1780,95559104.2,5858,8963,3105,7966.368539,397.3010818
Cell 25 NE 2013,5500,1778,95451734.42,201,9882,9681,5519.805399,2399.210485
Cell 25 SE 2013,5500,1785,95827528.65,-1005,9882,10887,5383.729972,2537.256781
Cell 26 NE 2013,5500,1783,95720158.87,-92,9787,9879,5503.266405,2380.327535
Cell 26 NNW 2013,5500,1785,95827528.65,-92,9882,9974,5427.008964,2571.237386
Cell 26 NW 2013,5500,1784,95773843.76,-507,9882,10389,5351.496637,2601.921041
Cell 27 NW 2013,5500,1780,95559104.2,956,9261,8305,5939.231461,2236.031346
Cell 28 2013,5500,1788,95988583.32,1111,9418,8307,4557.82774,2345.674685
Cell 29 2013,5500,1785,95827528.65,1877,9552,7675,6963.867787,1590.516496
Cell 3 NE 2013,5500,1785,95827528.65,-1958,9038,10996,7331.752381,1252.545866
Cell 3 NW 2013,5500,1781,95612789.09,-1954,9266,11220,6780.165076,1682.928289
Cell 30 2013,5500,1776,95344364.64,4051,8980,4929,8129.955518,390.0676133
Cell 31 2013,5500,1785,95827528.65,5717,8921,3204,8128.652661,417.0401499
Cell 32 2013,5500,1785,95827528.65,5623,8938,3315,7908.365826,527.0250039
Cell 33 NE 2013,5500,1782,95666473.98,655,9693,9038,6381.618967,2068.990498
Cell 33 SE 2013,5500,1783,95720158.87,-1781,9823,11604,5431.220976,2580.162828
Cell 33 SW 2013,5500,1785,95827528.65,-159,9547,9706,4762.206723,2783.015986
Cell 34 N 2013,5500,1786,95881213.54,705,9728,9023,6693.034155,1834.202638
Cell 34 NW 2013,5500,1785,95827528.65,457,9823,9366,6892.52381,1497.532726
Cell 34 SE 2013,5500,1784,95773843.76,457,9959,9502,6304.348094,1944.448055
Cell 35 2013,5500,1779,95505419.31,705,9950,9245,4635.847667,2610.313377
Cell 37 2013,5500,1782,95666473.98,4051,8786,4735,8020.136364,414.5570052
Cell 38 2013,5500,1787,95934898.43,6445,8956,2511,8187.640739,374.0284122
Cell 39 2013,5500,1788,95988583.32,6412,9081,2669,8324.330537,433.1296529
Cell 4 2013,5500,1783,95720158.87,5514,8595,3081,7841.209198,342.442673
Cell 40 NE 2013,5500,1780,95559104.2,-1781,9834,11615,4948.253371,2808.687442
Cell 41 N 2013,5500,1786,95881213.54,-1781,9972,11753,6250.226764,2349.228284
Cell 41 NW 2013,5500,1783,95720158.87,-1781,9972,11753,5772.981492,2664.669147
Cell 42 NW 2013,5500,1787,95934898.43,418,9298,8880,5110.117515,2676.881464
Cell 43 2013,5500,1787,95934898.43,1292,9652,8360,6430.215445,2106.878851
Cell 44 2013,5500,1786,95881213.54,4319,8672,4353,7841.120381,529.1808673
Cell 45 2013,5500,1780,95559104.2,6104,8798,2694,8083.570787,402.4799598
Cell 47 2013,5500,1786,95881213.54,853,9372,8519,6682.949608,2160.642453
Cell 48 2013,5500,1783,95720158.87,1175,8847,7672,6961.02636,2054.027164
Cell 49 2013,5500,1781,95612789.09,1436,9629,8193,7074.614262,1613.650881
Cell 5 2011/12 Summer,5500,1788,95988583.32,-1836,9972,11808,6163.893177,1727.528778
Cell 5 2013,5500,1785,95827528.65,5788,8863,3075,7969.664986,380.3133911
Cell 50 2013,5500,1789,96042268.21,1375,9692,8317,7433.344885,1316.178701
Cell 51 2013,5500,1788,95988583.32,6670,9085,2415,8226.475951,362.4135043
Cell 52 2013,5500,1786,95881213.54,1382,8787,7405,7454.468645,1534.03296
Cell 53 2013,5500,1786,95881213.54,1375,9129,7754,7390.12766,1498.395328
Cell 54 2013,5500,1782,95666473.98,5568,8970,3402,8069.853535,617.8707522
Cell 55 2013,5500,1785,95827528.65,6255,8903,2648,8168.751261,525.608027
Cell 56 2013,5500,1786,95881213.54,5473,9074,3601,7310.231243,595.0903314
Cell 57 2013,5500,1781,95612789.09,1681,8980,7299,7050.982594,1392.0174
Cell 58 2013,5500,1787,95934898.43,5568,8912,3344,8284.31897,475.5784368
Cell 59 2013,5500,1775,95290679.75,1737,9542,7805,7324.031549,632.6169178
Cell 6 2011/12,5500,1781,95612789.09,1254,9287,8033,6803.509264,2081.179639
Cell 6 2013,5500,1782,95666473.98,5788,8738,2950,8045.851852,341.7656659
Cell 6 NE 2011/12,5500,1779,95505419.31,1796,9287,7491,7049.395728,1665.066406
Cell 6 NW 2011/12,5500,1777,95398049.53,674,9287,8613,5953.362971,2587.938167
Cell 6 SW 2011/12,5500,1783,95720158.87,989,9804,8815,6670.859226,2146.776091
Cell 60 2013,5500,1787,95934898.43,2179,8555,6376,7102.343593,927.5308676
Cell 61 2013,5500,1782,95666473.98,3582,8825,5243,7657.727834,790.9581621
Cell 7 2013,5500,1788,95988583.32,4961,8935,3974,7866.003915,551.1178415
Cell 9 NW 2013,5500,1778,95451734.42,-76,9550,9626,4815.692351,2275.49333
Cell 9 SE 2013,5500,1783,95720158.87,-76,9736,9812,4688.555244,2312.4943
Cell 9 SW 2013,5500,1774,95236994.86,-1836,9736,11572,5309.484216,2252.887865
Cell R1,5500,1781,95612789.09,1239,8485,7246,5840.305446,1943.158147
Cell R10,5500,1781,95612789.09,5514,8595,3081,7841.244245,342.5790111
Cell R100,5500,1790,96095953.1,1375,9692,8317,7430.060335,1323.124638
Cell R101,5500,1784,95773843.76,5543,9085,3542,8023.886211,472.7669862
Cell R104,5500,1784,95773843.76,1301,9468,8167,7075.570628,2083.153951
Cell R105,5500,1786,95881213.54,1375,9129,7754,7390.12766,1498.395328
Cell R106,5500,1780,95559104.2,1375,9692,8317,7359.948315,1472.383972
Cell R107,5500,1781,95612789.09,5568,8970,3402,8069.836047,618.0437487
Cell R11,5500,1786,95881213.54,5788,8863,3075,7969.447928,380.3174851
Cell R111,5500,1785,95827528.65,1301,9468,8167,6920.692437,2220.967107
Cell R112,5500,1788,95988583.32,2289,8688,6399,7900.301454,645.3611706
Cell R113,5500,1782,95666473.98,1681,8980,7299,7051.345118,1391.710863
Cell R114,5500,1788,95988583.32,5568,8912,3344,8284.319351,475.4454268
Cell R117,5500,1776,95344364.64,1430,9542,8112,6553.776464,1873.291945
Cell R118,5500,1786,95881213.54,5473,9074,3601,7310.231243,595.0903314
Cell R119,5500,1783,95720158.87,1681,8596,6915,6780.466068,1417.270348
Cell R120,5500,1784,95773843.76,2412,8736,6324,7547.869955,937.2845863
Cell R121,5500,1788,95988583.32,6617,8802,2185,8134.538031,371.9493907
Cell R123,5500,1786,95881213.54,1441,9542,8101,7164.399776,1320.325692
Cell R124,5500,1787,95934898.43,1894,8555,6661,7077.401231,966.1006514
Cell R125,5500,1788,95988583.32,1894,8780,6886,6856.598993,1168.288086
Cell R126,5500,1790,96095953.1,3076,8780,5704,7510.683799,856.1359643
Cell R15,5500,1785,95827528.65,-1428,9210,10638,5193.093557,2088.736276
Cell R16,5500,1779,95505419.31,-76,9550,9626,4808.76054,2276.937354
Cell R17,5500,1785,95827528.65,1371,9513,8142,6734.996078,1935.653375
Cell R18,5500,1788,95988583.32,1668,9292,7624,6429.895973,1660.793072
Cell R19,5500,1780,95559104.2,1623,9571,7948,7038.453933,1833.457346
Cell R20,5500,1787,95934898.43,2010,8536,6526,7471.906547,1069.785616
Cell R21,5500,1788,95988583.32,2161,8863,6702,7513.675615,1043.702078
Cell R22,5500,1787,95934898.43,4978,8863,3885,7908.056519,426.3112491
Cell R24,5500,1777,95398049.53,-1836,9736,11572,5788.84018,2017.294503
Cell R25,5500,1776,95344364.64,649,9804,9155,3981.818131,2370.86438
Cell R26,5500,1784,95773843.76,674,9287,8613,5958.477018,2580.179835
Cell R27,5500,1782,95666473.98,1254,9287,8033,6822.559484,2084.855007
Cell R28,5500,1785,95827528.65,1373,9571,8198,6233.840896,2204.956377
Cell R29,5500,1789,96042268.21,1474,9548,8074,6892.322527,1802.87646
Cell R30,5500,1785,95827528.65,2385,8727,6342,7477.176471,916.3422927
Cell R31,5500,1785,95827528.65,4978,8730,3752,7819.383754,482.1911532
Cell R35,5500,1788,95988583.32,-1836,9972,11808,6163.893177,1727.528778
Cell R36,5500,1783,95720158.87,-1566,8869,10435,5514.775098,2343.190465
Cell R37,5500,1777,95398049.53,-92,9787,9879,6493.775464,2253.557714
Cell R38,5500,1785,95827528.65,1111,9787,8676,5972.161345,2450.028706
Cell R39,5500,1783,95720158.87,1499,9487,7988,7014.269209,1600.833097
Cell R40,5500,1787,95934898.43,2206,8970,6764,7461.311696,1098.572372
Cell R46,5500,1782,95666473.98,-1005,9882,10887,5253.680135,2619.561213
Cell R47,5500,1785,95827528.65,-507,9882,10389,5351.664986,2601.201828
Cell R48,5500,1784,95773843.76,-92,9787,9879,5504.571188,2380.298022
Cell R49,5500,1781,95612789.09,956,9261,8305,5939.259966,2235.403835
Cell R5,5500,1778,95451734.42,-1428,8571,9999,5529.739033,1980.249726
Cell R50,5500,1788,95988583.32,1111,9418,8307,4557.82774,2345.674685
Cell R51,5500,1786,95881213.54,1877,9552,7675,6976.211646,1579.40945
Cell R52,5500,1790,96095953.1,2206,8914,6708,7478.753631,1007.201046
Cell R53,5500,1786,95881213.54,3451,8794,5343,7708.258119,617.4041357
Cell R54,5500,1786,95881213.54,5717,8921,3204,8128.281075,417.2188534
Cell R58,5500,1783,95720158.87,-908,9693,10601,4443.593943,2608.453176
Cell R59,5500,1782,95666473.98,655,9693,9038,6381.618967,2068.990498
Cell R6,5500,1779,95505419.31,1267,8995,7728,6924.029792,1558.996314
Cell R60,5500,1786,95881213.54,457,9823,9366,6893.240202,1497.419347
Cell R61,5500,1779,95505419.31,705,9950,9245,4635.847667,2610.313377
Cell R62,5500,1789,96042268.21,1104,9552,8448,4848.324203,2499.747477
Cell R63,5500,1787,95934898.43,1205,9552,8347,6736.274203,1765.312759
Cell R64,5500,1785,95827528.65,4051,8672,4621,7933.715966,411.4156969
Cell R65,5500,1776,95344364.64,4051,8980,4929,8129.955518,390.0676133
Cell R66,5500,1789,96042268.21,5623,8980,3357,8300.549469,487.3503433
Cell R69,5500,1786,95881213.54,-159,9547,9706,4760.389698,2783.295653
Cell R7,5500,1780,95559104.2,-1954,9266,11220,6780.501124,1683.341217
Cell R70,5500,1784,95773843.76,-1781,9823,11604,5430.009529,2579.946767
Cell R71,5500,1785,95827528.65,457,9959,9502,6305.653221,1944.684778
Cell R72,5500,1785,95827528.65,418,9950,9532,5348.560224,2523.275419
Cell R73,5500,1785,95827528.65,418,9950,9532,5008.016807,2690.967036
Cell R74,5500,1783,95720158.87,1333,9400,8067,6653.59899,2169.892577
Cell R75,5500,1782,95666473.98,4051,8786,4735,8020.136364,414.5570052
Cell R76,5500,1788,95988583.32,6787,8980,2193,8249.383669,407.498637
Cell R77,5500,1787,95934898.43,6445,8956,2511,8187.640739,374.0284122
Cell R8,5500,1785,95827528.65,-1958,9038,10996,7284.42465,1277.244771
Cell R80,5500,1780,95559104.2,-1781,9834,11615,4948.253371,2808.687442
Cell R81,5500,1782,95666473.98,448,9972,9524,6409.092031,2237.169141
Cell R82,5500,1787,95934898.43,418,9298,8880,5110.117515,2676.881464
Cell R83,5500,1785,95827528.65,853,9571,8718,5792.369188,2550.546285
Cell R84,5500,1782,95666473.98,1175,9652,8477,5316.748597,2438.810263
Cell R85,5500,1787,95934898.43,1292,9652,8360,6430.215445,2106.878851
Cell R86,5500,1783,95720158.87,5588,9510,3922,7838.192372,428.7224791
Cell R87,5500,1780,95559104.2,6104,8798,2694,8083.570787,402.4799598
Cell R9,5500,1778,95451734.42,-1958,9038,10996,7379.65748,1221.756411
Cell R90,5500,1785,95827528.65,853,9372,8519,6682.083473,2160.937599
Cell R91,5500,1783,95720158.87,1175,8847,7672,6961.02636,2054.027164
Cell R92,5500,1785,95827528.65,1304,9904,8600,4678.797199,2490.55271
Cell R93,5500,1781,95612789.09,1436,9629,8193,7074.614262,1613.650881
Cell R97,5500,1787,95934898.43,1382,9152,7770,7014.63906,1921.057573
Cell R98,5500,1786,95881213.54,1443,8787,7344,7505.168533,1525.044254
Cell R99,5500,1786,95881213.54,1382,8787,7405,7454.468645,1534.03296
Cell S102,5500,1786,95881213.54,5712,9085,3373,8187.226204,443.7170117
Cell S108,5500,1786,95881213.54,6255,8903,2648,8168.096865,526.1877165
Cell S13,5500,1789,96042268.21,5654,8945,3291,7983.72834,411.6374601
Cell S14,5500,1788,95988583.32,4961,8935,3974,7866.003915,551.1178415
Cell S2,5500,1781,95612789.09,5788,8738,2950,8046.015722,341.7916049
Cell S23,5500,1786,95881213.54,4961,8741,3780,7984.62206,451.0533956
Cell S32,5500,1788,95988583.32,4978,8919,3941,7954.569911,516.5241235
Cell S33,5500,1789,96042268.21,6215,8933,2718,8010.267747,382.5389196
Cell S34,5500,1782,95666473.98,5858,8963,3105,7966.698653,397.2022692
Cell S41,5500,1788,95988583.32,4158,8727,4569,7829.801454,530.1995069
Cell S42,5500,1778,95451734.42,5845,8920,3075,8226.360517,443.6907877
Cell S44,5500,1785,95827528.65,6035,9061,3026,8029.239776,446.4038652
Cell S56,5500,1790,96095953.1,5645,8938,3293,7680.179888,515.3822371
Cell S67,5500,1785,95827528.65,5623,8938,3315,7908.365826,527.0250039
Cell S78,5500,1787,95934898.43,6412,9081,2669,8324.021824,433.0541245
Cell S88,5500,1786,95881213.54,6639,9081,2442,8252.62318,420.8463486
Cell S94,5500,1787,95934898.43,6670,9085,2415,8285.353665,345.004027
Cell S95,5500,1788,95988583.32,6670,9085,2415,8226.475951,362.4135043
W287,5500,1784,95773843.76,894,9204,8310,4142.602578,2052.93613
W295,5500,1783,95720158.87,1705,8785,7080,6808.643859,1688.021266
W338,5500,1777,95398049.53,697,9484,8787,4046.863815,2539.785386
W342,5500,1773,95183309.97,1043,8946,7903,5383.655386,2361.053424
W345,5500,1783,95720158.87,2065,8580,6515,7467.963545,636.8108271
W387,5500,1782,95666473.98,1121,9470,8349,5347.544332,2260.928151
W393,5500,1779,95505419.31,1118,8786,7668,5973.3457,2140.176439
W440,5500,1783,95720158.87,1101,8767,7666,5049.672462,2074.909899
W441,5500,1782,95666473.98,1439,9239,7800,6936.156566,934.8872434
W445,5500,1778,95451734.42,2651,8548,5897,6820.458943,900.0139317
W500,5500,1782,95666473.98,1196,8546,7350,6186.113917,1875.154673
1,5750,1948,104578165.7,-1954,9513,11467,6785.681211,1708.891938
2,5750,1950,104685535.5,1653,9292,7639,6305.076923,1758.623502
3,5750,1949,104631850.6,1653,9270,7617,7386.889174,1331.651578
4,5750,1950,104685535.5,1806,8536,6730,7457.267179,1119.069723
5,5750,1947,104524480.8,-1836,9972,11808,6134.553672,1755.054245
6,5750,1942,104256056.4,1254,9287,8033,6704.143666,2148.684254
7,5750,1949,104631850.6,1373,9571,8198,6772.469472,1853.12601
8,5750,1948,104578165.7,1806,8516,6710,7008.666324,1480.662518
9,5750,1949,104631850.6,4978,8919,3941,7927.655721,525.9987504
10,5750,1942,104256056.4,-419,9882,10301,5432.015963,2438.082373
11,5750,1954,104900275.1,-92,9787,9879,5586.623337,2398.65372
12,5750,1959,105168699.5,1111,9418,8307,4596.20929,2373.342613
13,5750,1954,104900275.1,1877,9552,7675,6929.206244,1620.042797
14,5750,1950,104685535.5,6238,8901,2663,8096.38,387.1042763
16,5750,1955,104953959.9,-159,9547,9706,4919.634271,2768.672541
17,5750,1953,104846590.2,457,9823,9366,6853.519201,1540.150403
18,5750,1950,104685535.5,705,9950,9245,4718.352821,2614.271527
19,5750,1950,104685535.5,1104,9552,8448,4928.447692,2500.928501
20,5750,1950,104685535.5,4051,8786,4735,8007.645641,434.2972208
21,5750,1948,104578165.7,6445,8956,2511,8199.904517,374.2376181
22,5750,1947,104524480.8,-1781,9972,11753,4887.360041,2997.435199
23,5750,1939,104095001.7,418,9298,8880,5241.938112,2666.468692
24,5750,1953,104846590.2,1125,9372,8247,6905.383001,2098.131433
25,5750,1943,104309741.3,1436,9629,8193,7012.130211,1710.845763
26,5750,1945,104417111.1,6104,8798,2694,8083.363496,410.9044235
27,5750,1949,104631850.6,1382,8942,7560,7395.182145,1679.528601
28,5750,1947,104524480.8,1375,9129,7754,7355.134566,1579.008749
29,5750,1956,105007644.8,1375,9692,8317,7382.536299,1383.724651
31,5750,1944,104363426.2,1604,9074,7470,7588.792695,1313.991292
32,5750,1950,104685535.5,1681,8980,7299,7076.666154,1360.523864
33,5750,1955,104953960,5206,9074,3868,7321.870588,613.932673
34,5750,1950,104685535.5,2484,8482,5998,7007.084103,974.7616714
10A,5750,1952,104792905.3,-507,9882,10389,5188.266906,2676.745029
10NE,5750,1948,104578165.7,-92,9882,9974,5324.274127,2591.987827
10NW,5750,1944,104363426.2,-1836,8869,10705,5482.540123,2347.031082
10SW,5750,1955,104953960,-1005,9882,10887,5426.214322,2562.395286
11NE,5750,1945,104417111.1,-92,9787,9879,6425.374807,2317.927137
11NW,5750,1954,104900275.1,-92,9787,9879,5516.012794,2543.153315
11SE,5750,1945,104417111.1,956,9261,8305,5964.364524,2235.809382
17NW,5750,1945,104417111.1,655,9693,9038,6370.611311,2065.385121
17SE,5750,1950,104685535.5,457,9959,9502,6229.962564,2020.344781
17SW,5750,1956,105007644.8,-1781,9823,11604,5439.111452,2588.439405
22S,5750,1945,104417111.1,-1781,9972,11753,4638.622622,2992.515633
23S,5750,1959,105168699.5,1335,9548,8213,4102.39612,2156.833271
24S,5750,1946,104470795.9,1125,9372,8247,6889.822713,2109.62214
27A,5750,1951,104739220.4,1487,9152,7665,7054.654024,1904.938632
2A,5750,1950,104685535.5,1668,9292,7624,6497.151795,1632.737874
5NE,5750,1946,104470795.9,-76,9736,9812,4664.739979,2313.532805
5NW,5750,1948,104578165.7,-1836,9736,11572,5247.005647,2253.02722
5SE,5750,1950,104685535.5,649,9804,9155,4118.375897,2430.440769
6NE,5750,1944,104363426.2,1522,9287,7765,6983.981996,1709.017062
6NW,5750,1943,104309741.3,674,9287,8613,5924.176016,2606.405713
6SW,5750,1943,104309741.3,738,9804,9066,6604.27895,2202.443587
Cell 1 2011/12,5750,1948,104578165.7,-1954,9513,11467,6785.681211,1708.891938
Cell 1 SW 2013,5750,1951,104739220.4,-1428,9210,10638,5251.04203,2092.894709
Cell 10 2011/12,5750,1942,104256056.4,-419,9882,10301,5432.015963,2438.082373
Cell 10 NE 2011/12,5750,1948,104578165.7,-92,9882,9974,5324.274127,2591.987827
Cell 10 NW 2011/12,5750,1944,104363426.2,-1836,8869,10705,5482.540123,2347.031082
Cell 10 SE 2013,5750,1945,104417111.1,674,9287,8613,5926.677635,2606.231964
Cell 10 SW 2011/12,5750,1955,104953960,-1005,9882,10887,5426.214322,2562.395286
Cell 10-A 2011/12,5750,1952,104792905.3,-507,9882,10389,5188.266906,2676.745029
Cell 11 NE 2011/12,5750,1945,104417111.1,-92,9787,9879,6425.374807,2317.927137
Cell 11 NW 2013,5750,1949,104631850.6,1668,9292,7624,6426.755259,1674.283593
Cell 11 SW 2013,5750,1947,104524480.8,1254,9287,8033,6949.791474,1901.627843
Cell 12 2013,5750,1946,104470795.9,1373,9571,8198,6767.38335,1855.11992
Cell 13 2013,5750,1948,104578165.7,1806,8516,6710,6969.2577,1501.493754
Cell 14 2013,5750,1955,104953960,4978,8863,3885,7899.542711,440.5872791
Cell 15 2013,5750,1950,104685535.5,5061,8777,3716,7946.751795,414.3598992
Cell 15-A 2013,5750,1949,104631850.6,6215,8933,2718,8016.763982,378.5422048
Cell 16 2013,5750,1945,104417111.1,6215,8963,2748,7976.875578,399.3206209
Cell 17 NW 2011/12,5750,1945,104417111.1,655,9693,9038,6370.611311,2065.385121
Cell 17 NW 2013,5750,1944,104363426.2,-1836,9736,11572,5768.324074,2029.686077
Cell 17 SE 2013,5750,1944,104363426.2,-1836,8869,10705,5482.540123,2347.031082
Cell 17 SW 2013,5750,1953,104846590.2,-1836,9972,11808,6128.185868,1762.444119
Cell 18 2011/12,5750,1950,104685535.5,705,9950,9245,4718.352821,2614.271527
Cell 18 NE 2013,5750,1953,104846590.2,1036,9804,8768,6719.58935,2143.448611
Cell 18 NW 2013,5750,1945,104417111.1,614,9804,9190,4114.600514,2409.788926
Cell 18 SE 2013,5750,1945,104417111.1,-92,9787,9879,6425.374807,2317.927137
Cell 18 SSE 2013,5750,1950,104685535.5,-92,9787,9879,5537.631795,2517.182471
Cell 19 NW 2013,5750,1947,104524480.8,1254,9287,8033,6755.676425,2120.149196
Cell 2 2011/12,5750,1950,104685535.5,1653,9292,7639,6305.076923,1758.623502
Cell 2 NE 2013,5750,1945,104417111.1,-1954,9266,11220,6658.283805,1677.420397
Cell 2 SW 2013,5750,1947,104524480.8,-1954,9513,11467,6783.614792,1713.440057
Cell 20 2013,5750,1949,104631850.6,1474,9548,8074,6868.874808,1796.500525
Cell 21 2013,5750,1949,104631850.6,2206,8970,6764,7454.831709,1089.87306
Cell 22 2013,5750,1944,104363426.2,5845,8920,3075,8015.489198,474.8057605
Cell 23 2013,5750,1944,104363426.2,5845,8920,3075,8221.180041,440.2845338
Cell 24 2013,5750,1948,104578165.7,5858,8963,3105,7960.126283,401.1055032
Cell 25 NE 2013,5750,1942,104256056.4,-419,9882,10301,5432.015963,2438.082373
Cell 25 SE 2013,5750,1955,104953960,-1005,9882,10887,5426.214322,2562.395286
Cell 26 NE 2013,5750,1955,104953959.9,-92,9787,9879,5587.84757,2398.650711
Cell 26 NNW 2013,5750,1948,104578165.7,-92,9882,9974,5324.274127,2591.987827
Cell 26 NW 2013,5750,1952,104792905.3,-507,9882,10389,5188.266906,2676.745029
Cell 27 NW 2013,5750,1946,104470795.9,956,9261,8305,5962.184995,2237.30066
Cell 28 2013,5750,1960,105222384.4,1111,9418,8307,4597.271429,2373.202757
Cell 29 2013,5750,1952,104792905.3,1877,9552,7675,6928.292008,1620.282842
Cell 3 NE 2013,5750,1948,104578165.7,-1958,9038,10996,7311.645791,1252.181709
Cell 3 NW 2013,5750,1952,104792905.3,-1954,9266,11220,6736.536373,1708.04409
Cell 30 2013,5750,1952,104792905.3,4051,8980,4929,8127.47541,410.9584389
Cell 31 2013,5750,1954,104900275.1,5717,8967,3250,8129.666837,424.0843397
Cell 32 2013,5750,1949,104631850.6,5623,8938,3315,7923.220113,529.9818823
Cell 33 NE 2013,5750,1945,104417111.1,655,9693,9038,6370.611311,2065.385121
Cell 33 SE 2013,5750,1958,105115014.6,-1781,9823,11604,5439.495914,2588.647253
Cell 33 SW 2013,5750,1947,104524480.8,-159,9547,9706,4825.052902,2783.632013
Cell 34 N 2013,5750,1947,104524480.8,705,9728,9023,6690.495121,1857.181141
Cell 34 NW 2013,5750,1953,104846590.2,457,9823,9366,6853.519201,1540.150403
Cell 34 SE 2013,5750,1950,104685535.5,457,9959,9502,6229.351795,2020.97123
Cell 35 2013,5750,1939,104095001.7,705,9950,9245,4644.884477,2600.835924
Cell 37 2013,5750,1947,104524480.8,4051,8786,4735,8003.878274,440.8896864
Cell 38 2013,5750,1953,104846590.2,6445,8956,2511,8203.601639,373.5541316
Cell 39 2013,5750,1951,104739220.4,6412,9081,2669,8317.704254,436.3163815
Cell 4 2013,5750,1946,104470795.9,4307,8595,4288,7838.311922,370.0825244
Cell 40 NE 2013,5750,1940,104148686.6,-1781,9834,11615,4956.262371,2812.351622
Cell 41 N 2013,5750,1955,104953960,-1781,9972,11753,6176.450639,2378.223217
Cell 41 NW 2013,5750,1949,104631850.6,-1781,9972,11753,5776.425859,2647.224164
Cell 42 NW 2013,5750,1952,104792905.3,418,9298,8880,5209.226947,2654.366349
Cell 43 2013,5750,1957,105061329.7,1292,9652,8360,6379.292284,2146.4409
Cell 44 2013,5750,1955,104953960,2233,8783,6550,7822.431714,631.5493115
Cell 45 2013,5750,1945,104417111.1,6104,8798,2694,8083.363496,410.9044235
Cell 47 2013,5750,1948,104578165.7,853,9372,8519,6709.997433,2149.639957
Cell 48 2013,5750,1945,104417111.1,1125,9372,8247,6889.43856,2110.013595
Cell 49 2013,5750,1943,104309741.3,1436,9629,8193,7011.352548,1710.679045
Cell 5 2011/12 Summer,5750,1953,104846590.2,-1836,9972,11808,6128.185868,1762.444119
Cell 5 2013,5750,1949,104631850.6,5788,8863,3075,7970.800924,385.1303823
Cell 50 2013,5750,1956,105007644.8,1375,9692,8317,7382.536299,1383.724651
Cell 51 2013,5750,1961,105276069.3,6670,9085,2415,8220.317695,366.1944161
Cell 52 2013,5750,1950,104685535.5,1382,8787,7405,7423.901538,1572.008433
Cell 53 2013,5750,1947,104524480.8,1375,9129,7754,7355.134566,1579.008749
Cell 54 2013,5750,1951,104739220.4,5101,8970,3869,8061.275756,626.7682061
Cell 55 2013,5750,1950,104685535.5,6255,8912,2657,8167.952821,519.9789905
Cell 56 2013,5750,1955,104953960,5206,9074,3868,7321.219949,613.428334
Cell 57 2013,5750,1950,104685535.5,1681,8980,7299,7075.598974,1360.74005
Cell 58 2013,5750,1949,104631850.6,5568,8912,3344,8270.954849,495.5008599
Cell 59 2013,5750,1952,104792905.3,1645,9542,7897,7289.034836,773.3043254
Cell 6 2011/12,5750,1942,104256056.4,1254,9287,8033,6704.143666,2148.684254
Cell 6 2013,5750,1943,104309741.3,5788,8738,2950,8042.703037,344.8440551
Cell 6 NE 2011/12,5750,1944,104363426.2,1522,9287,7765,6983.981996,1709.017062
Cell 6 NW 2011/12,5750,1943,104309741.3,674,9287,8613,5924.176016,2606.405713
Cell 6 SW 2011/12,5750,1943,104309741.3,738,9804,9066,6604.27895,2202.443587
Cell 60 2013,5750,1955,104953960,1894,8555,6661,7055.152941,980.4529073
Cell 61 2013,5750,1946,104470795.9,3582,8825,5243,7654.201439,805.694569
Cell 7 2013,5750,1958,105115014.6,4961,8959,3998,7880.139428,553.0890765
Cell 9 NW 2013,5750,1946,104470795.9,-76,9550,9626,4823.18962,2258.119453
Cell 9 SE 2013,5750,1946,104470795.9,-76,9736,9812,4664.739979,2313.532805
Cell 9 SW 2013,5750,1948,104578165.7,-1836,9736,11572,5249.344456,2251.789314
Cell R1,5750,1941,104202371.5,1239,8485,7246,5828.775889,1932.3817
Cell R10,5750,1946,104470795.9,4307,8595,4288,7838.311922,370.0825244
Cell R100,5750,1955,104953960,1375,9692,8317,7382.02046,1383.890466
Cell R101,5750,1950,104685535.5,5543,9085,3542,8021.980513,480.1172064
Cell R104,5750,1946,104470795.9,1301,9468,8167,7065.31295,2078.984264
Cell R105,5750,1947,104524480.8,1375,9129,7754,7355.134566,1579.008749
Cell R106,5750,1950,104685535.5,1375,9692,8317,7361.725641,1502.003457
Cell R107,5750,1951,104739220.4,5101,8970,3869,8061.275756,626.7682061
Cell R11,5750,1949,104631850.6,5788,8863,3075,7970.800924,385.1303823
Cell R111,5750,1950,104685535.5,1300,9468,8168,6890.362564,2243.806586
Cell R112,5750,1950,104685535.5,2289,8688,6399,7863.215385,691.0846568
Cell R113,5750,1950,104685535.5,1681,8980,7299,7075.598974,1360.74005
Cell R114,5750,1951,104739220.4,5568,8912,3344,8270.787801,495.6516785
Cell R117,5750,1948,104578165.7,1430,9542,8112,6528.799281,1907.007512
Cell R118,5750,1955,104953960,5206,9074,3868,7321.219949,613.428334
Cell R119,5750,1946,104470795.9,1681,8980,7299,6811.996403,1404.07156
Cell R120,5750,1941,104202371.5,2412,8736,6324,7541.848016,963.9381908
Cell R121,5750,1947,104524480.8,6617,8805,2188,8145.043657,367.3790591
Cell R123,5750,1948,104578165.7,1441,9542,8101,7119.059035,1371.77134
Cell R124,5750,1955,104953960,1894,8555,6661,7028.371867,1006.805918
Cell R125,5750,1959,105168699.5,1894,8780,6886,6867.167943,1154.69907
Cell R126,5750,1955,104953960,2412,8780,6368,7470.515601,923.343302
Cell R15,5750,1952,104792905.3,-1428,9210,10638,5250.577869,2092.458993
Cell R16,5750,1943,104309741.3,-76,9550,9626,4820.980957,2259.199382
Cell R17,5750,1953,104846590.2,1065,9513,8448,6613.493088,2030.599203
Cell R18,5750,1958,105115014.6,1668,9292,7624,6431.818182,1672.974213
Cell R19,5750,1947,104524480.8,1504,9571,8067,6998.242938,1849.466869
Cell R20,5750,1949,104631850.6,1908,8536,6628,7457.281683,1099.631569
Cell R21,5750,1949,104631850.6,2161,8863,6702,7492.19138,1095.620692
Cell R22,5750,1954,104900275.1,4978,8863,3885,7899.279427,440.5462248
Cell R24,5750,1944,104363426.2,-1836,9736,11572,5768.324074,2029.686077
Cell R25,5750,1945,104417111.1,614,9804,9190,4114.600514,2409.788926
Cell R26,5750,1944,104363426.2,674,9287,8613,5938.023663,2597.658385
Cell R27,5750,1947,104524480.8,1254,9287,8033,6755.676425,2120.149196
Cell R28,5750,1947,104524480.8,1373,9571,8198,6192.816127,2233.008497
Cell R29,5750,1949,104631850.6,1474,9548,8074,6868.874808,1796.500525
Cell R30,5750,1944,104363426.2,2239,8727,6488,7474.951132,942.1679367
Cell R31,5750,1952,104792905.3,4978,8740,3762,7811.100922,494.3474716
Cell R35,5750,1953,104846590.2,-1836,9972,11808,6128.185868,1762.444119
Cell R36,5750,1944,104363426.2,-1836,8869,10705,5482.540123,2347.031082
Cell R37,5750,1945,104417111.1,-92,9787,9879,6425.374807,2317.927137
Cell R38,5750,1956,105007644.8,1111,9787,8676,5913.084356,2467.778768
Cell R39,5750,1949,104631850.6,1368,9487,8119,6981.192919,1654.967162
Cell R40,5750,1950,104685535.5,2206,8970,6764,7454.703077,1089.608367
Cell R46,5750,1948,104578165.7,-1005,9882,10887,5217.38039,2626.701928
Cell R47,5750,1953,104846590.2,-507,9882,10389,5189.494624,2676.609326
Cell R48,5750,1956,105007644.8,-92,9787,9879,5589.436605,2399.066526
Cell R49,5750,1946,104470795.9,956,9261,8305,5962.184995,2237.30066
Cell R5,5750,1945,104417111,-1428,8571,9999,5565.280206,1978.310611
Cell R50,5750,1960,105222384.4,1111,9418,8307,4597.271429,2373.202757
Cell R51,5750,1955,104953960,1877,9552,7675,6933.515601,1616.271664
Cell R52,5750,1954,104900275.1,2206,8914,6708,7489.208291,987.9988424
Cell R53,5750,1949,104631850.6,3451,8794,5343,7708.02155,618.9996859
Cell R54,5750,1954,104900275.1,5717,8967,3250,8129.666837,424.0843397
Cell R58,5750,1950,104685535.5,-908,9693,10601,4545.883077,2673.104562
Cell R59,5750,1945,104417111.1,655,9693,9038,6370.611311,2065.385121
Cell R6,5750,1947,104524480.8,-1954,9513,11467,6782.862352,1714.881471
Cell R60,5750,1952,104792905.3,457,9823,9366,6853.622951,1540.538035
Cell R61,5750,1939,104095001.7,705,9950,9245,4644.884477,2600.835924
Cell R62,5750,1953,104846590.2,1104,9552,8448,4837.364055,2503.370175
Cell R63,5750,1951,104739220.4,1205,9552,8347,6690.410559,1820.875413
Cell R64,5750,1947,104524480.8,4051,8777,4726,7933.445814,419.6190761
Cell R65,5750,1952,104792905.3,4051,8980,4929,8127.023053,411.2838518
Cell R66,5750,1958,105115014.6,5623,8980,3357,8281.900409,490.5307696
Cell R69,5750,1946,104470795.9,-159,9547,9706,4823.364851,2783.350676
Cell R7,5750,1949,104631850.6,-1954,9266,11220,6737.841457,1708.020081
Cell R70,5750,1956,105007644.8,-1781,9823,11604,5436.748466,2588.53702
Cell R71,5750,1950,104685535.5,457,9959,9502,6229.351795,2020.97123
Cell R72,5750,1948,104578165.7,418,9950,9532,5422.873203,2505.377069
Cell R73,5750,1952,104792905.3,418,9950,9532,4912.375,2695.041377
Cell R74,5750,1950,104685535.5,1333,9400,8067,6594.744615,2209.887076
Cell R75,5750,1948,104578165.7,4051,8786,4735,8004.031314,440.8282322
Cell R76,5750,1958,105115014.6,6445,8980,2535,8246.886619,407.0838801
Cell R77,5750,1953,104846590.2,6445,8956,2511,8203.601639,373.5541316
Cell R8,5750,1948,104578165.7,-1958,9038,10996,7258.859343,1272.107356
Cell R80,5750,1940,104148686.6,-1781,9834,11615,4956.71701,2812.897733
Cell R81,5750,1945,104417111.1,448,9972,9524,6417.997943,2221.382029
Cell R82,5750,1953,104846590.2,418,9298,8880,5210.115207,2653.976874
Cell R83,5750,1950,104685535.5,853,9571,8718,5870.129231,2536.683714
Cell R84,5750,1951,104739220.4,1175,9652,8477,5341.341363,2443.168956
Cell R85,5750,1957,105061329.7,1292,9652,8360,6379.292284,2146.4409
Cell R86,5750,1952,104792905.3,4610,9510,4900,7850.453381,456.9578877
Cell R87,5750,1945,104417111.1,6104,8798,2694,8083.363496,410.9044235
Cell R9,5750,1941,104202371.5,-1958,9270,11228,7394.698609,1201.755996
Cell R90,5750,1947,104524480.8,853,9372,8519,6709.208526,2149.909981
Cell R91,5750,1944,104363426.2,1125,9372,8247,6889.036523,2110.481745
Cell R92,5750,1952,104792905.3,1304,9904,8600,4797.294057,2503.669164
Cell R93,5750,1942,104256056.4,1436,9629,8193,7010.837281,1710.968685
Cell R97,5750,1954,104900275.1,1382,9152,7770,7049.589048,1901.776957
Cell R98,5750,1947,104524480.8,1382,8942,7560,7401.222393,1669.777111
Cell R99,5750,1948,104578165.7,1382,8787,7405,7425.695585,1571.016658
Cell S102,5750,1953,104846590.2,5712,9085,3373,8191.494112,436.7533785
Cell S108,5750,1950,104685535.5,6255,8912,2657,8167.952821,519.9789905
Cell S13,5750,1953,104846590.2,5654,8945,3291,7985.772145,411.2799757
Cell S14,5750,1959,105168699.5,4961,8959,3998,7879.941807,553.0170335
Cell S2,5750,1944,104363426.2,5788,8738,2950,8042.849794,344.8160362
Cell S23,5750,1948,104578165.7,4961,8741,3780,7979.669918,457.7887598
Cell S32,5750,1950,104685535.5,4978,8920,3942,7958.189744,514.8275867
Cell S33,5750,1948,104578165.7,6215,8933,2718,8016.650924,378.6064558
Cell S34,5750,1949,104631850.6,5858,8963,3105,7960.268343,401.0516042
Cell S41,5750,1948,104578165.7,4158,8727,4569,7816.335729,527.3205624
Cell S42,5750,1945,104417111.1,5845,8920,3075,8221.159897,440.1722316
Cell S44,5750,1953,104846590.2,6035,9061,3026,8025.993856,453.0100693
Cell S56,5750,1951,104739220.4,5645,8938,3293,7674.77345,519.668871
Cell S67,5750,1950,104685535.5,5623,8938,3315,7923.268718,529.8503171
Cell S78,5750,1951,104739220.4,6412,9081,2669,8317.704254,436.3163815
Cell S88,5750,1948,104578165.7,6383,9081,2698,8248.308008,429.4669964
Cell S94,5750,1949,104631850.6,6670,9085,2415,8278.24628,346.0925575
Cell S95,5750,1962,105329754.2,6670,9085,2415,8220.16208,366.1659331
W287,5750,1948,104578165.7,894,9204,8310,4157.916838,2061.06723
W295,5750,1949,104631850.6,1705,8785,7080,6809.268856,1690.306328
W338,5750,1943,104309741.3,697,9484,8787,3996.778178,2517.669331
W342,5750,1943,104309741.3,1043,8946,7903,5345.676274,2403.416164
W345,5750,1946,104470795.9,1609,8580,6971,7455.819116,699.0979588
W387,5750,1943,104309741.3,1121,9470,8349,5291.06176,2270.64609
W393,5750,1943,104309741.3,1118,8786,7668,5943.091611,2170.631386
W440,5750,1947,104524480.8,1101,9136,8035,5095.196199,2096.412395
W441,5750,1942,104256056.4,1245,9239,7994,6903.861998,1005.004018
W445,5750,1943,104309741.3,2651,8548,5897,6818.783839,924.5070732
W500,5750,1950,104685535.5,1196,8546,7350,6206.92,1858.044669
1,6000,2124,114026706.4,-1954,9513,11467,6639.039077,1850.484434
2,6000,2118,113704597,1653,9292,7639,6311.229462,1777.998924
3,6000,2124,114026706.4,1635,9270,7635,7344.789548,1378.457964
4,6000,2123,113973021.5,1806,8536,6730,7442.569477,1153.419849
5,6000,2122,113919336.6,-1836,9972,11808,6087.713478,1797.599996
6,6000,2117,113650912.1,1254,9287,8033,6627.970241,2187.980069
7,6000,2123,113973021.5,1373,9571,8198,6686.910504,1917.464068
8,6000,2128,114241445.9,1806,8516,6710,7042.045113,1465.042217
9,6000,2128,114241445.9,4978,8920,3942,7929.795583,527.4776632
10,6000,2115,113543542.3,-507,9882,10389,5369.129078,2475.864112
11,6000,2123,113973021.5,-92,9787,9879,5675.352803,2409.034654
12,6000,2128,114241445.9,1111,9418,8307,4619.330827,2386.576761
13,6000,2125,114080391.2,1768,9552,7784,6903.430588,1648.382667
14,6000,2126,114134076.1,5717,8901,3184,8100.567733,396.3216655
16,6000,2122,113919336.6,-159,9693,9852,5001.213478,2770.735937
17,6000,2123,113973021.5,457,9823,9366,6807.45219,1601.543825
18,6000,2119,113758281.9,705,9950,9245,4769.10807,2617.595491
19,6000,2125,114080391.2,1104,9552,8448,4910.866353,2517.906466
20,6000,2123,113973021.5,4051,8786,4735,7989.918983,453.8899573
21,6000,2121,113865651.7,6445,8956,2511,8214.176332,375.5159996
22,6000,2120,113811966.8,-1781,9972,11753,4864.828302,3008.587892
23,6000,2113,113436172.6,418,9298,8880,5330.516327,2634.927859
24,6000,2124,114026706.4,1125,9372,8247,6863.963748,2124.410872
25,6000,2116,113597227.2,1436,9629,8193,6971.454631,1773.539714
26,6000,2125,114080391.2,6104,8798,2694,8082.477176,414.0868804
27,6000,2124,114026706.4,1382,9052,7670,7300.632298,1804.686911
28,6000,2125,114080391.2,1375,9129,7754,7327.114353,1640.305894
29,6000,2125,114080391.2,1375,9692,8317,7327.506353,1472.398552
31,6000,2120,113811966.8,1453,9074,7621,7525.890566,1396.401104
32,6000,2125,114080391.2,1681,8980,7299,7093.257412,1336.094918
33,6000,2127,114187761,1619,9074,7455,7319.802539,691.7578676
34,6000,2122,113919336.6,2179,8555,6376,6974.910462,1011.120053
10A,6000,2121,113865651.7,-1005,9882,10887,5052.244696,2730.360329
10NE,6000,2120,113811966.8,-92,9882,9974,5242.976415,2594.663873
10NW,6000,2121,113865651.7,-1836,8869,10705,5467.578972,2345.944883
10SW,6000,2121,113865651.7,-1005,9882,10887,5470.162659,2587.685199
11NE,6000,2113,113436172.6,-92,9787,9879,6378.265499,2355.540455
11NW,6000,2126,114134076.1,-92,9787,9879,5542.559266,2528.068173
11SE,6000,2119,113758281.9,956,9261,8305,5982.330345,2240.969142
17NW,6000,2123,113973021.5,543,9693,9150,6356.14602,2079.133333
17SE,6000,2124,114026706.4,457,9959,9502,6163.408192,2092.058201
17SW,6000,2123,113973021.5,-1781,9823,11604,5438.230334,2602.208355
22S,6000,2121,113865651.7,-1781,9972,11753,4619.90429,3004.531726
23S,6000,2128,114241445.9,1335,9548,8213,4215.959117,2196.202476
24S,6000,2123,113973021.5,1125,9372,8247,6846.051813,2136.124711
27A,6000,2126,114134076.1,1382,9152,7770,7064.621825,1900.996311
2A,6000,2124,114026706.4,1668,9292,7624,6517.426554,1645.091491
5NE,6000,2119,113758281.9,-76,9736,9812,4650.258141,2327.131919
5NW,6000,2118,113704597,-1836,9736,11572,5210.6322,2259.085718
5SE,6000,2122,113919336.6,614,9804,9190,4251.485391,2474.278593
6NE,6000,2112,113382487.7,1522,9287,7765,6929.487216,1733.101535
6NW,6000,2116,113597227.2,614,9287,8673,5919.405009,2614.322702
6SW,6000,2124,114026706.4,738,9804,9066,6534.561205,2272.868319
Cell 1 2011/12,6000,2124,114026706.4,-1954,9513,11467,6639.039077,1850.484434
Cell 1 SW 2013,6000,2124,114026706.4,-1428,9210,10638,5310.138418,2097.174273
Cell 10 2011/12,6000,2115,113543542.3,-507,9882,10389,5369.129078,2475.864112
Cell 10 NE 2011/12,6000,2120,113811966.8,-92,9882,9974,5242.976415,2594.663873
Cell 10 NW 2011/12,6000,2121,113865651.7,-1836,8869,10705,5467.578972,2345.944883
Cell 10 SE 2013,6000,2116,113597227.2,614,9287,8673,5919.405009,2614.322702
Cell 10 SW 2011/12,6000,2121,113865651.7,-1005,9882,10887,5470.162659,2587.685199
Cell 10-A 2011/12,6000,2121,113865651.7,-1005,9882,10887,5052.244696,2730.360329
Cell 11 NE 2011/12,6000,2113,113436172.6,-92,9787,9879,6378.265499,2355.540455
Cell 11 NW 2013,6000,2123,113973021.5,1668,9292,7624,6436.74423,1682.381406
Cell 11 SW 2013,6000,2122,113919336.6,1254,9287,8033,6905.860509,1919.267269
Cell 12 2013,6000,2122,113919336.6,1373,9571,8198,6688.1918,1915.428559
Cell 13 2013,6000,2125,114080391.2,1806,8516,6710,7006.454588,1484.406553
Cell 14 2013,6000,2127,114187761,4978,8863,3885,7891.495534,452.0988278
Cell 15 2013,6000,2126,114134076.1,5061,8777,3716,7953.264346,421.7188964
Cell 15-A 2013,6000,2129,114295130.8,6215,8963,2748,8024.061531,376.333958
Cell 16 2013,6000,2126,114134076.1,5858,8963,3105,7977.097836,408.5291998
Cell 17 NW 2011/12,6000,2123,113973021.5,543,9693,9150,6356.14602,2079.133333
Cell 17 NW 2013,6000,2112,113382487.7,-1836,9736,11572,5720.236269,2053.261066
Cell 17 SE 2013,6000,2121,113865651.7,-1836,8869,10705,5467.578972,2345.944883
Cell 17 SW 2013,6000,2125,114080391.2,-1836,9972,11808,6085.591529,1801.671518
Cell 18 2011/12,6000,2119,113758281.9,705,9950,9245,4769.10807,2617.595491
Cell 18 NE 2013,6000,2123,113973021.5,738,9804,9066,6646.262365,2210.092464
Cell 18 NW 2013,6000,2116,113597227.2,614,9804,9190,4245.492911,2456.905169
Cell 18 SE 2013,6000,2113,113436172.6,-92,9787,9879,6378.265499,2355.540455
Cell 18 SSE 2013,6000,2123,113973021.5,-92,9787,9879,5565.066415,2506.632863
Cell 19 NW 2013,6000,2123,113973021.5,1242,9287,8045,6709.841733,2143.083493
Cell 2 2011/12,6000,2118,113704597,1653,9292,7639,6311.229462,1777.998924
Cell 2 NE 2013,6000,2118,113704597,-1954,9292,11246,6662.926346,1672.970249
Cell 2 SW 2013,6000,2123,113973021.5,-1954,9513,11467,6639.254357,1850.893609
Cell 20 2013,6000,2125,114080391.2,1474,9571,8097,6822.186353,1813.74893
Cell 21 2013,6000,2124,114026706.4,2206,8970,6764,7452.896893,1088.333531
Cell 22 2013,6000,2125,114080391.2,5845,8920,3075,8015.287529,478.5540581
Cell 23 2013,6000,2117,113650912.1,5845,8920,3075,8216.078885,435.8993796
Cell 24 2013,6000,2122,113919336.6,5858,8963,3105,7954.98115,403.1156003
Cell 25 NE 2013,6000,2114,113489857.5,-507,9882,10389,5368.356197,2476.194537
Cell 25 SE 2013,6000,2122,113919336.6,-1005,9882,10887,5471.465598,2587.771211
Cell 26 NE 2013,6000,2123,113973021.5,-92,9787,9879,5675.352803,2409.034654
Cell 26 NNW 2013,6000,2120,113811966.8,-92,9882,9974,5244.318868,2593.662712
Cell 26 NW 2013,6000,2121,113865651.7,-1005,9882,10887,5052.244696,2730.360329
Cell 27 NW 2013,6000,2119,113758281.9,956,9261,8305,5982.330345,2240.969142
Cell 28 2013,6000,2128,114241445.9,1111,9418,8307,4619.330827,2386.576761
Cell 29 2013,6000,2126,114134076.1,1768,9552,7784,6902.678739,1650.212353
Cell 3 NE 2013,6000,2124,114026706.4,-1958,9270,11228,7298.079567,1252.803698
Cell 3 NW 2013,6000,2125,114080391.2,-1958,9266,11224,6707.512,1720.639709
Cell 30 2013,6000,2120,113811966.8,4051,8980,4929,8128.041038,420.5888389
Cell 31 2013,6000,2125,114080391.2,5717,8967,3250,8130.860706,429.3189555
Cell 32 2013,6000,2123,113973021.5,5623,8938,3315,7934.099859,529.9728292
Cell 33 NE 2013,6000,2123,113973021.5,543,9693,9150,6356.14602,2079.133333
Cell 33 SE 2013,6000,2123,113973021.5,-1781,9823,11604,5436.170984,2603.103417
Cell 33 SW 2013,6000,2121,113865651.7,-159,9561,9720,4923.970769,2773.09639
Cell 34 N 2013,6000,2123,113973021.5,705,9728,9023,6671.762129,1884.417614
Cell 34 NW 2013,6000,2123,113973021.5,457,9823,9366,6807.45219,1601.543825
Cell 34 SE 2013,6000,2124,114026706.4,457,9959,9502,6166.708098,2089.995571
Cell 35 2013,6000,2113,113436172.6,705,9950,9245,4663.477993,2595.746027
Cell 37 2013,6000,2121,113865651.7,4051,8786,4735,7990.503065,457.9879835
Cell 38 2013,6000,2124,114026706.4,6445,9035,2590,8219.055085,376.4509198
Cell 39 2013,6000,2126,114134076.1,6412,9081,2669,8304.423801,445.2831422
Cell 4 2013,6000,2124,114026706.4,4307,8595,4288,7831.570621,394.4222433
Cell 40 NE 2013,6000,2114,113489857.5,-1781,9851,11632,4958.674551,2816.215475
Cell 41 N 2013,6000,2122,113919336.6,-1781,9972,11753,6149.790763,2392.127684
Cell 41 NW 2013,6000,2124,114026706.4,-1781,9972,11753,5754.04661,2638.003253
Cell 42 NW 2013,6000,2124,114026706.4,418,9298,8880,5313.578625,2629.374991
Cell 43 2013,6000,2126,114134076.1,1292,9652,8360,6308.894167,2195.431218
Cell 44 2013,6000,2123,113973021.5,1659,8786,7127,7788.702779,751.2093749
Cell 45 2013,6000,2124,114026706.4,6104,8798,2694,8083.429849,413.6449633
Cell 47 2013,6000,2124,114026706.4,853,9372,8519,6745.463748,2139.230261
Cell 48 2013,6000,2124,114026706.4,1125,9372,8247,6846.191149,2135.557952
Cell 49 2013,6000,2116,113597227.2,1436,9629,8193,6971.454631,1773.539714
Cell 5 2011/12 Summer,6000,2125,114080391.2,-1836,9972,11808,6085.591529,1801.671518
Cell 5 2013,6000,2123,113973021.5,5788,8863,3075,7969.220914,390.3299481
Cell 50 2013,6000,2123,113973021.5,1375,9692,8317,7326.621762,1472.7943
Cell 51 2013,6000,2128,114241445.9,6614,9085,2471,8208.43844,371.5877764
Cell 52 2013,6000,2123,113973021.5,1382,9483,8101,7377.384362,1630.137333
Cell 53 2013,6000,2125,114080391.2,1375,9129,7754,7327.114353,1640.305894
Cell 54 2013,6000,2124,114026706.4,5101,8970,3869,8053.12806,633.8183465
Cell 55 2013,6000,2130,114348815.7,6255,8912,2657,8165.637089,513.5720449
Cell 56 2013,6000,2123,113973021.5,1619,9074,7455,7319.355629,692.2676257
Cell 57 2013,6000,2125,114080391.2,1681,8980,7299,7093.239059,1336.083912
Cell 58 2013,6000,2127,114187761,5568,8912,3344,8258.12882,504.8205864
Cell 59 2013,6000,2120,113811966.8,1473,9542,8069,7253.189623,908.6416505
Cell 6 2011/12,6000,2117,113650912.1,1254,9287,8033,6627.970241,2187.980069
Cell 6 2013,6000,2119,113758281.9,5676,8768,3092,8040.154318,347.328236
Cell 6 NE 2011/12,6000,2112,113382487.7,1522,9287,7765,6929.487216,1733.101535
Cell 6 NW 2011/12,6000,2116,113597227.2,614,9287,8673,5919.405009,2614.322702
Cell 6 SW 2011/12,6000,2124,114026706.4,738,9804,9066,6534.561205,2272.868319
Cell 60 2013,6000,2125,114080391.2,1894,8555,6661,6998.459765,1029.718955
Cell 61 2013,6000,2122,113919336.6,3582,8828,5246,7659.97738,809.7436397
Cell 7 2013,6000,2125,114080391.2,4961,8959,3998,7897.045176,545.5423912
Cell 9 NW 2013,6000,2118,113704597,-76,9550,9626,4832.502833,2259.898587
Cell 9 SE 2013,6000,2120,113811966.8,-76,9736,9812,4648.883962,2327.442785
Cell 9 SW 2013,6000,2117,113650912.1,-1836,9736,11572,5209.968824,2259.41296
Cell R1,6000,2110,113275117.9,1200,8485,7285,5813.808531,1922.139528
Cell R10,6000,2124,114026706.4,4307,8595,4288,7831.570621,394.4222433
Cell R100,6000,2123,113973021.5,1375,9692,8317,7326.621762,1472.7943
Cell R101,6000,2125,114080391.2,5528,9085,3557,8015.688471,494.9415793
Cell R104,6000,2122,113919336.6,1301,9468,8167,7056.700283,2065.805713
Cell R105,6000,2125,114080391.2,1375,9129,7754,7327.114353,1640.305894
Cell R106,6000,2124,114026706.4,1375,9692,8317,7370.367702,1511.755403
Cell R107,6000,2125,114080391.2,5101,8970,3869,8052.741647,633.9193911
Cell R11,6000,2123,113973021.5,5788,8863,3075,7969.220914,390.3299481
Cell R111,6000,2121,113865651.7,1226,9468,8242,6845.804338,2278.141208
Cell R112,6000,2127,114187761,2289,8732,6443,7831.877762,724.0022774
Cell R113,6000,2125,114080391.2,1681,8980,7299,7093.239059,1336.083912
Cell R114,6000,2127,114187761,5568,8912,3344,8258.12882,504.8205864
Cell R117,6000,2120,113811966.8,1327,9542,8215,6505.769811,1927.469153
Cell R118,6000,2123,113973021.5,1619,9074,7455,7319.350447,692.2650125
Cell R119,6000,2125,114080391.2,1681,8980,7299,6840.785412,1392.078939
Cell R120,6000,2115,113543542.3,2412,8736,6324,7535.130969,989.9122527
Cell R121,6000,2127,114187761,6617,8805,2188,8152.950165,366.598641
Cell R123,6000,2127,114187761,1441,9542,8101,7062.632816,1429.304381
Cell R124,6000,2126,114134076.1,1894,8555,6661,6995.610066,1027.00995
Cell R125,6000,2126,114134076.1,1894,8780,6886,6871.040922,1148.506405
Cell R126,6000,2128,114241445.9,2412,8780,6368,7434.449718,986.0854584
Cell R15,6000,2124,114026706.4,-1428,9210,10638,5310.138418,2097.174273
Cell R16,6000,2114,113489857.5,-76,9550,9626,4826.97351,2259.626911
Cell R17,6000,2122,113919336.6,922,9513,8591,6510.798303,2117.633354
Cell R18,6000,2128,114241445.9,1668,9292,7624,6447.914004,1675.056559
Cell R19,6000,2121,113865651.7,1504,9571,8067,6977.411127,1826.529373
Cell R20,6000,2125,114080391.2,1806,8536,6730,7440.573647,1132.677935
Cell R21,6000,2125,114080391.2,1872,8863,6991,7463.071059,1151.759557
Cell R22,6000,2127,114187761,4978,8863,3885,7891.495534,452.0988278
Cell R24,6000,2112,113382487.7,-1836,9736,11572,5720.236269,2053.261066
Cell R25,6000,2116,113597227.2,614,9804,9190,4245.105388,2456.438611
Cell R26,6000,2120,113811966.8,614,9513,8899,5922.421698,2610.627988
Cell R27,6000,2123,113973021.5,1242,9287,8045,6709.841733,2143.083493
Cell R28,6000,2124,114026706.4,1373,9571,8198,6171.003766,2242.834035
Cell R29,6000,2124,114026706.4,1474,9571,8097,6823.274482,1813.48227
Cell R30,6000,2124,114026706.4,2239,8727,6488,7472.483992,968.6597402
Cell R31,6000,2125,114080391.2,4978,8740,3762,7803.125176,513.5522109
Cell R35,6000,2123,113973021.5,-1836,9972,11808,6084.643429,1802.254462
Cell R36,6000,2121,113865651.7,-1836,8869,10705,5467.578972,2345.944883
Cell R37,6000,2114,113489857.5,-92,9787,9879,6379.029328,2355.244988
Cell R38,6000,2123,113973021.5,1111,9787,8676,5869.812529,2472.491244
Cell R39,6000,2122,113919336.6,1368,9487,8119,6944.151272,1705.44239
Cell R40,6000,2124,114026706.4,2206,8970,6764,7452.780603,1088.280781
Cell R46,6000,2121,113865651.7,-1005,9882,10887,5188.153701,2635.621071
Cell R47,6000,2121,113865651.7,-1005,9882,10887,5052.244696,2730.360329
Cell R48,6000,2122,113919336.6,-92,9787,9879,5674.526861,2409.301682
Cell R49,6000,2118,113704597,956,9261,8305,5981.620869,2241.260173
Cell R5,6000,2115,113543542.3,-1428,8571,9999,5606.0974,1966.964349
Cell R50,6000,2128,114241445.9,1111,9418,8307,4619.330827,2386.576761
Cell R51,6000,2127,114187761,1768,9552,7784,6911.267043,1640.328234
Cell R52,6000,2126,114134076.1,2206,8914,6708,7507.746472,966.8984461
Cell R53,6000,2124,114026706.4,3451,8794,5343,7708.815913,619.322916
Cell R54,6000,2124,114026706.4,5717,8967,3250,8130.938324,429.4051007
Cell R58,6000,2125,114080391.2,-908,9693,10601,4665.993412,2716.303595
Cell R59,6000,2123,113973021.5,543,9693,9150,6356.14602,2079.133333
Cell R6,6000,2124,114026706.4,-1954,9513,11467,6638.625235,1850.684879
Cell R60,6000,2124,114026706.4,457,9823,9366,6808.463277,1601.844362
Cell R61,6000,2113,113436172.6,705,9950,9245,4663.477993,2595.746027
Cell R62,6000,2122,113919336.6,1104,9552,8448,4834.607446,2518.088678
Cell R63,6000,2124,114026706.4,1172,9552,8380,6642.930791,1871.437827
Cell R64,6000,2128,114241445.9,4051,8967,4916,7924.529135,441.9718611
Cell R65,6000,2120,113811966.8,4051,8980,4929,8128.041038,420.5888389
Cell R66,6000,2124,114026706.4,5623,8980,3357,8263.536252,490.2607209
Cell R69,6000,2122,113919336.6,-159,9561,9720,4925.044769,2772.884084
Cell R7,6000,2124,114026706.4,-1958,9266,11224,6707.045198,1720.910178
Cell R70,6000,2122,113919336.6,-1781,9823,11604,5437.733742,2602.720859
Cell R71,6000,2124,114026706.4,457,9959,9502,6166.708098,2089.995571
Cell R72,6000,2125,114080391.2,418,9950,9532,5457.485647,2482.80459
Cell R73,6000,2125,114080391.2,418,9950,9532,4845.376471,2690.504102
Cell R74,6000,2125,114080391.2,1269,9400,8131,6551.728,2233.260622
Cell R75,6000,2122,113919336.6,4051,8786,4735,7990.347314,457.936238
Cell R76,6000,2122,113919336.6,6445,8980,2535,8245.116871,403.7519179
Cell R77,6000,2125,114080391.2,6445,9035,2590,8218.904471,376.4263375
Cell R8,6000,2124,114026706.4,-1958,9038,10996,7231.826742,1279.689895
Cell R80,6000,2114,113489857.5,-1781,9851,11632,4958.674551,2816.215475
Cell R81,6000,2123,113973021.5,448,9972,9524,6400.402732,2224.97914
Cell R82,6000,2124,114026706.4,418,9298,8880,5313.578625,2629.374991
Cell R83,6000,2126,114134076.1,853,9571,8718,5935.278928,2530.628032
Cell R84,6000,2124,114026706.4,1175,9652,8477,5385.650659,2451.214809
Cell R85,6000,2126,114134076.1,1292,9652,8360,6308.894167,2195.431218
Cell R86,6000,2125,114080391.2,2095,9510,7415,7844.642353,544.0239502
Cell R87,6000,2124,114026706.4,6104,8798,2694,8083.429849,413.6449633
Cell R9,6000,2115,113543542.3,-1958,9270,11228,7394.501655,1193.869778
Cell R90,6000,2124,114026706.4,853,9372,8519,6745.463748,2139.230261
Cell R91,6000,2125,114080391.2,1125,9372,8247,6846.587765,2135.133652
Cell R92,6000,2125,114080391.2,1304,9904,8600,4909.152,2514.826394
Cell R93,6000,2115,113543542.3,1436,9629,8193,6971.142317,1773.900766
Cell R97,6000,2126,114134076.1,1382,9152,7770,7076.454374,1886.249568
Cell R98,6000,2124,114026706.4,1382,9052,7670,7300.632298,1804.686911
Cell R99,6000,2122,113919336.6,1382,9483,8101,7376.850613,1630.330752
Cell S102,6000,2125,114080391.2,5712,9085,3373,8193.696,431.9514677
Cell S108,6000,2130,114348815.7,6255,8912,2657,8165.637089,513.5720449
Cell S13,6000,2125,114080391.2,5654,8945,3291,7990.434824,407.9518543
Cell S14,6000,2125,114080391.2,4961,8959,3998,7897.045176,545.5423912
Cell S2,6000,2120,113811966.8,5676,8768,3092,8040.345283,347.3575595
Cell S23,6000,2129,114295130.8,4961,8741,3780,7979.025364,457.1470984
Cell S32,6000,2125,114080391.2,4978,8920,3942,7962.473412,513.5255754
Cell S33,6000,2129,114295130.8,6215,8963,2748,8024.061531,376.333958
Cell S34,6000,2122,113919336.6,5858,8963,3105,7954.98115,403.1156003
Cell S41,6000,2125,114080391.2,4158,8727,4569,7808.450353,529.2102129
Cell S42,6000,2116,113597227.2,5845,8920,3075,8216.252363,435.9293005
Cell S44,6000,2124,114026706.4,6035,9061,3026,8024.350753,456.0881112
Cell S56,6000,2125,114080391.2,5645,8959,3314,7664.343529,525.0838056
Cell S67,6000,2122,113919336.6,5623,8938,3315,7934.343544,529.9787658
Cell S78,6000,2127,114187761,6412,9081,2669,8304.343677,445.193785
Cell S88,6000,2124,114026706.4,5607,9081,3474,8247.166667,434.7472993
Cell S94,6000,2125,114080391.2,6574,9085,2511,8269.990118,354.1353804
Cell S95,6000,2128,114241445.9,6614,9085,2471,8208.43844,371.5877764
W287,6000,2122,113919336.6,894,9410,8516,4159.962771,2057.300843
W295,6000,2124,114026706.4,1705,8785,7080,6816.018832,1683.88924
W338,6000,2115,113543542.3,697,9484,8787,3962.712057,2502.279846
W342,6000,2117,113650912.1,976,8946,7970,5308.417572,2426.663493
W345,6000,2124,114026706.4,1609,8580,6971,7450.506591,741.9022754
W387,6000,2120,113811966.8,1121,9470,8349,5212.189623,2291.79093
W393,6000,2114,113489857.5,1118,8860,7742,5899.689688,2205.580616
W440,6000,2121,113865651.7,1101,9136,8035,5134.93918,2117.580533
W441,6000,2122,113919336.6,1184,9239,8055,6851.491046,1110.356625
W445,6000,2114,113489857.5,2651,8548,5897,6816.749763,950.5694043
W500,6000,2122,113919336.6,1196,8598,7402,6222.393025,1837.287367
1,6250,2301,123528931.9,-1954,9513,11467,6547.972186,1893.769746
2,6250,2301,123528931.9,1653,9292,7639,6317.314211,1802.590413
3,6250,2302,123582616.8,1635,9270,7635,7292.257602,1442.629167
4,6250,2305,123743671.5,1806,8536,6730,7437.997397,1169.252177
5,6250,2299,123421562.1,-1836,9972,11808,6049.627229,1834.816885
6,6250,2301,123528931.9,1254,9287,8033,6567.947849,2216.784663
7,6250,2301,123528931.9,1373,9571,8198,6621.487614,1970.901772
8,6250,2303,123636301.7,1806,8516,6710,7070.329136,1444.150281
9,6250,2302,123582616.8,4978,8920,3942,7931.107298,524.4755009
10,6250,2304,123689986.6,-1005,9882,10887,5307.429688,2516.1902
11,6250,2303,123636301.7,-92,9787,9879,5755.518888,2416.046543
12,6250,2304,123689986.6,1111,9418,8307,4607.243056,2390.699598
13,6250,2305,123743671.4,1406,9552,8146,6870.860738,1677.835941
14,6250,2302,123582616.8,5717,8901,3184,8106.378801,401.7565308
16,6250,2305,123743671.5,-159,9693,9852,5059.886334,2757.698253
17,6250,2304,123689986.6,457,9823,9366,6735.263455,1703.76304
18,6250,2301,123528931.9,705,9950,9245,4813.349413,2616.343159
19,6250,2302,123582616.8,1104,9552,8448,4901.540834,2525.736901
20,6250,2303,123636301.7,4051,8786,4735,7976.904907,467.551221
21,6250,2304,123689986.6,6445,9035,2590,8226.157118,380.0607551
22,6250,2300,123475247,-1781,9972,11753,4834.283478,2998.525535
23,6250,2305,123743671.4,418,9298,8880,5426.25987,2599.410475
24,6250,2306,123797356.3,1120,9372,8252,6820.796184,2148.581306
25,6250,2306,123797356.3,1436,9629,8193,6922.251518,1843.292887
26,6250,2302,123582616.8,6104,8798,2694,8081.9596,413.963147
27,6250,2300,123475247,1382,9052,7670,7227.28,1887.301345
28,6250,2302,123582616.8,1375,9129,7754,7311.398349,1676.970523
29,6250,2305,123743671.4,1375,9692,8317,7271.303254,1567.342287
31,6250,2307,123851041.2,1421,9074,7653,7455.123104,1487.439803
32,6250,2304,123689986.6,1681,8980,7299,7122.351128,1314.914435
33,6250,2306,123797356.3,1605,9074,7469,7313.102342,765.2991212
34,6250,2302,123582616.8,1894,8555,6661,6949.309296,1037.129318
10A,6250,2307,123851041.2,-1005,9882,10887,4941.003901,2758.913168
10NE,6250,2302,123582616.8,-92,9882,9974,5159.990443,2589.147511
10NW,6250,2297,123314192.3,-1836,8869,10705,5447.413583,2335.460104
10SW,6250,2308,123904726.1,-1005,9882,10887,5490.300693,2609.258041
11NE,6250,2301,123528931.9,-92,9787,9879,6321.373316,2391.498876
11NW,6250,2304,123689986.6,-92,9787,9879,5591.925781,2512.416883
11SE,6250,2301,123528931.9,956,9261,8305,5996.651021,2248.108069
17NW,6250,2299,123421562.1,-115,9693,9808,6340.419313,2100.306041
17SE,6250,2302,123582616.8,457,9959,9502,6063.553866,2194.998887
17SW,6250,2305,123743671.5,-1781,9823,11604,5451.929718,2624.231166
22S,6250,2299,123421562.1,-1781,9972,11753,4610.193562,3005.341661
23S,6250,2305,123743671.5,1133,9548,8415,4332.836876,2232.777117
24S,6250,2299,123421562.1,1120,9372,8252,6817.490213,2150.397819
27A,6250,2304,123689986.6,1382,9152,7770,7070.961372,1899.015519
2A,6250,2303,123636301.7,-1958,9292,11250,6530.960921,1663.33272
5NE,6250,2299,123421562.1,-76,9736,9812,4636.798173,2350.970116
5NW,6250,2300,123475247,-1836,9736,11572,5183.541739,2274.716414
5SE,6250,2306,123797356.3,614,9804,9190,4414.997398,2528.994619
6NE,6250,2303,123636301.7,1254,9287,8033,6880.928789,1752.458427
6NW,6250,2304,123689986.6,614,9513,8899,5927.193576,2599.342851
6SW,6250,2300,123475247,264,9804,9540,6462.318261,2331.47086
Cell 1 2011/12,6250,2301,123528931.9,-1954,9513,11467,6547.972186,1893.769746
Cell 1 SW 2013,6250,2303,123636301.7,-1428,9210,10638,5375.684325,2103.511377
Cell 10 2011/12,6250,2304,123689986.6,-1005,9882,10887,5307.429688,2516.1902
Cell 10 NE 2011/12,6250,2302,123582616.8,-92,9882,9974,5159.990443,2589.147511
Cell 10 NW 2011/12,6250,2297,123314192.3,-1836,8869,10705,5447.413583,2335.460104
Cell 10 SE 2013,6250,2304,123689986.6,614,9513,8899,5927.193576,2599.342851
Cell 10 SW 2011/12,6250,2308,123904726.1,-1005,9882,10887,5490.300693,2609.258041
Cell 10-A 2011/12,6250,2307,123851041.2,-1005,9882,10887,4941.003901,2758.913168
Cell 11 NE 2011/12,6250,2301,123528931.9,-92,9787,9879,6321.373316,2391.498876
Cell 11 NW 2013,6250,2303,123636301.7,1668,9292,7624,6462.50977,1689.100895
Cell 11 SW 2013,6250,2302,123582616.8,1254,9287,8033,6849.198957,1950.320805
Cell 12 2013,6250,2299,123421562.1,1373,9571,8198,6622.752936,1970.999944
Cell 13 2013,6250,2302,123582616.8,1806,8516,6710,7041.900521,1460.964714
Cell 14 2013,6250,2307,123851041.2,4978,8863,3885,7879.426528,471.4760902
Cell 15 2013,6250,2305,123743671.4,5061,8791,3730,7953.641649,433.877866
Cell 15-A 2013,6250,2300,123475247,6215,8963,2748,8027.877391,375.6133601
Cell 16 2013,6250,2302,123582616.8,5858,8963,3105,7979.915291,409.9710679
Cell 17 NW 2011/12,6250,2299,123421562.1,-115,9693,9808,6340.419313,2100.306041
Cell 17 NW 2013,6250,2302,123582616.8,-1836,9736,11572,5651.847089,2090.08977
Cell 17 SE 2013,6250,2298,123367877.2,-1836,8869,10705,5446.828982,2335.119994
Cell 17 SW 2013,6250,2302,123582616.8,-1836,9972,11808,6040.535187,1840.907107
Cell 18 2011/12,6250,2301,123528931.9,705,9950,9245,4813.349413,2616.343159
Cell 18 NE 2013,6250,2303,123636301.7,738,9804,9066,6590.316544,2259.319462
Cell 18 NW 2013,6250,2300,123475247,614,9804,9190,4399.574348,2504.202208
Cell 18 SE 2013,6250,2302,123582616.8,-92,9787,9879,6319.532146,2392.609992
Cell 18 SSE 2013,6250,2299,123421562.1,-92,9787,9879,5599.117442,2501.945905
Cell 19 NW 2013,6250,2301,123528931.9,1242,9287,8045,6655.024772,2157.969567
Cell 2 2011/12,6250,2301,123528931.9,1653,9292,7639,6317.314211,1802.590413
Cell 2 NE 2013,6250,2299,123421562.1,-1958,9292,11250,6664.965202,1683.293108
Cell 2 SW 2013,6250,2301,123528931.9,-1954,9513,11467,6545.953933,1896.09371
Cell 20 2013,6250,2304,123689986.6,1474,9571,8097,6760.236111,1849.084318
Cell 21 2013,6250,2304,123689986.6,2206,8970,6764,7454.113715,1085.847852
Cell 22 2013,6250,2301,123528931.9,5845,8920,3075,8013.69535,482.0750803
Cell 23 2013,6250,2305,123743671.4,5845,8920,3075,8211.386117,431.3798374
Cell 24 2013,6250,2301,123528931.9,5858,8963,3105,7952.048674,409.7375616
Cell 25 NE 2013,6250,2302,123582616.8,-1005,9882,10887,5308.003475,2515.755906
Cell 25 SE 2013,6250,2308,123904726.1,-1005,9882,10887,5489.950173,2608.985944
Cell 26 NE 2013,6250,2304,123689986.6,-92,9787,9879,5756.801215,2416.305925
Cell 26 NNW 2013,6250,2302,123582616.8,-92,9882,9974,5159.990443,2589.147511
Cell 26 NW 2013,6250,2307,123851041.2,-1005,9882,10887,4941.003901,2758.913168
Cell 27 NW 2013,6250,2301,123528931.9,956,9261,8305,5996.945676,2248.444653
Cell 28 2013,6250,2305,123743671.5,1111,9418,8307,4607.239479,2390.180958
Cell 29 2013,6250,2304,123689986.6,1406,9552,8146,6870.851128,1678.333327
Cell 3 NE 2013,6250,2303,123636301.7,-1958,9270,11228,7275.036474,1268.549428
Cell 3 NW 2013,6250,2301,123528931.9,-1958,9266,11224,6671.003911,1744.155036
Cell 30 2013,6250,2302,123582616.8,4051,8980,4929,8132.180712,420.6646033
Cell 31 2013,6250,2306,123797356.3,5717,8967,3250,8127.792715,437.1911503
Cell 32 2013,6250,2303,123636301.7,5623,8938,3315,7948.491533,528.1486412
Cell 33 NE 2013,6250,2299,123421562.1,-115,9693,9808,6340.419313,2100.306041
Cell 33 SE 2013,6250,2304,123689986.6,-1781,9823,11604,5450.799479,2625.150105
Cell 33 SW 2013,6250,2303,123636301.7,-159,9693,9852,5022.003474,2758.479186
Cell 34 N 2013,6250,2304,123689986.6,705,9728,9023,6648.197049,1904.616029
Cell 34 NW 2013,6250,2303,123636301.7,457,9823,9366,6734.721233,1703.934141
Cell 34 SE 2013,6250,2303,123636301.7,457,9959,9502,6061.83109,2195.528681
Cell 35 2013,6250,2303,123636301.7,705,9950,9245,4670.208424,2587.780768
Cell 37 2013,6250,2303,123636301.7,4051,8786,4735,7976.437256,467.7309019
Cell 38 2013,6250,2309,123958411,6445,9035,2590,8229.715461,380.6240756
Cell 39 2013,6250,2305,123743671.5,6109,9081,2972,8292.872017,449.1680307
Cell 4 2013,6250,2300,123475247,4307,8716,4409,7824.634348,409.1792153
Cell 40 NE 2013,6250,2304,123689986.6,-1781,9972,11753,4960.595486,2835.790598
Cell 41 N 2013,6250,2305,123743671.4,-1781,9972,11753,6107.550108,2409.920474
Cell 41 NW 2013,6250,2302,123582616.8,-1781,9972,11753,5713.622937,2636.848595
Cell 42 NW 2013,6250,2308,123904726.1,418,9298,8880,5418.389081,2599.946335
Cell 43 2013,6250,2309,123958411,1292,9652,8360,6259.765266,2230.451748
Cell 44 2013,6250,2307,123851041.2,1384,8786,7402,7740.185089,882.7632234
Cell 45 2013,6250,2302,123582616.8,6104,8798,2694,8083.579496,413.6093513
Cell 47 2013,6250,2304,123689986.6,853,9372,8519,6770.121094,2132.793293
Cell 48 2013,6250,2300,123475247,1120,9372,8252,6815.574348,2152.667975
Cell 49 2013,6250,2307,123851041.2,1436,9629,8193,6920.641959,1844.513481
Cell 5 2011/12 Summer,6250,2302,123582616.8,-1836,9972,11808,6040.535187,1840.907107
Cell 5 2013,6250,2302,123582616.8,5788,8863,3075,7967.00391,393.9259419
Cell 50 2013,6250,2305,123743671.4,1375,9692,8317,7271.303254,1567.342287
Cell 51 2013,6250,2309,123958411,6098,9085,2987,8199.666955,376.0759272
Cell 52 2013,6250,2302,123582616.8,1382,9483,8101,7335.198089,1676.080241
Cell 53 2013,6250,2300,123475247,1375,9129,7754,7310.636957,1677.497753
Cell 54 2013,6250,2303,123636301.7,5101,8970,3869,8057.300912,628.8569925
Cell 55 2013,6250,2305,123743671.4,6255,8912,2657,8164.139262,507.3291257
Cell 56 2013,6250,2306,123797356.3,1605,9074,7469,7311.350824,763.5035847
Cell 57 2013,6250,2304,123689986.6,1681,8980,7299,7121.790799,1314.979023
Cell 58 2013,6250,2303,123636301.7,5568,8912,3344,8246.618324,509.6524564
Cell 59 2013,6250,2302,123582616.8,1448,9542,8094,7201.666811,1059.559135
Cell 6 2011/12,6250,2301,123528931.9,1254,9287,8033,6567.947849,2216.784663
Cell 6 2013,6250,2304,123689986.6,5676,8768,3092,8035.085069,351.807537
Cell 6 NE 2011/12,6250,2303,123636301.7,1254,9287,8033,6880.928789,1752.458427
Cell 6 NW 2011/12,6250,2304,123689986.6,614,9513,8899,5927.193576,2599.342851
Cell 6 SW 2011/12,6250,2300,123475247,264,9804,9540,6462.318261,2331.47086
Cell 60 2013,6250,2309,123958411,1894,8555,6661,6961.153313,1049.019206
Cell 61 2013,6250,2308,123904726.1,3076,8828,5752,7649.77253,834.3646909
Cell 7 2013,6250,2307,123851041.2,4961,8964,4003,7907.393151,540.9591084
Cell 9 NW 2013,6250,2301,123528931.9,-76,9736,9812,4855.591047,2269.147877
Cell 9 SE 2013,6250,2299,123421562.1,-76,9736,9812,4636.798173,2350.970116
Cell 9 SW 2013,6250,2300,123475247,-1836,9736,11572,5178.588696,2276.358764
Cell R1,6250,2307,123851041.2,1200,8485,7285,5802.592544,1900.947648
Cell R10,6250,2301,123528931.9,4307,8716,4409,7824.197306,409.6268802
Cell R100,6250,2305,123743671.4,1375,9692,8317,7271.303254,1567.342287
Cell R101,6250,2301,123528931.9,5528,9085,3557,8011.412429,505.0615117
Cell R104,6250,2302,123582616.8,1301,9468,8167,7045.65682,2051.627127
Cell R105,6250,2302,123582616.8,1375,9129,7754,7311.398349,1676.970523
Cell R106,6250,2302,123582616.8,1375,9692,8317,7372.943962,1525.777346
Cell R107,6250,2302,123582616.8,5101,8970,3869,8057.192876,628.972199
Cell R11,6250,2302,123582616.8,5788,8863,3075,7967.00391,393.9259419
Cell R111,6250,2300,123475247,1224,9468,8244,6820.781739,2289.978305
Cell R112,6250,2302,123582616.8,2289,8980,6691,7799.801911,767.0042562
Cell R113,6250,2304,123689986.6,1681,8980,7299,7121.790799,1314.979023
Cell R114,6250,2302,123582616.8,5568,8912,3344,8246.497828,509.7303436
Cell R117,6250,2302,123582616.8,1327,9542,8215,6475.727194,1959.816746
Cell R118,6250,2305,123743671.4,1605,9074,7469,7311.559219,763.6036138
Cell R119,6250,2300,123475247,1681,8980,7299,6870.225652,1371.835361
Cell R120,6250,2309,123958411,2412,8736,6324,7519.570377,1029.116336
Cell R121,6250,2302,123582616.8,6547,8867,2320,8158.543875,371.5664361
Cell R123,6250,2301,123528931.9,1327,9542,8215,7005.372012,1489.241629
Cell R124,6250,2308,123904726.1,1894,8595,6701,6967.886915,1044.115044
Cell R125,6250,2306,123797356.3,1894,8780,6886,6877.320035,1138.267305
Cell R126,6250,2306,123797356.3,2412,8825,6413,7402.228101,1042.388866
Cell R15,6250,2303,123636301.7,-1428,9210,10638,5375.684325,2103.511377
Cell R16,6250,2301,123528931.9,-76,9736,9812,4859.382442,2272.059499
Cell R17,6250,2302,123582616.8,720,9513,8793,6423.396612,2183.119164
Cell R18,6250,2303,123636301.7,1668,9292,7624,6457.461572,1688.912807
Cell R19,6250,2300,123475247,1504,9571,8067,6958.93,1796.107182
Cell R20,6250,2303,123636301.7,1806,8678,6872,7426.97525,1161.929427
Cell R21,6250,2305,123743671.4,1872,8863,6991,7432.273753,1213.019559
Cell R22,6250,2307,123851041.2,4978,8863,3885,7878.767664,471.8994632
Cell R24,6250,2302,123582616.8,-1836,9736,11572,5650.188097,2091.791271
Cell R25,6250,2299,123421562.1,614,9804,9190,4399.986081,2504.668943
Cell R26,6250,2298,123367877.2,614,9513,8899,5928.114883,2602.231698
Cell R27,6250,2301,123528931.9,1242,9287,8045,6655.024772,2157.969567
Cell R28,6250,2300,123475247,1373,9571,8198,6145.496087,2248.787813
Cell R29,6250,2304,123689986.6,1474,9571,8097,6760.236111,1849.084318
Cell R30,6250,2300,123475247,2239,8727,6488,7473.53,982.9290693
Cell R31,6250,2308,123904726.1,4196,8740,4544,7798.885615,524.9755544
Cell R35,6250,2302,123582616.8,-1836,9972,11808,6040.535187,1840.907107
Cell R36,6250,2298,123367877.2,-1836,8869,10705,5446.828982,2335.119994
Cell R37,6250,2301,123528931.9,-92,9787,9879,6321.373316,2391.498876
Cell R38,6250,2305,123743671.4,1111,9787,8676,5824.722777,2485.378432
Cell R39,6250,2300,123475247,1335,9487,8152,6893.759565,1758.175991
Cell R40,6250,2305,123743671.5,2206,8970,6764,7452.420824,1088.649172
Cell R46,6250,2303,123636301.7,-1005,9882,10887,5182.370386,2649.083582
Cell R47,6250,2307,123851041.2,-1005,9882,10887,4941.003901,2758.913168
Cell R48,6250,2305,123743671.4,-92,9787,9879,5757.77744,2416.23614
Cell R49,6250,2300,123475247,956,9261,8305,5995.79,2248.250034
Cell R5,6250,2302,123582616.8,-1428,8571,9999,5643.761946,1952.9969
Cell R50,6250,2302,123582616.8,1111,9418,8307,4607.129887,2389.773318
Cell R51,6250,2306,123797356.3,1406,9552,8146,6880.009107,1671.982247
Cell R52,6250,2306,123797356.3,2206,8914,6708,7526.179532,947.4689091
Cell R53,6250,2302,123582616.8,3451,8794,5343,7711.567767,615.3535212
Cell R54,6250,2306,123797356.3,5717,8967,3250,8127.792715,437.1911503
Cell R58,6250,2301,123528931.9,-908,9693,10601,4743.783138,2742.009507
Cell R59,6250,2300,123475247,-115,9693,9808,6341.226957,2100.206449
Cell R6,6250,2301,123528931.9,-1954,9513,11467,6545.953933,1896.09371
Cell R60,6250,2304,123689986.6,457,9823,9366,6735.263455,1703.76304
Cell R61,6250,2303,123636301.7,705,9950,9245,4670.208424,2587.780768
Cell R62,6250,2303,123636301.7,1104,9552,8448,4826.724707,2528.089312
Cell R63,6250,2306,123797356.3,1172,9552,8380,6579.722029,1922.073339
Cell R64,6250,2302,123582616.8,4051,8967,4916,7913.9053,473.1423253
Cell R65,6250,2301,123528931.9,4051,8980,4929,8131.905259,420.5483917
Cell R66,6250,2310,124012095.9,5623,8980,3357,8244.014719,489.6592408
Cell R69,6250,2304,123689986.6,-159,9693,9852,5023.078125,2758.362647
Cell R7,6250,2301,123528931.9,-1958,9266,11224,6671.003911,1744.155036
Cell R70,6250,2305,123743671.4,-1781,9823,11604,5451.518872,2624.807743
Cell R71,6250,2303,123636301.7,457,9959,9502,6065.12766,2194.203244
Cell R72,6250,2304,123689986.6,418,9950,9532,5499.452691,2470.429279
Cell R73,6250,2308,123904726.1,418,9950,9532,4799.833622,2693.78097
Cell R74,6250,2301,123528931.9,1219,9400,8181,6516.580617,2258.86352
Cell R75,6250,2302,123582616.8,4051,8786,4735,7976.340139,467.8092679
Cell R76,6250,2309,123958411,6445,8980,2535,8242.076223,400.7320783
Cell R77,6250,2309,123958411,6445,9035,2590,8229.715461,380.6240756
Cell R8,6250,2298,123367877.2,-1958,9038,10996,7202.577894,1303.680169
Cell R80,6250,2305,123743671.4,-1781,9972,11753,4961.685466,2835.658087
Cell R81,6250,2299,123421562.1,349,9972,9623,6358.345368,2249.12903
Cell R82,6250,2308,123904726.1,418,9298,8880,5418.389081,2599.946335
Cell R83,6250,2303,123636301.7,853,9571,8718,5998.616153,2520.640495
Cell R84,6250,2302,123582616.8,1175,9652,8477,5422.576455,2458.889163
Cell R85,6250,2309,123958411,1292,9652,8360,6259.765266,2230.451748
Cell R86,6250,2302,123582616.8,1612,9510,7898,7831.761512,633.1886477
Cell R87,6250,2303,123636301.7,6104,8798,2694,8083.178463,413.966953
Cell R9,6250,2301,123528931.9,-1958,9270,11228,7387.97827,1200.525397
Cell R90,6250,2303,123636301.7,853,9372,8519,6769.593574,2133.106009
Cell R91,6250,2301,123528931.9,1120,9372,8252,6816.019991,2152.306272
Cell R92,6250,2303,123636301.7,1304,9904,8600,5022.495441,2524.67666
Cell R93,6250,2307,123851041.2,1436,9629,8193,6920.641959,1844.513481
Cell R97,6250,2303,123636301.7,1382,9152,7770,7103.632653,1867.948778
Cell R98,6250,2300,123475247,1382,9052,7670,7227.28,1887.301345
Cell R99,6250,2301,123528931.9,1382,9483,8101,7337.65754,1672.286244
Cell S102,6250,2304,123689986.6,5712,9085,3373,8197.338976,425.4532133
Cell S108,6250,2305,123743671.4,6255,8912,2657,8164.139262,507.3291257
Cell S13,6250,2305,123743671.4,5654,8945,3291,7995.157484,405.9868242
Cell S14,6250,2306,123797356.3,4961,8964,4003,7907.451865,541.0690404
Cell S2,6250,2305,123743671.4,5676,8768,3092,8035.152278,351.7460085
Cell S23,6250,2300,123475247,4961,8877,3916,7977.422609,458.1511234
Cell S32,6250,2304,123689986.6,4978,8920,3942,7966.041233,510.0209423
Cell S33,6250,2300,123475247,6215,8963,2748,8027.877391,375.6133601
Cell S34,6250,2301,123528931.9,5858,8963,3105,7952.048674,409.7375616
Cell S41,6250,2305,123743671.4,4158,8727,4569,7801.697614,533.6446957
Cell S42,6250,2305,123743671.4,5845,8920,3075,8211.762256,430.817002
Cell S44,6250,2306,123797356.3,6035,9061,3026,8022.901995,460.2770414
Cell S56,6250,2307,123851041.2,5645,8977,3332,7663.246207,527.0899138
Cell S67,6250,2303,123636301.7,5623,8938,3315,7948.567086,528.1738854
Cell S78,6250,2305,123743671.5,6109,9081,2972,8292.872017,449.1680307
Cell S88,6250,2302,123582616.8,5600,9081,3481,8243.763249,441.7490422
Cell S94,6250,2300,123475247,6574,9085,2511,8258.006522,363.6717182
Cell S95,6250,2309,123958411,6098,9085,2987,8199.666955,376.0759272
W287,6250,2304,123689986.6,894,9410,8516,4150.314236,2055.207831
W295,6250,2301,123528931.9,1705,8785,7080,6809.451543,1690.346388
W338,6250,2303,123636301.7,697,9484,8787,3901.15241,2475.884927
W342,6250,2301,123528931.9,976,8946,7970,5290.031291,2441.981805
W345,6250,2300,123475247,1609,8580,6971,7444.776087,780.769755
W387,6250,2296,123260507.4,1012,9470,8458,5141.880662,2298.136831
W393,6250,2299,123421562.1,1078,8860,7782,5845.163549,2248.293992
W440,6250,2305,123743671.4,1101,9239,8138,5155.18872,2148.607489
W441,6250,2299,123421562.1,1155,9239,8084,6782.933884,1233.910751
W445,6250,2304,123689986.6,2651,8548,5897,6819.045139,965.1085304
W500,6250,2301,123528931.9,1196,8598,7402,6240.52412,1811.073257
1,6500,2488,133568006.3,-1954,9513,11467,6467.346463,1931.880413
2,6500,2489,133621691.2,1635,9292,7657,6309.382885,1823.60265
3,6500,2486,133460636.5,1635,9270,7635,7253.19992,1479.82169
4,6500,2492,133782745.9,1806,8536,6730,7431.610754,1176.369614
5,6500,2493,133836430.8,-1836,9972,11808,5981.328119,1892.39495
6,6500,2492,133782745.9,1254,9287,8033,6525.749197,2220.938029
7,6500,2491,133729061,1373,9571,8198,6532.965877,2035.021727
8,6500,2491,133729061,1806,8516,6710,7097.957848,1422.40117
9,6500,2490,133675376.1,4978,8920,3942,7937.45261,521.0244669
10,6500,2494,133890115.7,-1005,9882,10887,5269.214515,2541.656386
11,6500,2488,133568006.3,-92,9787,9879,5825.80828,2417.594121
12,6500,2489,133621691.2,1111,9728,8617,4585.283246,2399.701067
13,6500,2489,133621691.2,1406,9552,8146,6829.087585,1712.104479
14,6500,2493,133836430.8,5717,8921,3204,8113.101083,405.5933749
16,6500,2488,133568006.3,-159,9693,9852,5118.877412,2737.695407
17,6500,2485,133406951.7,457,9823,9366,6675.828571,1783.765132
18,6500,2491,133729061,705,9950,9245,4816.09153,2598.089918
19,6500,2496,133997485.4,1104,9552,8448,4896.465946,2540.55738
20,6500,2492,133782745.9,4051,8786,4735,7963.602729,478.142873
21,6500,2493,133836430.8,6445,9036,2591,8235.724027,383.6211153
22,6500,2490,133675376.1,-1781,9972,11753,4790.3,2986.029954
23,6500,2489,133621691.2,418,9298,8880,5506.051426,2572.331846
24,6500,2488,133568006.3,1120,9372,8252,6790.299839,2160.786019
25,6500,2491,133729061,1304,9629,8325,6883.016058,1901.1438
26,6500,2497,134051170.3,6104,9017,2913,8082.698438,417.8414764
27,6500,2495,133943800.5,1382,9052,7670,7174.018437,1940.513342
28,6500,2497,134051170.3,1375,9468,8093,7293.77533,1709.831047
29,6500,2489,133621691.2,1375,9692,8317,7229.486541,1634.297986
31,6500,2496,133997485.4,1421,9074,7653,7408.086538,1541.751629
32,6500,2491,133729061,1681,8980,7299,7141.694099,1304.240728
33,6500,2490,133675376.1,1430,9074,7644,7299.414859,857.5704564
34,6500,2490,133675376.1,1894,8555,6661,6932.344177,1044.469822
10A,6500,2490,133675376.1,-1005,9882,10887,4861.004418,2775.484881
10NE,6500,2490,133675376.1,-92,9882,9974,5095.263855,2586.30312
10NW,6500,2497,134051170.3,-1836,8869,10705,5428.448939,2321.486422
10SW,6500,2487,133514321.4,-1005,9882,10887,5496.849216,2626.97246
11NE,6500,2486,133460636.5,-92,9787,9879,6266.54465,2422.18941
11NW,6500,2487,133514321.4,-92,9787,9879,5646.868516,2499.460135
11SE,6500,2492,133782745.9,956,9271,8315,6024.692616,2257.705506
17NW,6500,2493,133836430.8,-128,9693,9821,6328.465704,2118.292026
17SE,6500,2489,133621691.2,457,9959,9502,5995.837284,2263.167361
17SW,6500,2488,133568006.3,-1781,9823,11604,5471.937299,2636.718285
22S,6500,2498,134104855.2,-1781,9972,11753,4610.294636,2994.005257
23S,6500,2489,133621691.2,1111,9548,8437,4418.969466,2253.228777
24S,6500,2498,134104855.2,1120,9372,8252,6771.330264,2170.670327
27A,6500,2489,133621691.2,1382,9152,7770,7074.918843,1893.56198
2A,6500,2485,133406951.7,-1958,9292,11250,6524.175855,1679.113077
5NE,6500,2493,133836430.8,-1428,9736,11164,4634.108303,2371.694094
5NW,6500,2488,133568006.3,-1836,9736,11572,5154.986736,2289.906435
5SE,6500,2489,133621691.2,614,9804,9190,4548.981519,2566.523658
6NE,6500,2488,133568006.3,1254,9287,8033,6838.252412,1767.98834
6NW,6500,2489,133621691.2,614,9513,8899,5949.27963,2571.960861
6SW,6500,2494,133890115.7,-92,9804,9896,6393.15437,2389.778682
Cell 1 2011/12,6500,2488,133568006.3,-1954,9513,11467,6467.346463,1931.880413
Cell 1 SW 2013,6500,2488,133568006.3,-1428,9210,10638,5433.567122,2106.328827
Cell 10 2011/12,6500,2494,133890115.7,-1005,9882,10887,5269.214515,2541.656386
Cell 10 NE 2011/12,6500,2490,133675376.1,-92,9882,9974,5095.263855,2586.30312
Cell 10 NW 2011/12,6500,2497,134051170.3,-1836,8869,10705,5428.448939,2321.486422
Cell 10 SE 2013,6500,2489,133621691.2,614,9513,8899,5949.27963,2571.960861
Cell 10 SW 2011/12,6500,2487,133514321.4,-1005,9882,10887,5496.849216,2626.97246
Cell 10-A 2011/12,6500,2490,133675376.1,-1005,9882,10887,4861.004418,2775.484881
Cell 11 NE 2011/12,6500,2486,133460636.5,-92,9787,9879,6266.54465,2422.18941
Cell 11 NW 2013,6500,2486,133460636.5,1653,9292,7639,6459.470233,1707.638949
Cell 11 SW 2013,6500,2489,133621691.2,1254,9287,8033,6795.374046,1972.305205
Cell 12 2013,6500,2494,133890115.7,1373,9571,8198,6534.618284,2033.490519
Cell 13 2013,6500,2491,133729061,1806,8516,6710,7072.276194,1438.758284
Cell 14 2013,6500,2487,133514321.4,4978,8863,3885,7876.075593,479.1009733
Cell 15 2013,6500,2491,133729061,5061,8791,3730,7959.74709,436.5322698
Cell 15-A 2013,6500,2494,133890115.7,6215,8963,2748,8033.789495,373.7236963
Cell 16 2013,6500,2498,134104855.2,5858,8963,3105,7984.700961,411.0454867
Cell 17 NW 2011/12,6500,2493,133836430.8,-128,9693,9821,6328.465704,2118.292026
Cell 17 NW 2013,6500,2488,133568006.3,-1836,9736,11572,5593.578376,2132.910759
Cell 17 SE 2013,6500,2496,133997485.4,-1836,8869,10705,5427.830929,2321.746044
Cell 17 SW 2013,6500,2487,133514321.4,-1836,9972,11808,5985.220346,1891.223561
Cell 18 2011/12,6500,2491,133729061,705,9950,9245,4816.09153,2598.089918
Cell 18 NE 2013,6500,2488,133568006.3,592,9804,9212,6515.224678,2317.549868
Cell 18 NW 2013,6500,2490,133675376.1,614,9804,9190,4542.881526,2540.605681
Cell 18 SE 2013,6500,2486,133460636.5,-92,9787,9879,6266.54465,2422.18941
Cell 18 SSE 2013,6500,2488,133568006.3,-92,9787,9879,5658.583199,2496.69362
Cell 19 NW 2013,6500,2490,133675376.1,1242,9287,8045,6597.60241,2173.123387
Cell 2 2011/12,6500,2489,133621691.2,1635,9292,7657,6309.382885,1823.60265
Cell 2 NE 2013,6500,2498,134104855.2,-1958,9292,11250,6667.634508,1690.688044
Cell 2 SW 2013,6500,2489,133621691.2,-1954,9513,11467,6466.262354,1934.113792
Cell 20 2013,6500,2487,133514321.4,1474,9571,8097,6712.700442,1871.787372
Cell 21 2013,6500,2492,133782745.9,2206,8970,6764,7448.771268,1089.255782
Cell 22 2013,6500,2497,134051170.3,5527,8920,3393,8011.546656,487.584576
Cell 23 2013,6500,2488,133568006.3,5845,8920,3075,8209.088424,428.0519784
Cell 24 2013,6500,2491,133729061,5858,8977,3119,7948.195905,416.6210741
Cell 25 NE 2013,6500,2494,133890115.7,-1005,9882,10887,5269.214515,2541.656386
Cell 25 SE 2013,6500,2487,133514321.4,-1005,9882,10887,5496.849216,2626.97246
Cell 26 NE 2013,6500,2488,133568006.3,-92,9787,9879,5825.154341,2417.164807
Cell 26 NNW 2013,6500,2489,133621691.2,-92,9882,9974,5096.922459,2585.498276
Cell 26 NW 2013,6500,2489,133621691.2,-1005,9882,10887,4859.323423,2774.774796
Cell 27 NW 2013,6500,2492,133782745.9,956,9271,8315,6024.692616,2257.705506
Cell 28 2013,6500,2489,133621691.2,1111,9728,8617,4585.283246,2399.701067
Cell 29 2013,6500,2490,133675376.1,1406,9552,8146,6828.3751,1711.397503
Cell 3 NE 2013,6500,2487,133514321.4,-1958,9270,11228,7247.741858,1288.720949
Cell 3 NW 2013,6500,2491,133729061,-1958,9266,11224,6629.228824,1767.005332
Cell 30 2013,6500,2491,133729061,4051,8980,4929,8130.598555,430.219071
Cell 31 2013,6500,2492,133782745.9,5623,8967,3344,8128.192215,446.7495299
Cell 32 2013,6500,2499,134158540.1,5623,8938,3315,7962.59984,525.153666
Cell 33 NE 2013,6500,2492,133782745.9,-128,9693,9821,6327.920546,2118.542145
Cell 33 SE 2013,6500,2488,133568006.3,-1781,9823,11604,5469.675241,2636.658923
Cell 33 SW 2013,6500,2489,133621691.2,-159,9693,9852,5109.38409,2742.340411
Cell 34 N 2013,6500,2489,133621691.2,705,9728,9023,6591.943351,1936.439524
Cell 34 NW 2013,6500,2485,133406951.7,457,9823,9366,6675.828571,1783.765132
Cell 34 SE 2013,6500,2489,133621691.2,457,9959,9502,5995.437123,2266.373271
Cell 35 2013,6500,2491,133729061,705,9950,9245,4672.285829,2582.486308
Cell 37 2013,6500,2493,133836430.8,4051,8786,4735,7964.05014,478.7394385
Cell 38 2013,6500,2491,133729061,6445,9036,2591,8237.765556,386.4753331
Cell 39 2013,6500,2492,133782745.9,5898,9081,3183,8276.980337,461.9990368
Cell 4 2013,6500,2496,133997485.4,4307,8883,4576,7815.501202,434.1178841
Cell 40 NE 2013,6500,2488,133568006.3,-1781,9972,11753,4948.523312,2849.071174
Cell 41 N 2013,6500,2491,133729061,-1781,9972,11753,6078.082698,2418.247119
Cell 41 NW 2013,6500,2489,133621691.2,-1781,9972,11753,5664.683005,2655.166482
Cell 42 NW 2013,6500,2488,133568006.3,418,9298,8880,5506.198955,2580.744112
Cell 43 2013,6500,2489,133621691.2,1292,9652,8360,6207.800321,2272.655829
Cell 44 2013,6500,2491,133729061,1384,9400,8016,7699.626656,981.8859582
Cell 45 2013,6500,2498,134104855.2,6104,9017,2913,8084.319456,417.3152675
Cell 47 2013,6500,2491,133729061,853,9571,8718,6802.451626,2122.819812
Cell 48 2013,6500,2498,134104855.2,1120,9372,8252,6768.734988,2170.7147
Cell 49 2013,6500,2492,133782745.9,1304,9629,8325,6880.880417,1903.748597
Cell 5 2011/12 Summer,6500,2487,133514321.4,-1836,9972,11808,5985.220346,1891.223561
Cell 5 2013,6500,2492,133782745.9,5788,8863,3075,7959.731541,399.1913623
Cell 50 2013,6500,2488,133568006.3,1375,9692,8317,7229.460611,1634.625877
Cell 51 2013,6500,2490,133675376.1,6098,9085,2987,8192.3249,382.9662804
Cell 52 2013,6500,2492,133782745.9,1382,9483,8101,7283.861958,1726.338619
Cell 53 2013,6500,2496,133997485.4,1375,9468,8093,7293.340545,1710.035515
Cell 54 2013,6500,2494,133890115.7,5101,8970,3869,8061.866079,620.5567001
Cell 55 2013,6500,2492,133782745.9,6255,8912,2657,8161.884831,499.6079779
Cell 56 2013,6500,2493,133836430.8,1430,9074,7644,7299.419575,857.2607325
Cell 57 2013,6500,2493,133836430.8,1681,8980,7299,7142.300842,1303.913776
Cell 58 2013,6500,2494,133890115.7,5568,8980,3412,8233.793103,512.6605334
Cell 59 2013,6500,2493,133836430.8,1448,9542,8094,7156.922182,1164.29551
Cell 6 2011/12,6500,2492,133782745.9,1254,9287,8033,6525.749197,2220.938029
Cell 6 2013,6500,2495,133943800.6,5676,8838,3162,8031.469339,354.8838233
Cell 6 NE 2011/12,6500,2488,133568006.3,1254,9287,8033,6838.252412,1767.98834
Cell 6 NW 2011/12,6500,2489,133621691.2,614,9513,8899,5949.27963,2571.960861
Cell 6 SW 2011/12,6500,2494,133890115.7,-92,9804,9896,6393.15437,2389.778682
Cell 60 2013,6500,2489,133621691.2,1894,8595,6701,6934.58176,1053.032926
Cell 61 2013,6500,2496,133997485.4,2412,8834,6422,7631.312099,877.7566001
Cell 7 2013,6500,2489,133621691.2,4961,8964,4003,7916.023303,535.5170219
Cell 9 NW 2013,6500,2493,133836430.8,-76,9736,9812,4876.715604,2281.76642
Cell 9 SE 2013,6500,2493,133836430.8,-1428,9736,11164,4634.108303,2371.694094
Cell 9 SW 2013,6500,2488,133568006.3,-1836,9736,11572,5154.986736,2289.906435
Cell R1,6500,2481,133192212.1,1200,8485,7285,5795.795244,1891.122159
Cell R10,6500,2496,133997485.4,4307,8883,4576,7815.501202,434.1178841
Cell R100,6500,2489,133621691.2,1375,9692,8317,7227.308959,1637.817661
Cell R101,6500,2491,133729061,4957,9085,4128,8003.57487,529.6767641
Cell R104,6500,2498,134104855.2,1301,9468,8167,7048.959568,2031.335729
Cell R105,6500,2496,133997485.4,1375,9468,8093,7293.340545,1710.035515
Cell R106,6500,2491,133729061,1375,9692,8317,7371.040546,1536.53785
Cell R107,6500,2494,133890115.7,5101,8970,3869,8061.750601,620.5006499
Cell R11,6500,2492,133782745.9,5788,8863,3075,7959.731541,399.1913623
Cell R111,6500,2499,134158540.1,1197,9468,8271,6786.256503,2309.440913
Cell R112,6500,2492,133782745.9,2289,8980,6691,7763.335072,802.2505641
Cell R113,6500,2492,133782745.9,1681,8980,7299,7142.101124,1304.137246
Cell R114,6500,2495,133943800.5,5568,8980,3412,8233.761523,512.5602119
Cell R117,6500,2490,133675376.1,1327,9542,8215,6449.066667,1983.241732
Cell R118,6500,2493,133836430.8,1430,9074,7644,7299.419575,857.2607325
Cell R119,6500,2499,134158540.1,1681,8980,7299,6889.77471,1357.805158
Cell R120,6500,2489,133621691.2,2412,8867,6455,7507.420249,1058.907412
Cell R121,6500,2497,134051170.3,5826,8874,3048,8159.511414,387.1830782
Cell R123,6500,2497,134051170.3,1327,9542,8215,6937.814177,1559.770029
Cell R124,6500,2488,133568006.3,1894,8595,6701,6949.675643,1058.466472
Cell R125,6500,2490,133675376.1,1894,8780,6886,6878.205221,1129.234958
Cell R126,6500,2491,133729061,1912,8825,6913,7378.910076,1101.039059
Cell R15,6500,2488,133568006.3,-1428,9210,10638,5433.567122,2106.328827
Cell R16,6500,2490,133675376.1,-76,9736,9812,4870.763855,2281.59243
Cell R17,6500,2488,133568006.3,614,9513,8899,6340.644293,2238.704175
Cell R18,6500,2488,133568006.3,1653,9292,7639,6466.637862,1703.394227
Cell R19,6500,2491,133729061,1504,9571,8067,6940.524689,1771.824095
Cell R20,6500,2485,133406951.7,1806,8678,6872,7422.735614,1169.114946
Cell R21,6500,2487,133514321.4,1872,8863,6991,7404.838359,1256.153518
Cell R22,6500,2487,133514321.4,4978,8863,3885,7876.075593,479.1009733
Cell R24,6500,2488,133568006.3,-1836,9736,11572,5593.578376,2132.910759
Cell R25,6500,2490,133675376.1,614,9804,9190,4542.881526,2540.605681
Cell R26,6500,2498,134104855.2,614,9513,8899,5947.285028,2574.135107
Cell R27,6500,2491,133729061,1242,9287,8045,6597.264954,2172.752401
Cell R28,6500,2496,133997485.4,1373,9571,8198,6119.72476,2241.428373
Cell R29,6500,2487,133514321.4,1474,9571,8097,6712.700442,1871.787372
Cell R30,6500,2497,134051170.3,2239,8727,6488,7473.725671,1002.914563
Cell R31,6500,2490,133675376.1,4196,8740,4544,7792.788755,537.6517538
Cell R35,6500,2486,133460636.5,-1836,9972,11808,5984.840306,1891.50895
Cell R36,6500,2497,134051170.3,-1836,8869,10705,5428.448939,2321.486422
Cell R37,6500,2486,133460636.5,-92,9787,9879,6266.54465,2422.18941
Cell R38,6500,2488,133568006.3,1111,9787,8676,5790.2291,2493.976468
Cell R39,6500,2491,133729061,1335,9487,8152,6853.848655,1791.189784
Cell R40,6500,2491,133729061,2206,8970,6764,7448.521076,1089.402807
Cell R46,6500,2487,133514321.4,-1005,9882,10887,5171.654202,2662.672683
Cell R47,6500,2489,133621691.2,-1005,9882,10887,4859.323423,2774.774796
Cell R48,6500,2488,133568006.3,-92,9787,9879,5825.154341,2417.164807
Cell R49,6500,2493,133836430.8,956,9271,8315,6025.387485,2257.519164
Cell R5,6500,2486,133460636.5,-1428,8571,9999,5674.680611,1946.866056
Cell R50,6500,2490,133675376.1,1111,9728,8617,4586.449398,2399.924447
Cell R51,6500,2489,133621691.2,1406,9552,8146,6840.743672,1700.616814
Cell R52,6500,2488,133568006.3,2206,8914,6708,7540.034164,927.7236823
Cell R53,6500,2493,133836430.8,3451,8794,5343,7709.7144,628.0156866
Cell R54,6500,2491,133729061,5623,8967,3344,8128.068246,446.7963371
Cell R58,6500,2488,133568006.3,-908,9693,10601,4825.030949,2748.285052
Cell R59,6500,2493,133836430.8,-128,9693,9821,6328.465704,2118.292026
Cell R6,6500,2489,133621691.2,-1954,9513,11467,6466.262354,1934.113792
Cell R60,6500,2485,133406951.7,457,9823,9366,6675.828571,1783.765132
Cell R61,6500,2491,133729061,705,9950,9245,4672.285829,2582.486308
Cell R62,6500,2490,133675376.1,1104,9552,8448,4825.984739,2541.756378
Cell R63,6500,2487,133514321.4,1104,9552,8448,6526.154001,1977.64127
Cell R64,6500,2492,133782745.9,4051,8967,4916,7909.45947,501.9525515
Cell R65,6500,2491,133729061,4051,8980,4929,8130.598555,430.219071
Cell R66,6500,2491,133729061,5623,8980,3357,8226.704938,488.9744313
Cell R69,6500,2489,133621691.2,-159,9693,9852,5109.38409,2742.340411
Cell R7,6500,2491,133729061,-1958,9266,11224,6629.228824,1767.005332
Cell R70,6500,2488,133568006.3,-1781,9823,11604,5469.675241,2636.658923
Cell R71,6500,2488,133568006.3,457,9959,9502,5994.856109,2266.643347
Cell R72,6500,2486,133460636.5,418,9950,9532,5538.898632,2462.335982
Cell R73,6500,2490,133675376.1,418,9950,9532,4771.323293,2700.790997
Cell R74,6500,2490,133675376.1,1219,9400,8181,6471.867871,2290.407546
Cell R75,6500,2493,133836430.8,4051,8786,4735,7964.05014,478.7394385
Cell R76,6500,2489,133621691.2,6445,8980,2535,8241.567698,396.6125249
Cell R77,6500,2492,133782745.9,6445,9036,2591,8237.647271,386.4428784
Cell R8,6500,2493,133836430.8,-1958,9048,11006,7182.922583,1316.080661
Cell R80,6500,2488,133568006.3,-1781,9972,11753,4945.891881,2850.045146
Cell R81,6500,2494,133890115.7,349,9972,9623,6291.199278,2296.255066
Cell R82,6500,2488,133568006.3,418,9298,8880,5506.198955,2580.744112
Cell R83,6500,2489,133621691.2,853,9571,8718,6046.524709,2515.323182
Cell R84,6500,2491,133729061,1175,9652,8477,5474.167804,2462.9701
Cell R85,6500,2489,133621691.2,1292,9652,8360,6207.800321,2272.655829
Cell R86,6500,2492,133782745.9,1499,9510,8011,7804.338684,742.9949054
Cell R87,6500,2497,134051170.3,6104,9017,2913,8084.100921,417.2558918
Cell R9,6500,2491,133729061,-1958,9270,11228,7379.511843,1211.337749
Cell R90,6500,2491,133729061,853,9571,8718,6802.451626,2122.819812
Cell R91,6500,2498,134104855.2,1120,9372,8252,6768.734988,2170.7147
Cell R92,6500,2491,133729061,1304,9904,8600,5118.804095,2526.452088
Cell R93,6500,2491,133729061,1304,9629,8325,6880.566038,1904.066009
Cell R97,6500,2490,133675376.1,1382,9152,7770,7120.765863,1862.42242
Cell R98,6500,2496,133997485.4,1382,9052,7670,7174.380609,1940.208918
Cell R99,6500,2492,133782745.9,1382,9483,8101,7283.861958,1726.338619
Cell S102,6500,2493,133836430.8,5712,9085,3373,8199.331729,420.9152095
Cell S108,6500,2491,133729061,6255,8912,2657,8161.908872,499.7068094
Cell S13,6500,2488,133568006.3,5654,8945,3291,7997.09365,405.1262056
Cell S14,6500,2489,133621691.2,4961,8964,4003,7916.023303,535.5170219
Cell S2,6500,2496,133997485.4,5676,8838,3162,8031.370192,354.8472856
Cell S23,6500,2494,133890115.7,4961,8877,3916,7970.073376,465.0107808
Cell S32,6500,2488,133568006.3,4978,8920,3942,7971.299839,505.8732113
Cell S33,6500,2494,133890115.7,6215,8963,2748,8033.789495,373.7236963
Cell S34,6500,2492,133782745.9,5858,8977,3119,7948.467095,416.757321
Cell S41,6500,2490,133675376.1,4158,8727,4569,7800.045783,533.9800911
Cell S42,6500,2490,133675376.1,5845,8920,3075,8208.982329,428.002976
Cell S44,6500,2489,133621691.2,6035,9061,3026,8013.863399,466.0521689
Cell S56,6500,2490,133675376.1,5645,8977,3332,7663.685141,524.47224
Cell S67,6500,2499,134158540.1,5623,8938,3315,7963.084034,525.0486928
Cell S78,6500,2492,133782745.9,5898,9081,3183,8276.980337,461.9990368
Cell S88,6500,2497,134051170.3,5600,9081,3481,8245.293953,449.9432315
Cell S94,6500,2497,134051170.3,6574,9085,2511,8243.981978,370.8813887
Cell S95,6500,2490,133675376.1,6098,9085,2987,8192.3249,382.9662804
W287,6500,2488,133568006.3,894,9410,8516,4154.746785,2048.961544
W295,6500,2489,133621691.2,1692,8785,7093,6806.866211,1704.664674
W338,6500,2488,133568006.3,697,9484,8787,3850.94172,2455.803083
W342,6500,2487,133514321.4,976,8946,7970,5276.050261,2447.67879
W345,6500,2494,133890115.7,1609,8580,6971,7440.019246,810.6682614
W387,6500,2490,133675376.1,1012,9470,8458,5048.112048,2311.153332
W393,6500,2490,133675376.1,985,8860,7875,5783.75743,2301.091558
W440,6500,2486,133460636.5,1073,9239,8166,5174.922767,2164.242224
W441,6500,2491,133729061,1155,9239,8084,6715.069851,1346.144194
W445,6500,2485,133406951.7,2651,8548,5897,6814.889336,981.5042405
W500,6500,2484,133353266.8,1196,8598,7402,6259.529388,1785.650549
1,6750,2683,144036559.9,-1954,9513,11467,6396.487514,1971.156336
2,6750,2686,144197614.5,1635,9292,7657,6317.992182,1853.301781
3,6750,2686,144197614.5,1635,9270,7635,7218.138868,1502.334605
4,6750,2686,144197614.5,1806,8536,6730,7430.393894,1172.538037
5,6750,2683,144036559.9,-1836,9972,11808,5921.683563,1940.122027
6,6750,2684,144090244.8,1242,9787,8545,6493.447466,2223.63289
7,6750,2684,144090244.8,1373,9571,8198,6462.173621,2074.37225
8,6750,2687,144251299.4,1806,8516,6710,7127.573874,1395.826706
9,6750,2687,144251299.4,4978,8920,3942,7948.271306,513.2580025
10,6750,2682,143982875,-1005,9882,10887,5233.836689,2574.875288
11,6750,2684,144090244.8,-92,9787,9879,5888.460507,2415.511664
12,6750,2680,143875505.2,1111,9728,8617,4549.616045,2416.523865
13,6750,2685,144143929.6,1319,9552,8233,6778.514711,1758.343521
14,6750,2688,144304984.3,5717,8967,3250,8117.718006,409.5324662
16,6750,2684,144090244.8,-159,9693,9852,5160.231744,2722.589624
17,6750,2684,144090244.8,457,9823,9366,6596.950447,1867.758377
18,6750,2690,144412354.1,705,9950,9245,4818.127509,2578.268621
19,6750,2678,143768135.4,1104,9552,8448,4907.460418,2556.114016
20,6750,2690,144412354.1,4051,8786,4735,7952.298885,487.4991998
21,6750,2691,144466039,6445,9036,2591,8242.61204,387.5677987
22,6750,2684,144090244.8,-1781,9972,11753,4780.498137,2969.310142
23,6750,2701,145002887.9,418,9571,9153,5602.045539,2549.984169
24,6750,2688,144304984.3,1029,9372,8343,6744.035342,2184.102279
25,6750,2698,144841833.2,1304,9629,8325,6840.722016,1946.501333
26,6750,2685,144143929.6,6104,9027,2923,8081.968343,426.0912328
27,6750,2683,144036559.9,1382,9177,7795,7124.786433,1982.038352
28,6750,2682,143982875,1375,9468,8093,7288.621178,1713.212727
29,6750,2683,144036559.9,1375,9692,8317,7197.621692,1673.901133
31,6750,2686,144197614.5,1421,9074,7653,7360.306404,1597.745888
32,6750,2689,144358669.2,1681,8980,7299,7163.26627,1296.097822
33,6750,2684,144090244.8,1430,9074,7644,7268.93927,964.3836567
34,6750,2691,144466039,1894,8555,6661,6907.79673,1060.960108
10A,6750,2685,144143929.6,-1005,9882,10887,4808.888268,2777.390767
10NE,6750,2687,144251299.4,-419,9882,10301,5059.387793,2584.376713
10NW,6750,2681,143929190.1,-1836,8869,10705,5409.816859,2318.957101
10SW,6750,2685,144143929.7,-1005,9882,10887,5467.994786,2641.006118
11NE,6750,2690,144412354.1,-92,9787,9879,6196.418959,2455.015055
11NW,6750,2680,143875505.2,-92,9787,9879,5718.802985,2491.728045
11SE,6750,2681,143929190.1,791,9271,8480,6053.424841,2262.028291
17NW,6750,2683,144036559.9,-639,9693,10332,6299.483041,2154.531497
17SE,6750,2685,144143929.6,418,9959,9541,5927.527374,2324.69818
17SW,6750,2684,144090244.8,-1781,9834,11615,5493.337556,2647.953505
22S,6750,2683,144036559.9,-1781,9972,11753,4602.014536,2980.841193
23S,6750,2680,143875505.2,1111,9548,8437,4493.868284,2272.21354
24S,6750,2686,144197614.5,1029,9372,8343,6724.118392,2193.269486
27A,6750,2686,144197614.5,1382,9427,8045,7071.228593,1896.057091
2A,6750,2684,144090244.8,-1958,9292,11250,6514.706036,1704.902754
5NE,6750,2685,144143929.7,-1836,9736,11572,4638.912104,2386.391122
5NW,6750,2685,144143929.6,-1836,9736,11572,5148.55419,2293.859634
5SE,6750,2685,144143929.6,592,9804,9212,4681.851397,2597.952191
6NE,6750,2691,144466039,1254,9287,8033,6776.583798,1807.869855
6NW,6750,2692,144519723.9,614,9513,8899,5972.057207,2544.348646
6SW,6750,2684,144090244.8,-92,9804,9896,6320.357303,2441.036319
Cell 1 2011/12,6750,2683,144036559.9,-1954,9513,11467,6396.487514,1971.156336
Cell 1 SW 2013,6750,2684,144090244.8,-1428,9210,10638,5488.920641,2111.138564
Cell 10 2011/12,6750,2682,143982875,-1005,9882,10887,5233.836689,2574.875288
Cell 10 NE 2011/12,6750,2687,144251299.4,-419,9882,10301,5059.387793,2584.376713
Cell 10 NW 2011/12,6750,2681,143929190.1,-1836,8869,10705,5409.816859,2318.957101
Cell 10 SE 2013,6750,2692,144519723.9,614,9513,8899,5972.057207,2544.348646
Cell 10 SW 2011/12,6750,2685,144143929.7,-1005,9882,10887,5467.994786,2641.006118
Cell 10-A 2011/12,6750,2685,144143929.6,-1005,9882,10887,4808.888268,2777.390767
Cell 11 NE 2011/12,6750,2690,144412354.1,-92,9787,9879,6196.418959,2455.015055
Cell 11 NW 2013,6750,2685,144143929.6,1629,9292,7663,6473.691248,1724.715717
Cell 11 SW 2013,6750,2687,144251299.4,1242,9287,8045,6721.503163,2013.834496
Cell 12 2013,6750,2683,144036559.9,1373,9571,8198,6458.448006,2075.905551
Cell 13 2013,6750,2687,144251299.4,1806,8516,6710,7102.62486,1412.43273
Cell 14 2013,6750,2684,144090244.8,4600,8863,4263,7865.668033,501.1978651
Cell 15 2013,6750,2686,144197614.5,5061,8791,3730,7964.898362,440.4876162
Cell 15-A 2013,6750,2688,144304984.3,6215,8963,2748,8034.794643,375.6597879
Cell 16 2013,6750,2684,144090244.8,5858,8963,3105,7992.119225,408.4688878
Cell 17 NW 2011/12,6750,2683,144036559.9,-639,9693,10332,6299.483041,2154.531497
Cell 17 NW 2013,6750,2690,144412354.1,-1836,9736,11572,5544.34684,2170.684303
Cell 17 SE 2013,6750,2681,143929190.1,-1836,8869,10705,5409.816859,2318.957101
Cell 17 SW 2013,6750,2681,143929190.1,-1836,9972,11808,5926.534129,1936.173255
Cell 18 2011/12,6750,2690,144412354.1,705,9950,9245,4818.127509,2578.268621
Cell 18 NE 2013,6750,2682,143982875,-92,9804,9896,6442.66443,2364.851411
Cell 18 NW 2013,6750,2687,144251299.4,614,9804,9190,4675.036844,2575.720013
Cell 18 SE 2013,6750,2690,144412354.1,-92,9787,9879,6196.418959,2455.015055
Cell 18 SSE 2013,6750,2684,144090244.8,-92,9787,9879,5717.73845,2487.58507
Cell 19 NW 2013,6750,2684,144090244.8,1038,9287,8249,6555.659091,2180.721631
Cell 2 2011/12,6750,2686,144197614.5,1635,9292,7657,6317.992182,1853.301781
Cell 2 NE 2013,6750,2682,143982875,-1958,9292,11250,6661.615958,1717.01773
Cell 2 SW 2013,6750,2686,144197614.5,-1954,9513,11467,6390.805659,1975.12697
Cell 20 2013,6750,2684,144090244.8,1474,9571,8097,6660.592772,1897.460529
Cell 21 2013,6750,2687,144251299.4,2206,9182,6976,7441.197246,1093.33998
Cell 22 2013,6750,2687,144251299.4,4978,8920,3942,8001.357276,500.8652161
Cell 23 2013,6750,2698,144841833.2,5845,8920,3075,8207.363232,423.8624545
Cell 24 2013,6750,2687,144251299.4,5858,8977,3119,7948.680685,422.1454128
Cell 25 NE 2013,6750,2682,143982875,-1005,9882,10887,5233.836689,2574.875288
Cell 25 SE 2013,6750,2685,144143929.7,-1005,9882,10887,5467.994786,2641.006118
Cell 26 NE 2013,6750,2684,144090244.8,-92,9787,9879,5888.460507,2415.511664
Cell 26 NNW 2013,6750,2687,144251299.4,-419,9882,10301,5059.387793,2584.376713
Cell 26 NW 2013,6750,2685,144143929.6,-1005,9882,10887,4808.888268,2777.390767
Cell 27 NW 2013,6750,2681,143929190.1,791,9271,8480,6053.424841,2262.028291
Cell 28 2013,6750,2680,143875505.2,1111,9728,8617,4549.616045,2416.523865
Cell 29 2013,6750,2686,144197614.5,1319,9552,8233,6777.436337,1759.60402
Cell 3 NE 2013,6750,2685,144143929.6,-1958,9270,11228,7218.943762,1310.98445
Cell 3 NW 2013,6750,2685,144143929.6,-1958,9266,11224,6579.818994,1798.744867
Cell 30 2013,6750,2688,144304984.3,4051,8980,4929,8127.72433,439.4659328
Cell 31 2013,6750,2685,144143929.6,5623,8967,3344,8128.542272,452.5549305
Cell 32 2013,6750,2684,144090244.8,5623,8938,3315,7974.489568,522.5908526
Cell 33 NE 2013,6750,2683,144036559.9,-639,9693,10332,6299.483041,2154.531497
Cell 33 SE 2013,6750,2684,144090244.8,-1781,9834,11615,5493.337556,2647.953505
Cell 33 SW 2013,6750,2687,144251299.4,-159,9693,9852,5176.163751,2725.545315
Cell 34 N 2013,6750,2687,144251299.4,457,9728,9271,6525.586528,1980.963901
Cell 34 NW 2013,6750,2685,144143929.6,457,9823,9366,6596.4473,1867.592452
Cell 34 SE 2013,6750,2685,144143929.6,418,9959,9541,5930.951583,2323.1766
Cell 35 2013,6750,2703,145110257.7,705,9950,9245,4672.710692,2579.933961
Cell 37 2013,6750,2687,144251299.4,4051,8786,4735,7954.273539,485.7692398
Cell 38 2013,6750,2687,144251299.4,6445,9036,2591,8245.63677,387.7615815
Cell 39 2013,6750,2690,144412354.1,5898,9081,3183,8261.603717,471.0445253
Cell 4 2013,6750,2685,144143929.6,4307,8883,4576,7806.8,455.5230794
Cell 40 NE 2013,6750,2694,144627093.7,-1781,9972,11753,4933.772086,2862.847685
Cell 41 N 2013,6750,2684,144090244.8,-1781,9972,11753,6054.926602,2421.995152
Cell 41 NW 2013,6750,2683,144036559.9,-1781,9972,11753,5613.784197,2676.376489
Cell 42 NW 2013,6750,2686,144197614.5,418,9571,9153,5592.431497,2557.973597
Cell 43 2013,6750,2685,144143929.6,1292,9841,8549,6151.034264,2310.918779
Cell 44 2013,6750,2686,144197614.5,1292,9400,8108,7655.72971,1068.265655
Cell 45 2013,6750,2683,144036559.9,6104,9027,2923,8082.995155,424.8168863
Cell 47 2013,6750,2689,144358669.2,853,9571,8718,6825.443659,2116.688731
Cell 48 2013,6750,2685,144143929.6,1029,9372,8343,6723.366108,2193.33902
Cell 49 2013,6750,2699,144895518.1,1304,9629,8325,6838.933309,1948.35721
Cell 5 2011/12 Summer,6750,2680,143875505.2,-1836,9972,11808,5926.274627,1936.487832
Cell 5 2013,6750,2686,144197614.5,5788,8863,3075,7954.396128,401.786
Cell 50 2013,6750,2684,144090244.8,1375,9692,8317,7198.055887,1673.740384
Cell 51 2013,6750,2682,143982875,6098,9085,2987,8188.149515,387.5309725
Cell 52 2013,6750,2690,144412354.1,1382,9483,8101,7245.767658,1761.586783
Cell 53 2013,6750,2682,143982875,1375,9468,8093,7288.621178,1713.212727
Cell 54 2013,6750,2688,144304984.3,4912,8970,4058,8056.893229,620.4836326
Cell 55 2013,6750,2691,144466039,6255,9005,2750,8155.807507,493.9712582
Cell 56 2013,6750,2685,144143929.6,1430,9074,7644,7267.076723,964.8796434
Cell 57 2013,6750,2688,144304984.3,1681,8980,7299,7162.537946,1295.92985
Cell 58 2013,6750,2690,144412354.1,4584,8980,4396,8220.501859,523.2803731
Cell 59 2013,6750,2694,144627093.7,1441,9542,8101,7102.314031,1262.709714
Cell 6 2011/12,6750,2684,144090244.8,1242,9787,8545,6493.447466,2223.63289
Cell 6 2013,6750,2684,144090244.8,5676,8838,3162,8024.946721,360.0255162
Cell 6 NE 2011/12,6750,2691,144466039,1254,9287,8033,6776.583798,1807.869855
Cell 6 NW 2011/12,6750,2692,144519723.9,614,9513,8899,5972.057207,2544.348646
Cell 6 SW 2011/12,6750,2684,144090244.8,-92,9804,9896,6320.357303,2441.036319
Cell 60 2013,6750,2687,144251299.4,1894,8595,6701,6916.471157,1057.923947
Cell 61 2013,6750,2688,144304984.3,2412,8849,6437,7604.154018,927.1962915
Cell 7 2013,6750,2684,144090244.8,4961,9073,4112,7926.593145,534.3609063
Cell 9 NW 2013,6750,2680,143875505.2,-76,9736,9812,4901.61194,2288.069244
Cell 9 SE 2013,6750,2685,144143929.7,-1836,9736,11572,4638.912104,2386.391122
Cell 9 SW 2013,6750,2685,144143929.6,-1836,9736,11572,5145.843203,2295.687145
Cell R1,6750,2701,145002887.9,1200,8485,7285,5788.469826,1887.811487
Cell R10,6750,2684,144090244.8,4307,8883,4576,7806.200075,455.3577603
Cell R100,6750,2683,144036559.9,1375,9692,8317,7197.632501,1673.908565
Cell R101,6750,2687,144251299.4,4957,9230,4273,7996.963156,544.2258
Cell R104,6750,2687,144251299.4,1301,9468,8167,7043.66952,2029.038712
Cell R105,6750,2681,143929190.1,1375,9468,8093,7288.379336,1713.486434
Cell R106,6750,2685,144143929.6,1375,9692,8317,7373.598883,1527.409626
Cell R107,6750,2688,144304984.3,4912,8970,4058,8056.893229,620.4836326
Cell R11,6750,2688,144304984.3,5788,8863,3075,7954.418527,401.8236147
Cell R111,6750,2684,144090244.8,1197,9468,8271,6774.620715,2305.265129
Cell R112,6750,2687,144251299.4,1978,8980,7002,7724.080387,843.0368282
Cell R113,6750,2687,144251299.4,1681,8980,7299,7162.38035,1296.14899
Cell R114,6750,2688,144304984.3,4584,8980,4396,8220.37128,523.4512557
Cell R117,6750,2691,144466039,1327,9542,8215,6427.295429,2007.94488
Cell R118,6750,2685,144143929.6,1430,9074,7644,7267.076723,964.8796434
Cell R119,6750,2686,144197614.5,1681,8980,7299,6910.567014,1337.397305
Cell R120,6750,2702,145056572.8,2412,8874,6462,7486.215396,1096.780737
Cell R121,6750,2689,144358669.2,5774,8874,3100,8157.758274,405.2383635
Cell R123,6750,2684,144090244.8,1327,9542,8215,6891.525708,1601.875601
Cell R124,6750,2683,144036559.9,1894,8780,6886,6947.614983,1057.470336
Cell R125,6750,2687,144251299.4,1894,8780,6886,6867.348344,1127.997678
Cell R126,6750,2683,144036559.9,1912,8828,6916,7358.882594,1141.385668
Cell R15,6750,2684,144090244.8,-1428,9210,10638,5488.556632,2110.788902
Cell R16,6750,2685,144143929.6,-76,9736,9812,4905.756425,2289.782814
Cell R17,6750,2681,143929190.1,614,9513,8899,6268.953376,2278.430348
Cell R18,6750,2681,143929190.1,1629,9292,7663,6469.001492,1725.296104
Cell R19,6750,2687,144251299.4,1504,9571,8067,6909.779308,1757.968406
Cell R20,6750,2686,144197614.5,1806,8710,6904,7427.080789,1167.972937
Cell R21,6750,2689,144358669.2,1806,8863,7057,7376.082187,1296.770734
Cell R22,6750,2685,144143929.6,4600,8863,4263,7865.344134,501.3854036
Cell R24,6750,2689,144358669.2,-1836,9736,11572,5545.807363,2169.766002
Cell R25,6750,2687,144251299.4,614,9804,9190,4675.036844,2575.720013
Cell R26,6750,2682,143982875,614,9513,8899,5961.680089,2546.074499
Cell R27,6750,2685,144143929.6,1038,9287,8249,6555.823091,2180.332054
Cell R28,6750,2681,143929190.1,1373,9571,8198,6111.817232,2232.163136
Cell R29,6750,2685,144143929.6,1474,9571,8097,6661.070019,1897.268264
Cell R30,6750,2684,144090244.8,2239,8727,6488,7484.281297,1003.119875
Cell R31,6750,2686,144197614.5,3774,8740,4966,7783.750558,552.2036059
Cell R35,6750,2680,143875505.2,-1836,9972,11808,5926.274627,1936.487832
Cell R36,6750,2681,143929190.1,-1836,8869,10705,5409.816859,2318.957101
Cell R37,6750,2690,144412354.1,-92,9787,9879,6196.418959,2455.015055
Cell R38,6750,2685,144143929.6,1111,9787,8676,5759.015642,2497.294622
Cell R39,6750,2684,144090244.8,1335,9487,8152,6803.51006,1837.144257
Cell R40,6750,2687,144251299.4,2206,9182,6976,7441.197246,1093.33998
Cell R46,6750,2685,144143929.7,-1005,9882,10887,5179.582868,2672.48224
Cell R47,6750,2686,144197614.5,-1005,9882,10887,4809.13589,2776.90335
Cell R48,6750,2684,144090244.8,-92,9787,9879,5888.460507,2415.511664
Cell R49,6750,2682,143982875,791,9271,8480,6053.796048,2261.688218
Cell R5,6750,2690,144412354.1,-1428,8571,9999,5705.913011,1950.676072
Cell R50,6750,2680,143875505.2,1111,9728,8617,4549.616045,2416.523865
Cell R51,6750,2683,144036559.9,1319,9552,8233,6794.653373,1744.948189
Cell R52,6750,2681,143929190.1,2206,8914,6708,7549.02611,908.8105047
Cell R53,6750,2687,144251299.4,2815,8794,5979,7698.36137,653.7805121
Cell R54,6750,2685,144143929.6,5623,8967,3344,8128.542272,452.5549305
Cell R58,6750,2685,144143929.6,-908,9693,10601,4892.636127,2759.736486
Cell R59,6750,2685,144143929.6,-639,9693,10332,6299.450652,2154.259373
Cell R6,6750,2686,144197614.5,-1954,9513,11467,6390.805659,1975.12697
Cell R60,6750,2686,144197614.5,457,9823,9366,6594.763217,1869.282762
Cell R61,6750,2701,145002887.9,705,9950,9245,4672.891151,2579.58818
Cell R62,6750,2683,144036559.9,1104,9552,8448,4846.380544,2557.285444
Cell R63,6750,2688,144304984.3,1104,9552,8448,6461.781994,2042.495377
Cell R64,6750,2688,144304984.3,4051,8980,4929,7907.40439,522.1832991
Cell R65,6750,2689,144358669.2,4051,8980,4929,8127.711789,439.3846908
Cell R66,6750,2688,144304984.3,5623,8980,3357,8209.594866,487.3124165
Cell R69,6750,2686,144197614.5,-159,9693,9852,5176.718913,2725.900731
Cell R7,6750,2685,144143929.6,-1958,9266,11224,6578.425326,1799.522693
Cell R70,6750,2684,144090244.8,-1781,9834,11615,5493.337556,2647.953505
Cell R71,6750,2685,144143929.6,418,9959,9541,5930.951583,2323.1766
Cell R72,6750,2687,144251299.4,418,9950,9532,5565.902121,2459.92446
Cell R73,6750,2685,144143929.6,418,9950,9532,4756.710242,2707.264113
Cell R74,6750,2686,144197614.5,1193,9400,8207,6431.880864,2315.968153
Cell R75,6750,2687,144251299.4,4051,8786,4735,7953.951247,486.0286612
Cell R76,6750,2691,144466039,6445,8980,2535,8241.079896,390.0747014
Cell R77,6750,2687,144251299.4,6445,9036,2591,8245.63677,387.7615815
Cell R8,6750,2688,144304984.3,-1958,9270,11228,7174.251488,1325.316881
Cell R80,6750,2694,144627093.7,-1781,9972,11753,4933.772086,2862.847685
Cell R81,6750,2685,144143929.6,-175,9972,10147,6216.486406,2349.803962
Cell R82,6750,2686,144197614.5,418,9571,9153,5592.431497,2557.973597
Cell R83,6750,2686,144197614.5,853,9571,8718,6097.924051,2509.68327
Cell R84,6750,2687,144251299.4,1175,9841,8666,5510.720134,2466.082668
Cell R85,6750,2684,144090244.8,1292,9841,8549,6150.368852,2311.092048
Cell R86,6750,2686,144197614.5,1499,9629,8130,7771.570365,844.5757742
Cell R87,6750,2683,144036559.9,6104,9027,2923,8082.995155,424.8168863
Cell R9,6750,2698,144841833.2,-1958,9270,11228,7362.472572,1233.24242
Cell R90,6750,2688,144304984.3,853,9571,8718,6827.357515,2114.754975
Cell R91,6750,2685,144143929.6,1029,9372,8343,6723.366108,2193.33902
Cell R92,6750,2688,144304984.3,1304,9904,8600,5214.774554,2529.898909
Cell R93,6750,2699,144895518.1,1304,9629,8325,6838.933309,1948.35721
Cell R97,6750,2686,144197614.5,1382,9152,7770,7134.50968,1859.227603
Cell R98,6750,2682,143982875,1382,9177,7795,7126.693139,1979.946125
Cell R99,6750,2689,144358669.2,1382,9483,8101,7245.624024,1761.898558
Cell S102,6750,2687,144251299.4,5712,9085,3373,8202.715668,416.6889883
Cell S108,6750,2691,144466039,6255,9005,2750,8155.807507,493.9712582
Cell S13,6750,2684,144090244.8,5654,8945,3291,7995.054024,407.0538881
Cell S14,6750,2684,144090244.8,4961,9073,4112,7926.593145,534.3609063
Cell S2,6750,2686,144197614.5,5676,8838,3162,8024.82204,359.933761
Cell S23,6750,2689,144358669.2,4961,8877,3916,7965.819636,466.1973366
Cell S32,6750,2686,144197614.5,4978,8920,3942,7975.569993,499.6073687
Cell S33,6750,2687,144251299.4,6215,8963,2748,8034.679196,375.682007
Cell S34,6750,2687,144251299.4,5858,8977,3119,7948.277633,422.7216806
Cell S41,6750,2687,144251299.4,4158,8727,4569,7796.34946,538.1728288
Cell S42,6750,2697,144788148.3,5845,8920,3075,8207.563218,423.8137439
Cell S44,6750,2689,144358669.2,5756,9061,3305,8004.664931,471.7041871
Cell S56,6750,2685,144143929.6,5645,8977,3332,7670.067412,519.7645165
Cell S67,6750,2684,144090244.8,5623,8938,3315,7974.489568,522.5908526
Cell S78,6750,2690,144412354.1,5898,9081,3183,8261.603717,471.0445253
Cell S88,6750,2683,144036559.9,5600,9081,3481,8242.335445,452.3857016
Cell S94,6750,2683,144036559.9,6574,9085,2511,8232.571003,375.6388338
Cell S95,6750,2682,143982875,6098,9085,2987,8188.149515,387.5309725
W287,6750,2686,144197614.5,894,9410,8516,4150.716307,2039.511016
W295,6750,2685,144143929.6,1668,8947,7279,6806.257728,1718.277245
W338,6750,2692,144519723.9,697,9484,8787,3786.188707,2431.827565
W342,6750,2695,144680778.5,976,8946,7970,5283.628571,2432.293281
W345,6750,2681,143929190.1,1609,8580,6971,7434.737411,834.5098768
W387,6750,2684,144090244.8,1012,9470,8458,4969.71386,2315.180271
W393,6750,2683,144036559.9,985,8860,7875,5719.777861,2350.940901
W440,6750,2683,144036559.9,1073,9239,8166,5191.767797,2186.113206
W441,6750,2682,143982875,1155,9239,8084,6649.607383,1432.147005
W445,6750,2690,144412354.1,2651,8548,5897,6810.841264,996.5014304
W500,6750,2683,144036559.9,1196,8598,7402,6273.383899,1763.64437
1,7000,2887,154988277.4,-1954,9513,11467,6317.899203,2013.334717
2,7000,2894,155364071.7,1504,9292,7788,6322.771596,1873.978907
3,7000,2887,154988277.4,1635,9498,7863,7190.413232,1519.697785
4,7000,2887,154988277.4,1806,8536,6730,7430.434707,1164.053905
5,7000,2886,154934592.5,-1836,9972,11808,5878.643798,1975.892324
6,7000,2891,155203017,1242,9787,8545,6454.602214,2227.450754
7,7000,2894,155364071.7,1373,9571,8198,6374.618521,2116.899023
8,7000,2887,154988277.4,1806,8520,6714,7151.301697,1375.150911
9,7000,2886,154934592.5,4978,8920,3942,7956.171171,507.7848314
10,7000,2893,155310386.8,-1005,9882,10887,5196.91635,2603.165165
11,7000,2880,154612483.2,-92,9787,9879,5941.409028,2424.274039
12,7000,2876,154397743.6,1111,9728,8617,4530.890821,2437.857313
13,7000,2883,154773537.9,1319,9552,8233,6729.941034,1807.88402
14,7000,2888,155041962.3,5717,8967,3250,8122.476801,413.3786162
16,7000,2880,154612483.2,-159,9693,9852,5177.244444,2704.053539
17,7000,2884,154827222.8,457,9823,9366,6529.808252,1922.706736
18,7000,2895,155417756.6,705,9950,9245,4797.855268,2562.757493
19,7000,2897,155525126.3,1104,9552,8448,4927.327235,2566.030412
20,7000,2890,155149332.1,4051,8901,4850,7941.469896,497.2311855
21,7000,2896,155471441.4,6445,9036,2591,8251.125,386.0376411
22,7000,2893,155310386.8,-1781,9972,11753,4770.753197,2958.857598
23,7000,2886,154934592.5,418,9571,9153,5675.128898,2531.267968
24,7000,2887,154988277.4,1029,9372,8343,6696.034292,2206.561794
25,7000,2889,155095647.2,1304,9629,8325,6829.645898,1961.964907
26,7000,2893,155310386.8,6082,9085,3003,8078.717249,439.8902711
27,7000,2891,155203017,1382,9483,8101,7075.72743,2022.423525
28,7000,2892,155256701.9,1375,9524,8149,7275.914246,1723.302141
29,7000,2886,154934592.5,1375,9692,8317,7175.865904,1695.420955
31,7000,2896,155471441.4,1421,9468,8047,7319.657113,1651.95747
32,7000,2895,155417756.6,1681,8980,7299,7179.142314,1285.885989
33,7000,2883,154773537.9,1430,9079,7649,7222.501561,1080.25542
34,7000,2895,155417756.6,1894,8595,6701,6895.245596,1070.066318
10A,7000,2880,154612483.2,-1005,9882,10887,4790.078472,2782.504071
10NE,7000,2888,155041962.3,-507,9882,10389,5030.485111,2597.760924
10NW,7000,2893,155310386.8,-1836,8869,10705,5388.34739,2321.976522
10SW,7000,2881,154666168.1,-1005,9882,10887,5432.841722,2653.329191
11NE,7000,2893,155310386.8,-92,9787,9879,6142.68925,2477.768459
11NW,7000,2883,154773537.9,-92,9787,9879,5776.48734,2488.468521
11SE,7000,2892,155256701.9,791,9271,8480,6093.912517,2265.256541
17NW,7000,2892,155256701.9,-706,9693,10399,6262.028354,2201.861622
17SE,7000,2890,155149332.1,-1451,9972,11423,5890.780277,2355.15977
17SW,7000,2880,154612483.2,-1781,9851,11632,5514.165278,2655.03413
22S,7000,2893,155310386.8,-1781,9972,11753,4622.110612,2964.92398
23S,7000,2876,154397743.6,1111,9571,8460,4556.449235,2290.341462
24S,7000,2895,155417756.6,1029,9372,8343,6675.218307,2217.433931
27A,7000,2887,154988277.4,1125,9427,8302,7055.399723,1917.964324
2A,7000,2886,154934592.5,-1958,9292,11250,6512.431046,1735.485593
5NE,7000,2888,155041962.3,-1836,9736,11572,4656.840028,2388.732832
5NW,7000,2893,155310386.8,-1836,9736,11572,5124.500173,2305.382819
5SE,7000,2884,154827222.8,592,9804,9212,4796.893204,2618.082739
6NE,7000,2889,155095647.2,1254,9287,8033,6712.024576,1855.040003
6NW,7000,2889,155095647.2,614,9513,8899,5988.787124,2525.322733
6SW,7000,2890,155149332.1,-92,9804,9896,6243.483737,2491.462736
Cell 1 2011/12,7000,2887,154988277.4,-1954,9513,11467,6317.899203,2013.334717
Cell 1 SW 2013,7000,2880,154612483.2,-1428,9210,10638,5536.280556,2116.353294
Cell 10 2011/12,7000,2893,155310386.8,-1005,9882,10887,5196.91635,2603.165165
Cell 10 NE 2011/12,7000,2888,155041962.3,-507,9882,10389,5030.485111,2597.760924
Cell 10 NW 2011/12,7000,2893,155310386.8,-1836,8869,10705,5388.34739,2321.976522
Cell 10 SE 2013,7000,2889,155095647.2,614,9513,8899,5988.787124,2525.322733
Cell 10 SW 2011/12,7000,2881,154666168.1,-1005,9882,10887,5432.841722,2653.329191
Cell 10-A 2011/12,7000,2880,154612483.2,-1005,9882,10887,4790.078472,2782.504071
Cell 11 NE 2011/12,7000,2893,155310386.8,-92,9787,9879,6142.68925,2477.768459
Cell 11 NW 2013,7000,2887,154988277.4,-1958,9292,11250,6473.520263,1755.942235
Cell 11 SW 2013,7000,2887,154988277.4,1242,9287,8045,6650.111188,2048.951668
Cell 12 2013,7000,2893,155310386.8,1373,9571,8198,6380.856205,2113.066622
Cell 13 2013,7000,2886,154934592.5,1806,8516,6710,7129.903326,1388.251425
Cell 14 2013,7000,2884,154827222.8,4196,8863,4667,7857.333564,526.0221392
Cell 15 2013,7000,2895,155417756.6,5061,8798,3737,7974.206563,447.3126089
Cell 15-A 2013,7000,2888,155041962.3,5061,8963,3902,8031.069598,384.5924278
Cell 16 2013,7000,2894,155364071.7,5858,8963,3105,7996.998963,407.2294413
Cell 17 NW 2011/12,7000,2892,155256701.9,-706,9693,10399,6262.028354,2201.861622
Cell 17 NW 2013,7000,2889,155095647.2,-1836,9736,11572,5504.869159,2196.671533
Cell 17 SE 2013,7000,2892,155256701.9,-1836,8869,10705,5387.898686,2322.25253
Cell 17 SW 2013,7000,2881,154666168.1,-1836,9972,11808,5880.894481,1976.081842
Cell 18 2011/12,7000,2895,155417756.6,705,9950,9245,4797.855268,2562.757493
Cell 18 NE 2013,7000,2883,154773537.9,-92,9804,9896,6375.166493,2410.509972
Cell 18 NW 2013,7000,2891,155203017,592,9804,9212,4792.319958,2597.939033
Cell 18 SE 2013,7000,2892,155256701.9,-92,9787,9879,6142.25,2478.084185
Cell 18 SSE 2013,7000,2892,155256701.9,-92,9787,9879,5792.716459,2477.570646
Cell 19 NW 2013,7000,2891,155203017,1036,9287,8251,6507.102733,2191.253927
Cell 2 2011/12,7000,2894,155364071.7,1504,9292,7788,6322.771596,1873.978907
Cell 2 NE 2013,7000,2893,155310386.8,-1958,9292,11250,6644.391289,1744.49228
Cell 2 SW 2013,7000,2892,155256701.9,-1954,9513,11467,6317.134855,2013.346671
Cell 20 2013,7000,2888,155041962.3,1386,9571,8185,6610.360803,1931.815764
Cell 21 2013,7000,2890,155149332.1,2206,9552,7346,7422.148443,1108.412202
Cell 22 2013,7000,2894,155364071.7,4978,8920,3942,7994.513822,504.0659816
Cell 23 2013,7000,2889,155095647.2,5845,8920,3075,8200.816892,422.7046919
Cell 24 2013,7000,2895,155417756.6,5858,8977,3119,7953.432124,424.7596172
Cell 25 NE 2013,7000,2893,155310386.8,-1005,9882,10887,5196.91635,2603.165165
Cell 25 SE 2013,7000,2881,154666168.1,-1005,9882,10887,5432.841722,2653.329191
Cell 26 NE 2013,7000,2880,154612483.2,-92,9787,9879,5941.409028,2424.274039
Cell 26 NNW 2013,7000,2887,154988277.4,-507,9882,10389,5031.357811,2597.787482
Cell 26 NW 2013,7000,2880,154612483.2,-1005,9882,10887,4790.078472,2782.504071
Cell 27 NW 2013,7000,2892,155256701.9,791,9271,8480,6093.912517,2265.256541
Cell 28 2013,7000,2876,154397743.6,1111,9728,8617,4530.890821,2437.857313
Cell 29 2013,7000,2888,155041962.3,1319,9552,8233,6730.290859,1806.529446
Cell 3 NE 2013,7000,2888,155041962.3,-1958,9270,11228,7194.164474,1333.676423
Cell 3 NW 2013,7000,2888,155041962.3,-1958,9266,11224,6543.591413,1815.948204
Cell 30 2013,7000,2895,155417756.6,4051,8980,4929,8122.606908,444.6026114
Cell 31 2013,7000,2883,154773537.9,5623,8967,3344,8133.935831,454.3631202
Cell 32 2013,7000,2895,155417756.6,5623,8938,3315,7985.031434,521.774627
Cell 33 NE 2013,7000,2892,155256701.9,-706,9693,10399,6262.028354,2201.861622
Cell 33 SE 2013,7000,2881,154666168.1,-1781,9851,11632,5509.992017,2657.1667
Cell 33 SW 2013,7000,2888,155041962.3,-159,9693,9852,5216.553324,2701.120293
Cell 34 N 2013,7000,2890,155149332.1,457,9823,9366,6426.443945,2049.813256
Cell 34 NW 2013,7000,2884,154827222.8,457,9823,9366,6529.808252,1922.706736
Cell 34 SE 2013,7000,2887,154988277.4,-1451,9972,11423,5889.631451,2356.018719
Cell 35 2013,7000,2885,154880907.7,705,9950,9245,4680.436049,2578.071133
Cell 37 2013,7000,2896,155471441.4,4051,8901,4850,7943.639848,496.2292188
Cell 38 2013,7000,2883,154773537.9,6445,9036,2591,8253.080819,386.8462676
Cell 39 2013,7000,2891,155203017,5898,9081,3183,8247.215496,476.1411455
Cell 4 2013,7000,2893,155310386.8,4307,8883,4576,7791.891462,488.4713183
Cell 40 NE 2013,7000,2886,154934592.5,-1781,9972,11753,4928.489951,2880.564678
Cell 41 N 2013,7000,2880,154612483.2,-1781,9972,11753,6031.580556,2423.064713
Cell 41 NW 2013,7000,2888,155041962.3,-1781,9972,11753,5578.840374,2693.635398
Cell 42 NW 2013,7000,2880,154612483.2,418,9571,9153,5673.911458,2536.645536
Cell 43 2013,7000,2882,154719853,1250,9841,8591,6113.849063,2332.514301
Cell 44 2013,7000,2882,154719853,1292,9400,8108,7605.049618,1158.16908
Cell 45 2013,7000,2894,155364071.7,6082,9085,3003,8079.088804,440.104921
Cell 47 2013,7000,2889,155095647.2,853,9571,8718,6843.581862,2114.739471
Cell 48 2013,7000,2892,155256701.9,1029,9372,8343,6671.826418,2218.779171
Cell 49 2013,7000,2888,155041962.3,1304,9629,8325,6829.311288,1962.222132
Cell 5 2011/12 Summer,7000,2881,154666168.1,-1836,9972,11808,5880.894481,1976.081842
Cell 5 2013,7000,2887,154988277.4,5788,8863,3075,7950.298926,401.2359037
Cell 50 2013,7000,2886,154934592.5,1375,9692,8317,7175.865904,1695.420955
Cell 51 2013,7000,2877,154451428.5,5712,9085,3373,8188.218631,387.698918
Cell 52 2013,7000,2889,155095647.2,1375,9483,8108,7204.345794,1803.198544
Cell 53 2013,7000,2893,155310386.8,1375,9524,8149,7276.200138,1723.072868
Cell 54 2013,7000,2896,155471441.4,2289,8980,6691,8042.607044,656.4449023
Cell 55 2013,7000,2889,155095647.2,6255,9005,2750,8147.269643,494.1400763
Cell 56 2013,7000,2883,154773537.9,1430,9079,7649,7220.139091,1082.565402
Cell 57 2013,7000,2894,155364071.7,1681,8980,7299,7178.62094,1285.83432
Cell 58 2013,7000,2889,155095647.2,2678,8980,6302,8195.077189,569.5017351
Cell 59 2013,7000,2895,155417756.6,1327,9542,8215,7060.715717,1327.321678
Cell 6 2011/12,7000,2891,155203017,1242,9787,8545,6454.602214,2227.450754
Cell 6 2013,7000,2893,155310386.8,5676,8838,3162,8021.233322,364.4502992
Cell 6 NE 2011/12,7000,2889,155095647.2,1254,9287,8033,6712.024576,1855.040003
Cell 6 NW 2011/12,7000,2889,155095647.2,614,9513,8899,5988.787124,2525.322733
Cell 6 SW 2011/12,7000,2890,155149332.1,-92,9804,9896,6243.483737,2491.462736
Cell 60 2013,7000,2883,154773537.9,1894,8780,6886,6907.566077,1057.394914
Cell 61 2013,7000,2900,155686181,2412,8849,6437,7577.962759,979.9994557
Cell 7 2013,7000,2881,154666168.1,4961,9073,4112,7932.761541,531.384509
Cell 9 NW 2013,7000,2893,155310386.8,-76,9736,9812,4942.376772,2297.657946
Cell 9 SE 2013,7000,2889,155095647.2,-1836,9736,11572,4657.651783,2388.717749
Cell 9 SW 2013,7000,2895,155417756.5,-1836,9736,11572,5122.91848,2305.712049
Cell R1,7000,2885,154880907.6,1200,8485,7285,5779.84714,1879.233163
Cell R10,7000,2893,155310386.8,4307,8883,4576,7791.891462,488.4713183
Cell R100,7000,2886,154934592.5,1375,9692,8317,7175.314622,1695.42261
Cell R101,7000,2896,155471441.4,4957,9692,4735,7998.581146,547.488678
Cell R104,7000,2896,155471441.4,1301,9468,8167,7051.148135,2018.772095
Cell R105,7000,2893,155310386.8,1375,9524,8149,7276.200138,1723.072868
Cell R106,7000,2897,155525126.3,1375,9692,8317,7383.943735,1509.401072
Cell R107,7000,2897,155525126.3,2289,8980,6691,8042.424922,656.4047673
Cell R11,7000,2888,155041962.3,5788,8863,3075,7950.159626,401.2362481
Cell R111,7000,2894,155364071.7,1197,9468,8271,6756.268141,2300.478484
Cell R112,7000,2887,154988277.4,1681,8980,7299,7682.897818,883.3818913
Cell R113,7000,2894,155364071.7,1681,8980,7299,7179.45888,1285.893269
Cell R114,7000,2889,155095647.2,2678,8980,6302,8195.077189,569.5017351
Cell R117,7000,2895,155417756.6,1327,9542,8215,6406.230743,2032.918877
Cell R118,7000,2883,154773537.9,1430,9079,7649,7220.139091,1082.565402
Cell R119,7000,2895,155417756.6,1681,8980,7299,6935.214508,1318.595951
Cell R120,7000,2888,155041962.3,2412,8874,6462,7466.274584,1130.559407
Cell R121,7000,2895,155417756.6,5588,8874,3286,8157.287047,420.5801029
Cell R123,7000,2890,155149332.1,1327,9542,8215,6841.583391,1647.809185
Cell R124,7000,2885,154880907.7,1894,8780,6886,6949.918891,1055.944828
Cell R125,7000,2886,154934592.5,1894,8780,6886,6845.204782,1131.056267
Cell R126,7000,2884,154827222.8,1894,8828,6934,7346.033981,1168.312464
Cell R15,7000,2878,154505113.4,-1428,9210,10638,5535.37665,2116.801724
Cell R16,7000,2894,155364071.7,-76,9736,9812,4939.395301,2296.392742
Cell R17,7000,2884,154827222.8,614,9513,8899,6199.748266,2307.579781
Cell R18,7000,2876,154397743.6,-1958,9292,11250,6472.724618,1757.169708
Cell R19,7000,2894,155364071.7,1504,9571,8067,6882.63027,1741.353288
Cell R20,7000,2888,155041962.3,1806,8750,6944,7435.171399,1162.70197
Cell R21,7000,2887,154988277.4,1806,8863,7057,7353.602009,1317.681727
Cell R22,7000,2886,154934592.5,4196,8863,4667,7856.877339,526.4944945
Cell R24,7000,2889,155095647.2,-1836,9736,11572,5504.869159,2196.671533
Cell R25,7000,2891,155203017,592,9804,9212,4792.319958,2597.939033
Cell R26,7000,2892,155256701.9,614,9513,8899,5975.104772,2525.756199
Cell R27,7000,2891,155203017,1036,9287,8251,6508.324455,2191.336601
Cell R28,7000,2891,155203017,1373,9571,8198,6094.523694,2223.702293
Cell R29,7000,2888,155041962.3,1386,9571,8185,6610.360803,1931.815764
Cell R30,7000,2894,155364071.7,2165,8727,6562,7486.44886,1016.430305
Cell R31,7000,2883,154773537.9,2876,8740,5864,7771.996878,579.7628909
Cell R35,7000,2881,154666168.1,-1836,9972,11808,5880.894481,1976.081842
Cell R36,7000,2893,155310386.8,-1836,8869,10705,5388.34739,2321.976522
Cell R37,7000,2893,155310386.8,-92,9787,9879,6142.68925,2477.768459
Cell R38,7000,2882,154719853,956,9787,8831,5731.039556,2502.503161
Cell R39,7000,2893,155310386.8,1335,9487,8152,6762.501901,1870.227286
Cell R40,7000,2891,155203017,2206,9552,7346,7421.570045,1109.383192
Cell R46,7000,2886,154934592.5,-1005,9882,10887,5193.624047,2681.625466
Cell R47,7000,2880,154612483.2,-1005,9882,10887,4790.078472,2782.504071
Cell R48,7000,2882,154719853,-92,9787,9879,5943.015267,2424.199258
Cell R49,7000,2892,155256701.9,791,9271,8480,6092.317427,2265.243595
Cell R5,7000,2887,154988277.4,-1428,8571,9999,5723.363007,1944.229316
Cell R50,7000,2876,154397743.6,1111,9728,8617,4530.890821,2437.857313
Cell R51,7000,2883,154773537.9,1319,9552,8233,6743.377385,1792.471171
Cell R52,7000,2885,154880907.7,2206,8914,6708,7545.97435,895.6918359
Cell R53,7000,2889,155095647.2,2214,8794,6580,7690.636899,673.6608546
Cell R54,7000,2883,154773537.9,5623,8967,3344,8133.691641,454.3173359
Cell R58,7000,2885,154880907.7,-908,9693,10601,4955.183016,2761.223965
Cell R59,7000,2892,155256701.9,-706,9693,10399,6262.028354,2201.861622
Cell R6,7000,2890,155149332.1,-1954,9513,11467,6317.847405,2012.452573
Cell R60,7000,2885,154880907.7,457,9823,9366,6529.329289,1922.545555
Cell R61,7000,2885,154880907.7,705,9950,9245,4680.436049,2578.071133
Cell R62,7000,2885,154880907.7,1104,9552,8448,4880.012825,2570.602303
Cell R63,7000,2887,154988277.4,1104,9552,8448,6412.837894,2083.718367
Cell R64,7000,2889,155095647.2,4051,8980,4929,7906.508827,542.1571793
Cell R65,7000,2896,155471441.4,4051,8980,4929,8122.47134,444.585686
Cell R66,7000,2884,154827222.8,5623,8980,3357,8193.979196,487.4730665
Cell R69,7000,2886,154934592.5,-159,9693,9852,5217.111227,2701.891205
Cell R7,7000,2890,155149332.1,-1958,9266,11224,6544.406228,1815.583813
Cell R70,7000,2881,154666168.1,-1781,9851,11632,5509.992017,2657.1667
Cell R71,7000,2888,155041962.3,-1451,9972,11423,5890.307479,2355.890823
Cell R72,7000,2888,155041962.3,418,9950,9532,5565.887812,2478.259049
Cell R73,7000,2879,154558798.3,418,9950,9532,4739.511289,2708.282751
Cell R74,7000,2892,155256701.9,540,9400,8860,6385.035961,2348.270301
Cell R75,7000,2894,155364071.7,4051,8901,4850,7943.628887,496.34841
Cell R76,7000,2885,154880907.7,6445,8980,2535,8237.160485,386.9903194
Cell R77,7000,2883,154773537.9,6445,9036,2591,8252.923691,386.8736845
Cell R8,7000,2886,154934592.5,-1958,9292,11250,7173.725572,1321.506947
Cell R80,7000,2885,154880907.7,-1781,9972,11753,4927.923744,2880.903291
Cell R81,7000,2892,155256701.9,-1781,9972,11753,6143.621024,2406.856068
Cell R82,7000,2880,154612483.2,418,9571,9153,5673.911458,2536.645536
Cell R83,7000,2887,154988277.4,418,9571,9153,6142.608244,2502.114516
Cell R84,7000,2894,155364071.7,540,9841,9301,5555.639254,2476.777891
Cell R85,7000,2881,154666168.1,1250,9841,8591,6113.121138,2332.59176
Cell R86,7000,2892,155256701.9,1499,9629,8130,7739.052213,932.5331088
Cell R87,7000,2895,155417756.6,6082,9085,3003,8078.976511,440.0703674
Cell R9,7000,2887,154988277.4,-1958,9270,11228,7346.224108,1244.197706
Cell R90,7000,2889,155095647.2,853,9571,8718,6843.581862,2114.739471
Cell R91,7000,2893,155310386.8,1029,9372,8343,6672.526789,2218.715373
Cell R92,7000,2888,155041962.3,1304,9904,8600,5308.092798,2529.220703
Cell R93,7000,2887,154988277.4,1304,9629,8325,6828.814687,1962.38048
Cell R97,7000,2882,154719853,1382,9152,7770,7146.273074,1858.78748
Cell R98,7000,2892,155256701.9,1382,9483,8101,7075.951245,2022.109646
Cell R99,7000,2889,155095647.2,1375,9483,8108,7204.345794,1803.198544
Cell S102,7000,2892,155256701.9,5712,9085,3373,8201.548064,415.0843164
Cell S108,7000,2887,154988277.4,6255,9005,2750,8147.168687,494.214345
Cell S13,7000,2887,154988277.4,5654,8945,3291,7996.432629,412.7266623
Cell S14,7000,2880,154612483.2,4961,9073,4112,7933.051389,531.2490034
Cell S2,7000,2894,155364071.7,5676,8838,3162,8021.381479,364.4744533
Cell S23,7000,2887,154988277.4,4961,8877,3916,7962.321095,468.5314591
Cell S32,7000,2888,155041962.3,4978,8920,3942,7978.605263,494.2966
Cell S33,7000,2890,155149332.1,5061,8963,3902,8031.175433,384.5348208
Cell S34,7000,2894,155364071.7,5858,8977,3119,7953.361783,424.8161382
Cell S41,7000,2887,154988277.4,4158,8727,4569,7791.705577,548.208739
Cell S42,7000,2891,155203017,5845,8920,3075,8201.040125,422.6597755
Cell S44,7000,2889,155095647.2,5754,9061,3307,7997.202146,476.4832279
Cell S56,7000,2891,155203017,5528,8977,3449,7670.477343,518.7629277
Cell S67,7000,2895,155417756.6,5623,8938,3315,7985.031434,521.774627
Cell S78,7000,2891,155203017,5898,9081,3183,8247.215496,476.1411455
Cell S88,7000,2895,155417756.6,5600,9081,3481,8241.879102,452.8097595
Cell S94,7000,2893,155310386.8,6249,9085,2836,8222.186657,383.9570685
Cell S95,7000,2876,154397743.6,5712,9085,3373,8188.039291,387.6469817
W287,7000,2887,154988277.4,894,9410,8516,4168.497749,2029.937419
W295,7000,2891,155203017,1633,9145,7512,6818.568315,1716.174712
W338,7000,2887,154988277.4,697,9484,8787,3736.255282,2401.673062
W342,7000,2889,155095647.2,976,8946,7970,5304.503288,2414.160438
W345,7000,2890,155149332.1,1609,8580,6971,7428.116955,842.8105433
W387,7000,2888,155041962.3,1012,9470,8458,4908.304017,2313.127141
W393,7000,2890,155149332.1,866,8860,7994,5635.722491,2406.402403
W440,7000,2881,154666168.1,1073,9239,8166,5213.309962,2197.981927
W441,7000,2887,154988277.4,1130,9239,8109,6583.118116,1512.798143
W445,7000,2887,154988277.4,2651,8548,5897,6801.386907,1012.303242
W500,7000,2885,154880907.7,1196,8598,7402,6287.853726,1747.954508
1,7250,3099,166369474.1,-1954,9513,11467,6252.149403,2045.099356
2,7250,3102,166530528.8,1504,9292,7788,6345.961315,1886.649101
3,7250,3097,166262104.3,1635,9498,7863,7174.37165,1516.936766
4,7250,3098,166315789.2,1806,8536,6730,7435.129116,1152.168073
5,7250,3091,165939995,-1836,9972,11808,5828.959884,2009.65546
6,7250,3100,166423159,1038,9787,8749,6414.079355,2235.796482
7,7250,3102,166530528.8,1373,9571,8198,6324.54481,2135.092918
8,7250,3096,166208419.4,1806,8653,6847,7169.876292,1354.771395
9,7250,3098,166315789.2,4978,8920,3942,7962.249193,501.5725592
10,7250,3098,166315789.2,-1005,9882,10887,5165.5949,2631.09565
11,7250,3090,165886310.1,-92,9787,9879,5992.969903,2427.079566
12,7250,3092,165993679.9,1088,9728,8640,4503.242561,2455.684176
13,7250,3098,166315789.2,1319,9552,8233,6687.290187,1852.963773
14,7250,3100,166423159,5717,8967,3250,8124.58129,420.3227602
16,7250,3092,165993679.9,-159,9693,9852,5169.154592,2682.081215
17,7250,3097,166262104.3,457,9823,9366,6471.210526,1967.767857
18,7250,3101,166476843.9,705,9950,9245,4794.914866,2549.102899
19,7250,3090,165886310.1,1104,9552,8448,4946.49644,2571.802587
20,7250,3100,166423159,4051,8901,4850,7934.937742,504.3772056
21,7250,3106,166745268.3,6445,9036,2591,8256.543142,385.1480522
22,7250,3103,166584213.7,-1781,9972,11753,4778.74154,2945.672907
23,7250,3111,167013692.8,418,9571,9153,5750.990357,2504.910101
24,7250,3098,166315789.2,1029,9372,8343,6652.665913,2224.321212
25,7250,3111,167013692.8,1304,9629,8325,6833.484089,1967.254297
26,7250,3101,166476843.9,5756,9085,3329,8070.960658,458.2413599
27,7250,3094,166101049.7,1382,9483,8101,7023.893019,2060.291997
28,7250,3094,166101049.7,1375,9524,8149,7263.464124,1739.705669
29,7250,3104,166637898.6,1375,9692,8317,7156.433956,1711.174952
31,7250,3103,166584213.7,1417,9468,8051,7285.750886,1692.219292
32,7250,3101,166476843.9,1681,8980,7299,7201.44405,1267.693948
33,7250,3101,166476843.9,1430,9542,8112,7163.473073,1225.836685
34,7250,3102,166530528.8,1894,8780,6886,6891.969697,1066.077974
10A,7250,3093,166047364.8,-1005,9882,10887,4790.783705,2783.077926
10NE,7250,3095,166154734.5,-1005,9882,10887,5015.168982,2616.623718
10NW,7250,3089,165832625.2,-1836,9050,10886,5378.496925,2329.1565
10SW,7250,3088,165778940.3,-1005,9882,10887,5377.299547,2667.078523
11NE,7250,3103,166584213.7,-92,9787,9879,6090.89204,2492.296188
11NW,7250,3097,166262104.3,-92,9787,9879,5833.451727,2486.023413
11SE,7250,3100,166423159,791,9418,8627,6138.216129,2264.980195
17NW,7250,3100,166423159,-908,9693,10601,6208.215484,2255.171033
17SE,7250,3102,166530528.8,-1451,9972,11423,5883.470986,2378.442826
17SW,7250,3090,165886310.1,-1781,9851,11632,5520.972816,2662.457497
22S,7250,3092,165993679.9,-1781,9972,11753,4635.679495,2947.297895
23S,7250,3092,165993679.9,1111,9571,8460,4620.862225,2302.339228
24S,7250,3097,166262104.3,1029,9372,8343,6639.33484,2229.235912
27A,7250,3098,166315789.2,1120,9427,8307,7041.078115,1942.235985
2A,7250,3097,166262104.3,-1958,9292,11250,6524.590249,1750.967403
5NE,7250,3096,166208419.4,-1836,9736,11572,4690.435078,2378.339556
5NW,7250,3102,166530528.8,-1836,9736,11572,5105.90619,2304.312796
5SE,7250,3095,166154734.5,592,9804,9212,4913.465913,2622.418215
6NE,7250,3105,166691583.4,1254,9287,8033,6629.842834,1914.18986
6NW,7250,3105,166691583.4,614,9513,8899,6002.839936,2505.756998
6SW,7250,3091,165939995,-92,9804,9896,6173.632805,2536.340126
Cell 1 2011/12,7250,3099,166369474.1,-1954,9513,11467,6252.149403,2045.099356
Cell 1 SW 2013,7250,3096,166208419.4,-1428,9285,10713,5584.206395,2120.459816
Cell 10 2011/12,7250,3098,166315789.2,-1005,9882,10887,5165.5949,2631.09565
Cell 10 NE 2011/12,7250,3095,166154734.5,-1005,9882,10887,5015.168982,2616.623718
Cell 10 NW 2011/12,7250,3089,165832625.2,-1836,9050,10886,5378.496925,2329.1565
Cell 10 SE 2013,7250,3105,166691583.4,614,9513,8899,6002.839936,2505.756998
Cell 10 SW 2011/12,7250,3088,165778940.3,-1005,9882,10887,5377.299547,2667.078523
Cell 10-A 2011/12,7250,3093,166047364.8,-1005,9882,10887,4790.783705,2783.077926
Cell 11 NE 2011/12,7250,3103,166584213.7,-92,9787,9879,6090.89204,2492.296188
Cell 11 NW 2013,7250,3097,166262104.3,-1958,9292,11250,6479.116887,1788.334462
Cell 11 SW 2013,7250,3101,166476843.9,1036,9287,8251,6582.332473,2083.397861
Cell 12 2013,7250,3100,166423159,1373,9571,8198,6324.410645,2135.118898
Cell 13 2013,7250,3098,166315789.2,1806,8520,6714,7159.526146,1357.832427
Cell 14 2013,7250,3099,166369474.1,2706,8863,6157,7839.320426,581.8836901
Cell 15 2013,7250,3100,166423159,5061,8903,3842,7985.682258,449.5105417
Cell 15-A 2013,7250,3096,166208419.4,5061,8963,3902,8028.677649,391.5679664
Cell 16 2013,7250,3103,166584213.7,5858,8963,3105,7999.814695,406.3229248
Cell 17 NW 2011/12,7250,3100,166423159,-908,9693,10601,6208.215484,2255.171033
Cell 17 NW 2013,7250,3103,166584213.7,-1836,9736,11572,5470.41476,2217.841246
Cell 17 SE 2013,7250,3091,165939995,-1836,9050,10886,5375.960207,2330.552639
Cell 17 SW 2013,7250,3095,166154734.5,-1836,9972,11808,5832.477868,2008.255369
Cell 18 2011/12,7250,3101,166476843.9,705,9950,9245,4794.914866,2549.102899
Cell 18 NE 2013,7250,3099,166369474.1,-92,9804,9896,6296.694095,2460.671255
Cell 18 NW 2013,7250,3100,166423159,592,9804,9212,4902.700968,2609.349482
Cell 18 SE 2013,7250,3103,166584213.7,-92,9787,9879,6090.89204,2492.296188
Cell 18 SSE 2013,7250,3102,166530528.8,-92,9787,9879,5872.650226,2475.395282
Cell 19 NW 2013,7250,3101,166476843.9,1036,9287,8251,6464.240568,2200.694985
Cell 2 2011/12,7250,3102,166530528.8,1504,9292,7788,6345.961315,1886.649101
Cell 2 NE 2013,7250,3090,165886310.1,-1958,9292,11250,6625.48479,1766.44602
Cell 2 SW 2013,7250,3099,166369474.1,-1954,9513,11467,6252.17554,2045.115821
Cell 20 2013,7250,3097,166262104.3,1386,9571,8185,6557.198579,1969.162416
Cell 21 2013,7250,3099,166369474.1,1810,9552,7742,7395.563085,1142.781917
Cell 22 2013,7250,3094,166101049.7,4978,8920,3942,7985.435036,508.2468404
Cell 23 2013,7250,3110,166960007.9,5845,8920,3075,8194.001929,421.9932993
Cell 24 2013,7250,3104,166637898.6,5858,8977,3119,7961.746134,426.2833572
Cell 25 NE 2013,7250,3099,166369474.1,-1005,9882,10887,5164.550177,2631.313698
Cell 25 SE 2013,7250,3088,165778940.3,-1005,9882,10887,5377.299547,2667.078523
Cell 26 NE 2013,7250,3090,165886310.1,-92,9787,9879,5992.969903,2427.079566
Cell 26 NNW 2013,7250,3094,166101049.7,-1005,9882,10887,5015.251778,2617.042485
Cell 26 NW 2013,7250,3093,166047364.8,-1005,9882,10887,4790.783705,2783.077926
Cell 27 NW 2013,7250,3100,166423159,791,9418,8627,6138.216129,2264.980195
Cell 28 2013,7250,3092,165993679.9,1088,9728,8640,4503.242561,2455.684176
Cell 29 2013,7250,3097,166262104.3,1319,9552,8233,6686.582822,1854.306663
Cell 3 NE 2013,7250,3097,166262104.3,-1958,9292,11250,7188.5134,1334.96363
Cell 3 NW 2013,7250,3097,166262104.3,-1958,9292,11250,6526.749435,1825.508048
Cell 30 2013,7250,3101,166476843.9,4051,8980,4929,8111.495647,458.3803649
Cell 31 2013,7250,3100,166423159,5623,8967,3344,8141.735161,455.1287998
Cell 32 2013,7250,3094,166101049.7,5623,8938,3315,7991.578539,521.3604476
Cell 33 NE 2013,7250,3100,166423159,-908,9693,10601,6208.215484,2255.171033
Cell 33 SE 2013,7250,3090,165886310.1,-1781,9851,11632,5520.972816,2662.457497
Cell 33 SW 2013,7250,3097,166262104.3,-159,9693,9852,5230.108815,2679.883151
Cell 34 N 2013,7250,3097,166262104.3,457,9823,9366,6343.220536,2099.840415
Cell 34 NW 2013,7250,3098,166315789.2,457,9823,9366,6471.004519,1967.483646
Cell 34 SE 2013,7250,3097,166262104.3,-1451,9972,11423,5883.078463,2378.098233
Cell 35 2013,7250,3111,167013692.8,705,9950,9245,4701.56252,2586.885254
Cell 37 2013,7250,3104,166637898.6,4051,8901,4850,7937.693621,502.8840853
Cell 38 2013,7250,3099,166369474.1,6445,9036,2591,8259.68635,384.9817114
Cell 39 2013,7250,3100,166423159,5898,9081,3183,8235.669032,478.1837325
Cell 4 2013,7250,3096,166208419.4,4258,8969,4711,7774.737726,526.8210668
Cell 40 NE 2013,7250,3107,166798953.2,-1781,9972,11753,4917.204055,2888.877395
Cell 41 N 2013,7250,3094,166101049.7,-1781,9972,11753,6002.257272,2428.580762
Cell 41 NW 2013,7250,3099,166369474.1,-1781,9972,11753,5569.48435,2707.207192
Cell 42 NW 2013,7250,3096,166208419.4,418,9571,9153,5750.671189,2512.704098
Cell 43 2013,7250,3092,165993679.9,1175,9841,8666,6069.73868,2362.940409
Cell 44 2013,7250,3094,166101049.7,1292,9400,8108,7535.976729,1272.181814
Cell 45 2013,7250,3101,166476843.9,5756,9085,3329,8071.542406,458.2119989
Cell 47 2013,7250,3099,166369474.1,853,9571,8718,6860.955792,2110.39557
Cell 48 2013,7250,3097,166262104.3,1029,9372,8343,6639.368744,2229.902557
Cell 49 2013,7250,3111,167013692.8,1304,9629,8325,6833.484089,1967.254297
Cell 5 2011/12 Summer,7250,3096,166208419.4,-1836,9972,11808,5831.269703,2009.055649
Cell 5 2013,7250,3100,166423159,5788,8863,3075,7946.742258,397.6803924
Cell 50 2013,7250,3103,166584213.7,1375,9692,8317,7156.145988,1711.375457
Cell 51 2013,7250,3093,166047364.8,5712,9085,3373,8187.71969,386.7851873
Cell 52 2013,7250,3101,166476843.9,1375,9483,8108,7174.318607,1834.138827
Cell 53 2013,7250,3096,166208419.4,1375,9524,8149,7263.752584,1739.19738
Cell 54 2013,7250,3103,166584213.7,2289,8980,6691,8028.49146,685.6525503
Cell 55 2013,7250,3099,166369474.1,6255,9005,2750,8136.883511,497.3389183
Cell 56 2013,7250,3097,166262104.3,1430,9542,8112,7161.292541,1229.555017
Cell 57 2013,7250,3105,166691583.4,1681,8980,7299,7200.261836,1268.032428
Cell 58 2013,7250,3100,166423159,1681,8980,7299,8151.524516,701.6192017
Cell 59 2013,7250,3103,166584213.7,1327,9542,8215,7016.295843,1394.424784
Cell 6 2011/12,7250,3100,166423159,1038,9787,8749,6414.079355,2235.796482
Cell 6 2013,7250,3101,166476843.9,5676,8854,3178,8019.882296,367.578821
Cell 6 NE 2011/12,7250,3105,166691583.4,1254,9287,8033,6629.842834,1914.18986
Cell 6 NW 2011/12,7250,3105,166691583.4,614,9513,8899,6002.839936,2505.756998
Cell 6 SW 2011/12,7250,3091,165939995,-92,9804,9896,6173.632805,2536.340126
Cell 60 2013,7250,3101,166476843.9,1894,8780,6886,6904.858433,1060.583401
Cell 61 2013,7250,3106,166745268.3,2412,8849,6437,7556.233419,1020.693783
Cell 7 2013,7250,3092,165993679.9,4961,9168,4207,7941.537516,528.7039869
Cell 9 NW 2013,7250,3100,166423159,-76,9736,9812,4974.303871,2299.921781
Cell 9 SE 2013,7250,3095,166154734.5,-1836,9736,11572,4689.46979,2378.117297
Cell 9 SW 2013,7250,3102,166530528.8,-1836,9736,11572,5104.004836,2304.552859
Cell R1,7250,3107,166798953.2,1200,8485,7285,5762.672675,1881.161207
Cell R10,7250,3094,166101049.7,4258,8969,4711,7774.44958,526.8523457
Cell R100,7250,3101,166476843.9,1375,9692,8317,7155.742986,1711.842979
Cell R101,7250,3102,166530528.8,2396,9692,7296,7989.795938,572.2545366
Cell R104,7250,3095,166154734.5,1301,9468,8167,7056.488207,2019.007963
Cell R105,7250,3095,166154734.5,1375,9524,8149,7263.705331,1739.476339
Cell R106,7250,3104,166637898.6,1375,9692,8317,7396.228093,1478.166974
Cell R107,7250,3103,166584213.7,2289,8980,6691,8028.49146,685.6525503
Cell R11,7250,3100,166423159,5788,8863,3075,7946.742258,397.6803924
Cell R111,7250,3095,166154734.5,1197,9468,8271,6755.413893,2277.20017
Cell R112,7250,3100,166423159,1681,8980,7299,7647.737742,915.7053787
Cell R113,7250,3105,166691583.4,1681,8980,7299,7200.261836,1268.032428
Cell R114,7250,3100,166423159,1681,8980,7299,8151.524516,701.6192017
Cell R117,7250,3104,166637898.6,1327,9542,8215,6386.131765,2054.32704
Cell R118,7250,3097,166262104.3,1430,9542,8112,7162.27123,1228.787238
Cell R119,7250,3098,166315789.2,1681,8980,7299,6966.588767,1302.386399
Cell R120,7250,3113,167121062.6,2412,8874,6462,7450.099582,1158.387565
Cell R121,7250,3097,166262104.3,5236,8874,3638,8154.042299,437.4906449
Cell R123,7250,3095,166154734.5,1327,9542,8215,6802.681745,1677.380724
Cell R124,7250,3101,166476843.9,1894,8780,6886,6953.502419,1052.828007
Cell R125,7250,3093,166047364.8,1894,8780,6886,6836.405108,1131.771002
Cell R126,7250,3102,166530528.8,1894,8828,6934,7327.034172,1200.139897
Cell R15,7250,3094,166101049.7,-1428,9285,10713,5583.679703,2121.024294
Cell R16,7250,3100,166423159,-76,9736,9812,4974.803226,2300.06001
Cell R17,7250,3095,166154734.5,614,9513,8899,6140.827464,2334.001087
Cell R18,7250,3090,165886310.1,-1958,9292,11250,6475.312298,1788.032835
Cell R19,7250,3104,166637898.6,1504,9571,8067,6856.98518,1739.00778
Cell R20,7250,3097,166262104.3,1806,8750,6944,7446.15402,1149.427888
Cell R21,7250,3099,166369474.1,1806,8863,7057,7346.996128,1321.702276
Cell R22,7250,3099,166369474.1,2706,8863,6157,7839.320426,581.8836901
Cell R24,7250,3103,166584213.7,-1836,9736,11572,5470.41476,2217.841246
Cell R25,7250,3101,166476843.9,592,9804,9212,4903.278942,2609.182707
Cell R26,7250,3086,165671570.5,614,9513,8899,5985.110499,2508.043305
Cell R27,7250,3101,166476843.9,1036,9287,8251,6464.240568,2200.694985
Cell R28,7250,3092,165993679.9,1373,9571,8198,6060.690815,2225.184071
Cell R29,7250,3097,166262104.3,1386,9571,8185,6557.198579,1969.162416
Cell R30,7250,3094,166101049.7,2165,8727,6562,7488.853264,1025.664196
Cell R31,7250,3097,166262104.3,2876,8740,5864,7758.340329,611.5668674
Cell R35,7250,3096,166208419.4,-1836,9972,11808,5831.269703,2009.055649
Cell R36,7250,3090,165886310.1,-1836,9050,10886,5377.339806,2329.667419
Cell R37,7250,3103,166584213.7,-92,9787,9879,6090.89204,2492.296188
Cell R38,7250,3089,165832625.2,956,9787,8831,5726.320492,2492.800585
Cell R39,7250,3102,166530528.8,1335,9487,8152,6717.006447,1912.030181
Cell R40,7250,3098,166315789.2,1810,9552,7742,7395.096837,1143.19877
Cell R46,7250,3096,166208419.4,-1005,9882,10887,5222.881783,2686.946778
Cell R47,7250,3092,165993679.9,-1005,9882,10887,4789.688228,2782.861107
Cell R48,7250,3090,165886310.1,-92,9787,9879,5992.969903,2427.079566
Cell R49,7250,3101,166476843.9,791,9418,8627,6139.223476,2264.180391
Cell R5,7250,3102,166530528.8,-1428,8571,9999,5736.415538,1944.797701
Cell R50,7250,3092,165993679.9,1088,9728,8640,4503.242561,2455.684176
Cell R51,7250,3098,166315789.2,1319,9552,8233,6700.642995,1843.799201
Cell R52,7250,3101,166476843.9,2206,8914,6708,7550.639794,877.4016304
Cell R53,7250,3101,166476843.9,2213,8794,6581,7690.262173,683.1169279
Cell R54,7250,3099,166369474.1,5623,8967,3344,8141.637302,455.1696159
Cell R58,7250,3101,166476843.9,-1005,9693,10698,4996.690422,2760.151524
Cell R59,7250,3100,166423159,-908,9693,10601,6208.215484,2255.171033
Cell R6,7250,3099,166369474.1,-1954,9513,11467,6252.17554,2045.115821
Cell R60,7250,3098,166315789.2,457,9823,9366,6471.004519,1967.483646
Cell R61,7250,3109,166906323,705,9950,9245,4701.444194,2586.774512
Cell R62,7250,3098,166315789.2,1104,9552,8448,4911.001937,2577.574479
Cell R63,7250,3099,166369474.1,1104,9552,8448,6378.982898,2110.604648
Cell R64,7250,3095,166154734.5,4051,8980,4929,7913.194507,552.1644533
Cell R65,7250,3103,166584213.7,4051,8980,4929,8111.242991,458.354484
Cell R66,7250,3094,166101049.7,5623,8980,3357,8179.875242,486.9077573
Cell R69,7250,3096,166208419.4,-159,9693,9852,5229.32655,2679.962356
Cell R7,7250,3098,166315789.2,-1958,9292,11250,6526.514203,1825.260342
Cell R70,7250,3090,165886310.1,-1781,9851,11632,5520.972816,2662.457497
Cell R71,7250,3096,166208419.4,-1451,9972,11423,5882.624354,2378.348003
Cell R72,7250,3097,166262104.3,418,9959,9541,5561.464966,2501.584249
Cell R73,7250,3097,166262104.3,418,9950,9532,4730.735551,2706.15082
Cell R74,7250,3102,166530528.8,540,9400,8860,6363.632818,2360.051126
Cell R75,7250,3104,166637898.6,4051,8901,4850,7937.693621,502.8840853
Cell R76,7250,3097,166262104.3,6445,8980,2535,8232.174362,386.5349659
Cell R77,7250,3099,166369474.1,6445,9036,2591,8259.68635,384.9817114
Cell R8,7250,3094,166101049.7,-1958,9292,11250,7153.801228,1326.706806
Cell R80,7250,3107,166798953.2,-1781,9972,11753,4914.949469,2889.538019
Cell R81,7250,3100,166423159,-1781,9972,11753,6053.140323,2463.100775
Cell R82,7250,3096,166208419.4,418,9571,9153,5750.220607,2512.395636
Cell R83,7250,3097,166262104.3,418,9571,9153,6178.424604,2499.10598
Cell R84,7250,3102,166530528.8,540,9841,9301,5576.73372,2497.24882
Cell R85,7250,3092,165993679.9,1175,9841,8666,6069.73868,2362.940409
Cell R86,7250,3102,166530528.8,1499,9629,8130,7718.903611,988.3197501
Cell R87,7250,3102,166530528.8,5756,9085,3329,8071.565442,458.1399314
Cell R9,7250,3105,166691583.4,-1958,9270,11228,7325.952013,1256.672704
Cell R90,7250,3102,166530528.8,853,9571,8718,6862.528369,2109.980527
Cell R91,7250,3098,166315789.2,1029,9372,8343,6640.172692,2229.395928
Cell R92,7250,3100,166423159,1175,9904,8729,5392.025484,2527.075877
Cell R93,7250,3110,166960007.9,1304,9629,8325,6833.056592,1967.426065
Cell R97,7250,3097,166262104.3,1320,9152,7832,7159.149177,1856.089815
Cell R98,7250,3095,166154734.5,1382,9483,8101,7024.176414,2060.019441
Cell R99,7250,3102,166530528.8,1375,9483,8108,7174.789491,1834.030628
Cell S102,7250,3102,166530528.8,5712,9085,3373,8200.993875,411.5725159
Cell S108,7250,3098,166315789.2,6255,9005,2750,8136.84377,497.4142598
Cell S13,7250,3098,166315789.2,5654,8989,3335,8001.135894,412.8873742
Cell S14,7250,3092,165993679.9,4961,9168,4207,7941.537516,528.7039869
Cell S2,7250,3100,166423159,5676,8854,3178,8019.941613,367.6232637
Cell S23,7250,3096,166208419.4,4961,8877,3916,7960.700904,467.6965695
Cell S32,7250,3098,166315789.2,4978,8920,3942,7979.149128,491.459626
Cell S33,7250,3097,166262104.3,5061,8963,3902,8028.852438,391.6255244
Cell S34,7250,3105,166691583.4,5858,8977,3119,7961.885024,426.2849447
Cell S41,7250,3099,166369474.1,4158,8727,4569,7788.529203,555.7200011
Cell S42,7250,3109,166906323,5845,8920,3075,8193.954969,422.0530355
Cell S44,7250,3100,166423159,5706,9061,3355,7986.210323,486.0199939
Cell S56,7250,3100,166423159,5505,8977,3472,7671.972903,520.8811981
Cell S67,7250,3094,166101049.7,5623,8938,3315,7991.578539,521.3604476
Cell S78,7250,3102,166530528.8,5898,9081,3183,8235.432946,478.1436115
Cell S88,7250,3095,166154734.5,5600,9081,3481,8239.511793,454.9932945
Cell S94,7250,3096,166208419.4,5811,9085,3274,8214.035853,392.7736982
Cell S95,7250,3093,166047364.8,5712,9085,3373,8187.71969,386.7851873
W287,7250,3095,166154734.5,894,9507,8613,4198.312763,2039.101814
W295,7250,3100,166423159,1633,9145,7512,6832.558387,1713.26818
W338,7250,3105,166691583.4,697,9484,8787,3692.615459,2374.236536
W342,7250,3105,166691583.4,976,8946,7970,5344.326892,2386.820768
W345,7250,3089,165832625.2,1609,8580,6971,7412.365167,874.785321
W387,7250,3098,166315789.2,1012,9470,8458,4860.456423,2308.810585
W393,7250,3099,166369474.1,866,8860,7994,5558.753469,2450.82382
W440,7250,3093,166047364.8,1073,9239,8166,5237.800841,2202.543902
W441,7250,3091,165939995,1130,9239,8109,6532.57263,1566.986654
W445,7250,3105,166691583.4,2651,8548,5897,6804.559098,1015.929135
W500,7250,3095,166154734.5,1196,8598,7402,6299.277544,1727.083701
1,7500,3315,177965410.4,-1954,9513,11467,6205.423228,2058.254747
2,7500,3317,178072780.1,-1958,9292,11250,6343.830268,1916.677019
3,7500,3317,178072780.1,1623,9498,7875,7157.894181,1512.513478
4,7500,3312,177804355.7,1806,8678,6872,7440.486715,1144.089385
5,7500,3312,177804355.7,-1836,9972,11808,5777.494263,2047.688349
6,7500,3318,178126465,1036,9787,8751,6365.886076,2250.754429
7,7500,3317,178072780.1,1373,9571,8198,6273.038891,2150.592301
8,7500,3318,178126465,1806,8692,6886,7194.446052,1326.583158
9,7500,3315,177965410.4,4978,8920,3942,7967.27089,494.5759622
10,7500,3317,178072780.1,-1005,9882,10887,5130.303588,2656.090747
11,7500,3307,177535931.2,-92,9787,9879,6038.138192,2429.144597
12,7500,3304,177374876.6,812,9728,8916,4484.276634,2470.647921
13,7500,3316,178019095.2,1319,9552,8233,6649.556393,1895.083078
14,7500,3319,178180149.9,5717,8967,3250,8126.621874,428.3249008
16,7500,3309,177643301,-159,9693,9852,5163.240556,2661.359998
17,7500,3317,178072780.1,457,9823,9366,6435.829062,1995.288681
18,7500,3320,178233834.8,705,9950,9245,4796.228614,2542.155006
19,7500,3318,178126465,1104,9552,8448,4983.116938,2573.305595
20,7500,3312,177804355.7,4051,9400,5349,7932.24849,507.3778316
21,7500,3323,178394889.5,6445,9036,2591,8260.750226,384.2812304
22,7500,3317,178072780.1,-1781,9972,11753,4795.316853,2932.595026
23,7500,3314,177911725.5,418,9959,9541,5812.226916,2479.876639
24,7500,3316,178019095.2,1029,9372,8343,6608.395356,2229.078211
25,7500,3319,178180149.9,1304,9904,8600,6829.245255,1982.562778
26,7500,3322,178341204.6,5543,9085,3542,8068.943107,470.613931
27,7500,3317,178072780.1,1382,9690,8308,6956.288514,2110.244875
28,7500,3319,178180149.9,1375,9692,8317,7248.781259,1765.877012
29,7500,3318,178126465,1375,9692,8317,7149.152803,1719.945616
31,7500,3322,178341204.6,1254,9468,8214,7241.643287,1735.661198
32,7500,3319,178180149.9,1681,8980,7299,7221.676409,1251.098754
33,7500,3318,178126465,1430,9542,8112,7100.515672,1354.408339
34,7500,3322,178341204.6,1894,8780,6886,6898.081878,1063.016604
10A,7500,3311,177750670.8,-1005,9882,10887,4802.398369,2786.173759
10NE,7500,3312,177804355.7,-1005,9882,10887,4990.330918,2633.654774
10NW,7500,3316,178019095.2,-1836,9736,11572,5381.966828,2332.987845
10SW,7500,3301,177213821.9,-1005,9882,10887,5332.736746,2671.669635
11NE,7500,3317,178072780.1,-92,9804,9896,6054.939705,2503.774845
11NW,7500,3319,178180149.9,-92,9787,9879,5886.952998,2484.701698
11SE,7500,3321,178287519.7,278,9787,9509,6175.040952,2264.504574
17NW,7500,3319,178180149.9,-908,9693,10601,6163.407954,2287.462289
17SE,7500,3316,178019095.2,-1781,9972,11753,5891.872738,2399.463633
17SW,7500,3307,177535931.2,-1781,9972,11753,5525.506501,2670.716966
22S,7500,3319,178180149.9,-1781,9972,11753,4663.733353,2930.41615
23S,7500,3304,177374876.6,1111,9571,8460,4677.387107,2316.876416
24S,7500,3320,178233834.8,853,9571,8718,6603.260843,2231.543278
27A,7500,3314,177911725.5,1120,9427,8307,7023.758902,1969.338523
2A,7500,3318,178126465,-1958,9292,11250,6538.973177,1771.972415
5NE,7500,3316,178019095.2,-1836,9736,11572,4724.063329,2366.864173
5NW,7500,3316,178019095.2,-1836,9736,11572,5093.543124,2305.577236
5SE,7500,3310,177696985.9,592,9804,9212,5018.222659,2621.935124
6NE,7500,3317,178072780.1,1254,9287,8033,6555.672897,1964.90929
6NW,7500,3316,178019095.2,614,9513,8899,6004.207479,2491.132565
6SW,7500,3319,178180149.9,-92,9804,9896,6094.365472,2575.729477
Cell 1 2011/12,7500,3315,177965410.4,-1954,9513,11467,6205.423228,2058.254747
Cell 1 SW 2013,7500,3313,177858040.6,-1428,9285,10713,5615.801992,2122.678892
Cell 10 2011/12,7500,3317,178072780.1,-1005,9882,10887,5130.303588,2656.090747
Cell 10 NE 2011/12,7500,3312,177804355.7,-1005,9882,10887,4990.330918,2633.654774
Cell 10 NW 2011/12,7500,3316,178019095.2,-1836,9736,11572,5381.966828,2332.987845
Cell 10 SE 2013,7500,3316,178019095.2,614,9513,8899,6004.207479,2491.132565
Cell 10 SW 2011/12,7500,3301,177213821.9,-1005,9882,10887,5332.736746,2671.669635
Cell 10-A 2011/12,7500,3311,177750670.8,-1005,9882,10887,4802.398369,2786.173759
Cell 11 NE 2011/12,7500,3317,178072780.1,-92,9804,9896,6054.939705,2503.774845
Cell 11 NW 2013,7500,3315,177965410.4,-1958,9292,11250,6484.600905,1811.797699
Cell 11 SW 2013,7500,3313,177858040.6,1036,9287,8251,6514.097797,2113.518026
Cell 12 2013,7500,3319,178180149.9,1373,9571,8198,6271.998795,2150.552213
Cell 13 2013,7500,3311,177750670.8,1806,8520,6714,7185.192087,1328.400621
Cell 14 2013,7500,3319,178180149.9,2679,8863,6184,7817.44411,659.223476
Cell 15 2013,7500,3318,178126465,4961,8920,3959,7995.32821,452.6983554
Cell 15-A 2013,7500,3316,178019095.2,5061,8963,3902,8026.111882,395.7154777
Cell 16 2013,7500,3322,178341204.6,5858,8963,3105,8001.369657,407.3526571
Cell 17 NW 2011/12,7500,3319,178180149.9,-908,9693,10601,6163.407954,2287.462289
Cell 17 NW 2013,7500,3317,178072780.1,-1836,9736,11572,5441.54085,2225.115784
Cell 17 SE 2013,7500,3316,178019095.2,-1836,9736,11572,5381.966828,2332.987845
Cell 17 SW 2013,7500,3311,177750670.8,-1836,9972,11808,5774.024464,2047.791095
Cell 18 2011/12,7500,3320,178233834.8,705,9950,9245,4796.228614,2542.155006
Cell 18 NE 2013,7500,3319,178180149.9,-92,9804,9896,6224.840615,2505.341688
Cell 18 NW 2013,7500,3319,178180149.9,592,9804,9212,5001.492016,2608.140351
Cell 18 SE 2013,7500,3317,178072780.1,-92,9804,9896,6054.939705,2503.774845
Cell 18 SSE 2013,7500,3314,177911725.5,-92,9787,9879,5936.640917,2469.849195
Cell 19 NW 2013,7500,3316,178019095.2,1036,9287,8251,6425.637515,2203.113719
Cell 2 2011/12,7500,3317,178072780.1,-1958,9292,11250,6343.830268,1916.677019
Cell 2 NE 2013,7500,3320,178233834.8,-1958,9292,11250,6620.818072,1768.56197
Cell 2 SW 2013,7500,3316,178019095.2,-1954,9513,11467,6206.022316,2057.970914
Cell 20 2013,7500,3317,178072780.1,1373,9571,8198,6499.662948,2014.798306
Cell 21 2013,7500,3314,177911725.5,1810,9552,7742,7362.840676,1187.78474
Cell 22 2013,7500,3320,178233834.8,4978,8920,3942,7984.39247,504.2059072
Cell 23 2013,7500,3318,178126465,5845,8920,3075,8187.8044,418.3161177
Cell 24 2013,7500,3321,178287519.7,5858,8977,3119,7966.827462,429.0911181
Cell 25 NE 2013,7500,3317,178072780.1,-1005,9882,10887,5130.303588,2656.090747
Cell 25 SE 2013,7500,3301,177213821.9,-1005,9882,10887,5332.736746,2671.669635
Cell 26 NE 2013,7500,3306,177482246.3,-92,9787,9879,6037.499395,2429.234216
Cell 26 NNW 2013,7500,3311,177750670.8,-1005,9882,10887,4991.008155,2633.764093
Cell 26 NW 2013,7500,3312,177804355.7,-1005,9882,10887,4803.335145,2786.274565
Cell 27 NW 2013,7500,3320,178233834.8,278,9787,9509,6174.424398,2264.566868
Cell 28 2013,7500,3304,177374876.6,812,9728,8916,4484.276634,2470.647921
Cell 29 2013,7500,3316,178019095.2,1319,9552,8233,6648.842883,1896.049525
Cell 3 NE 2013,7500,3316,178019095.2,-1958,9292,11250,7185.408323,1331.395255
Cell 3 NW 2013,7500,3315,177965410.4,-1958,9292,11250,6518.854902,1823.640841
Cell 30 2013,7500,3322,178341204.6,4051,8980,4929,8098.450933,475.1020038
Cell 31 2013,7500,3313,177858040.6,5623,8967,3344,8146.222457,456.8474701
Cell 32 2013,7500,3323,178394889.5,5623,9032,3409,7997.244358,520.187003
Cell 33 NE 2013,7500,3319,178180149.9,-908,9693,10601,6163.407954,2287.462289
Cell 33 SE 2013,7500,3305,177428561.5,-1781,9972,11753,5521.780333,2671.409655
Cell 33 SW 2013,7500,3313,177858040.6,-159,9693,9852,5219.177181,2662.227948
Cell 34 N 2013,7500,3313,177858040.6,457,9823,9366,6256.800785,2145.723098
Cell 34 NW 2013,7500,3318,178126465,457,9823,9366,6435.558469,1995.048852
Cell 34 SE 2013,7500,3315,177965410.4,-1781,9972,11753,5892.217195,2398.495903
Cell 35 2013,7500,3314,177911725.5,705,9950,9245,4721.353651,2590.215235
Cell 37 2013,7500,3321,178287519.7,4051,9400,5349,7933.968985,507.5698423
Cell 38 2013,7500,3314,177911725.5,6445,9036,2591,8262.328908,385.2316523
Cell 39 2013,7500,3316,178019095.2,5898,9081,3183,8224.139023,481.8491407
Cell 4 2013,7500,3318,178126465,2903,9270,6367,7749.543701,599.2248713
Cell 40 NE 2013,7500,3315,177965410.4,-1781,9972,11753,4909.94359,2884.827076
Cell 41 N 2013,7500,3310,177696985.9,-1781,9972,11753,5992.586405,2429.519398
Cell 41 NW 2013,7500,3315,177965410.4,-1781,9972,11753,5541.301056,2729.61077
Cell 42 NW 2013,7500,3312,177804355.7,418,9677,9259,5817.193237,2485.201927
Cell 43 2013,7500,3303,177321191.7,1175,9841,8666,6047.257039,2381.1823
Cell 44 2013,7500,3314,177911725.5,1292,9400,8108,7464.477067,1386.164379
Cell 45 2013,7500,3322,178341204.6,5543,9085,3542,8069.756773,470.5173781
Cell 47 2013,7500,3314,177911725.5,853,9571,8718,6881.789982,2101.96713
Cell 48 2013,7500,3319,178180149.9,853,9571,8718,6602.49533,2231.922771
Cell 49 2013,7500,3319,178180149.9,1304,9904,8600,6829.245255,1982.562778
Cell 5 2011/12 Summer,7500,3313,177858040.6,-1836,9972,11808,5772.105343,2048.730069
Cell 5 2013,7500,3319,178180149.9,5788,8863,3075,7943.047002,394.813605
Cell 50 2013,7500,3318,178126465,1375,9692,8317,7149.152803,1719.945616
Cell 51 2013,7500,3308,177589616.1,5712,9085,3373,8185.4211,392.2277198
Cell 52 2013,7500,3313,177858040.6,1375,9483,8108,7134.520676,1869.26066
Cell 53 2013,7500,3319,178180149.9,1375,9692,8317,7248.781259,1765.877012
Cell 54 2013,7500,3321,178287519.7,2289,8980,6691,8019.296597,700.8263228
Cell 55 2013,7500,3319,178180149.9,5712,9005,3293,8126.487496,504.4753581
Cell 56 2013,7500,3314,177911725.5,1430,9542,8112,7097.375377,1357.996231
Cell 57 2013,7500,3321,178287519.7,1681,8980,7299,7220.097561,1251.034341
Cell 58 2013,7500,3320,178233834.8,1681,8980,7299,8095.893675,852.6821618
Cell 59 2013,7500,3324,178448574.4,1327,9542,8215,6976.092058,1459.197897
Cell 6 2011/12,7500,3318,178126465,1036,9787,8751,6365.886076,2250.754429
Cell 6 2013,7500,3321,178287519.7,5676,8868,3192,8022.283047,369.3515522
Cell 6 NE 2011/12,7500,3317,178072780.1,1254,9287,8033,6555.672897,1964.90929
Cell 6 NW 2011/12,7500,3316,178019095.2,614,9513,8899,6004.207479,2491.132565
Cell 6 SW 2011/12,7500,3319,178180149.9,-92,9804,9896,6094.365472,2575.729477
Cell 60 2013,7500,3317,178072780.1,1894,8780,6886,6907.621043,1057.831111
Cell 61 2013,7500,3324,178448574.4,1912,8849,6937,7536.997894,1061.081754
Cell 7 2013,7500,3306,177482246.3,4961,9168,4207,7941.50242,533.9645572
Cell 9 NW 2013,7500,3321,178287519.7,-76,9736,9812,5021.127672,2300.073713
Cell 9 SE 2013,7500,3317,178072780.1,-1836,9736,11572,4724.766054,2366.853319
Cell 9 SW 2013,7500,3317,178072780.1,-1836,9736,11572,5092.889659,2305.744632
Cell R1,7500,3313,177858040.6,1080,8693,7613,5746.430727,1881.242535
Cell R10,7500,3318,178126465,2903,9270,6367,7749.866787,599.7553422
Cell R100,7500,3317,178072780.1,1375,9692,8317,7148.885137,1720.135761
Cell R101,7500,3320,178233834.8,2396,9692,7296,7974.841566,618.4837295
Cell R104,7500,3321,178287519.7,1301,9468,8167,7073.13249,2008.864882
Cell R105,7500,3319,178180149.9,1375,9692,8317,7248.781259,1765.877012
Cell R106,7500,3324,178448574.4,1375,9692,8317,7414.508424,1444.746398
Cell R107,7500,3321,178287519.7,2289,8980,6691,8019.296597,700.8263228
Cell R11,7500,3320,178233834.8,5788,8863,3075,7943.062048,394.7550923
Cell R111,7500,3322,178341204.6,1197,9468,8271,6759.172787,2257.394115
Cell R112,7500,3318,178126465,1681,8980,7299,7615.081977,948.303191
Cell R113,7500,3320,178233834.8,1681,8980,7299,7219.800904,1251.105938
Cell R114,7500,3320,178233834.8,1681,8980,7299,8096.033133,852.6982775
Cell R117,7500,3321,178287519.7,1254,9542,8288,6373.818729,2071.853315
Cell R118,7500,3313,177858040.6,1430,9542,8112,7095.622397,1360.607752
Cell R119,7500,3322,178341204.6,1681,8980,7299,7001.395244,1280.965086
Cell R120,7500,3315,177965410.4,2175,8874,6699,7435.032278,1183.495986
Cell R121,7500,3320,178233834.8,5236,8874,3638,8151.674096,451.1948759
Cell R123,7500,3318,178126465,1327,9542,8215,6775.516576,1688.303312
Cell R124,7500,3319,178180149.9,1894,8780,6886,6952.374812,1048.616194
Cell R125,7500,3313,177858040.6,1894,8780,6886,6836.104739,1123.413828
Cell R126,7500,3319,178180149.9,1894,8834,6940,7308.124134,1225.86362
Cell R15,7500,3312,177804355.7,-1428,9285,10713,5615.536232,2122.944211
Cell R16,7500,3315,177965410.3,-76,9736,9812,5016.523982,2301.009701
Cell R17,7500,3315,177965410.4,614,9513,8899,6112.415988,2338.25236
Cell R18,7500,3300,177160137,-1958,9292,11250,6487.591818,1809.966946
Cell R19,7500,3321,178287519.7,1504,9571,8067,6829.678109,1743.416737
Cell R20,7500,3317,178072780.1,1806,8750,6944,7451.921616,1144.069429
Cell R21,7500,3317,178072780.1,1806,8863,7057,7348.206512,1317.496689
Cell R22,7500,3319,178180149.9,2679,8863,6184,7817.44411,659.223476
Cell R24,7500,3317,178072780.1,-1836,9736,11572,5441.54085,2225.115784
Cell R25,7500,3318,178126465,592,9804,9212,5000.933996,2608.335246
Cell R26,7500,3321,178287519.7,614,9513,8899,5993.660042,2488.916274
Cell R27,7500,3314,177911725.5,1036,9287,8251,6425.558238,2203.774782
Cell R28,7500,3318,178126465,1373,9571,8198,6016.628089,2233.7973
Cell R29,7500,3317,178072780.1,1373,9571,8198,6499.662948,2014.798306
Cell R30,7500,3319,178180149.9,2161,8727,6566,7486.108768,1044.762179
Cell R31,7500,3315,177965410.4,2677,8740,6063,7745.117647,655.3993102
Cell R35,7500,3312,177804355.7,-1836,9972,11808,5773.270531,2047.941466
Cell R36,7500,3316,178019095.2,-1836,9736,11572,5381.966828,2332.987845
Cell R37,7500,3317,178072780.1,-92,9804,9896,6054.939705,2503.774845
Cell R38,7500,3304,177374876.6,956,9787,8831,5718.130145,2491.280033
Cell R39,7500,3317,178072780.1,1335,9548,8213,6668.593006,1949.333483
Cell R40,7500,3313,177858040.6,1810,9552,7742,7362.573498,1187.864416
Cell R46,7500,3309,177643301,-1005,9882,10887,5249.121789,2691.70127
Cell R47,7500,3311,177750670.8,-1005,9882,10887,4800.260646,2786.434101
Cell R48,7500,3304,177374876.6,-92,9787,9879,6036.551453,2429.76685
Cell R49,7500,3321,178287519.7,278,9787,9509,6174.504065,2264.230549
Cell R5,7500,3315,177965410.3,-1428,9210,10638,5746.865762,1945.582572
Cell R50,7500,3302,177267506.8,812,9728,8916,4486.281042,2470.046995
Cell R51,7500,3317,178072780.1,1319,9552,8233,6663.500754,1884.747734
Cell R52,7500,3316,178019095.2,2206,8914,6708,7557.262364,863.6044719
Cell R53,7500,3319,178180149.9,2213,8794,6581,7689.926484,691.7599146
Cell R54,7500,3314,177911725.5,5623,8967,3344,8146.084188,456.7604841
Cell R58,7500,3317,178072780.1,-1005,9693,10698,5037.094362,2753.512547
Cell R59,7500,3319,178180149.9,-908,9693,10601,6163.407954,2287.462289
Cell R6,7500,3316,178019095.2,-1954,9513,11467,6206.022316,2057.970914
Cell R60,7500,3317,178072780.1,457,9823,9366,6434.849563,1994.931681
Cell R61,7500,3316,178019095.2,705,9950,9245,4722.736128,2590.129253
Cell R62,7500,3317,178072780.1,1104,9552,8448,4955.36328,2578.947091
Cell R63,7500,3317,178072780.1,1104,9552,8448,6344.406994,2132.914596
Cell R64,7500,3318,178126465,4051,8980,4929,7919.774563,553.8801842
Cell R65,7500,3322,178341204.6,4051,8980,4929,8098.450933,475.1020038
Cell R66,7500,3311,177750670.8,5623,8980,3357,8165.633041,486.52965
Cell R69,7500,3313,177858040.6,-159,9693,9852,5219.177181,2662.227948
Cell R7,7500,3314,177911725.5,-1958,9292,11250,6518.423355,1823.746714
Cell R70,7500,3305,177428561.5,-1781,9972,11753,5521.780333,2671.409655
Cell R71,7500,3314,177911725.5,-1781,9972,11753,5891.027158,2397.879028
Cell R72,7500,3318,178126465,418,9959,9541,5548.65431,2523.340279
Cell R73,7500,3315,177965410.4,418,9950,9532,4715.912821,2689.607238
Cell R74,7500,3318,178126465,540,9400,8860,6336.297167,2378.532027
Cell R75,7500,3321,178287519.7,4051,9400,5349,7934.058416,507.5810281
Cell R76,7500,3310,177696985.9,6445,8980,2535,8226.100302,384.1338461
Cell R77,7500,3315,177965410.4,6445,9036,2591,8262.369834,385.1807492
Cell R8,7500,3313,177858040.6,-1958,9292,11250,7134.427407,1346.577815
Cell R80,7500,3315,177965410.4,-1781,9972,11753,4908.201508,2885.051451
Cell R81,7500,3319,178180149.9,-1781,9972,11753,5982.629406,2500.173666
Cell R82,7500,3313,177858040.6,418,9677,9259,5817.43767,2484.866648
Cell R83,7500,3313,177858040.6,418,9571,9153,6221.897374,2484.546695
Cell R84,7500,3318,178126465,540,9841,9301,5607.076854,2512.864615
Cell R85,7500,3305,177428561.5,1175,9841,8666,6046.606354,2381.263989
Cell R86,7500,3318,178126465,1499,9629,8130,7706.555756,1031.90861
Cell R87,7500,3322,178341204.6,5543,9085,3542,8069.756773,470.5173781
Cell R9,7500,3318,178126465,-1958,9270,11228,7299.170283,1281.451602
Cell R90,7500,3314,177911725.5,853,9571,8718,6881.789982,2101.96713
Cell R91,7500,3318,178126465,853,9571,8718,6603.632007,2231.298353
Cell R92,7500,3314,177911725.5,1175,9904,8729,5467.159324,2518.093982
Cell R93,7500,3318,178126465,1304,9904,8600,6829.013864,1982.816703
Cell R97,7500,3313,177858040.6,1125,9152,8027,7165.14428,1861.177084
Cell R98,7500,3317,178072780.1,1382,9690,8308,6956.288514,2110.244875
Cell R99,7500,3313,177858040.6,1375,9483,8108,7134.520676,1869.26066
Cell S102,7500,3316,178019095.2,5712,9085,3373,8202.449638,407.1814045
Cell S108,7500,3319,178180149.9,5712,9005,3293,8126.487496,504.4753581
Cell S13,7500,3320,178233834.8,5654,9168,3514,8007.216265,413.5968844
Cell S14,7500,3306,177482246.3,4961,9168,4207,7941.50242,533.9645572
Cell S2,7500,3322,178341204.6,5676,8868,3192,8022.346478,369.3140469
Cell S23,7500,3315,177965410.4,4961,8877,3916,7959.699548,464.4427858
Cell S32,7500,3315,177965410.4,4978,8920,3942,7981.846757,487.926475
Cell S33,7500,3315,177965410.4,5061,8963,3902,8026.039819,395.7534032
Cell S34,7500,3320,178233834.8,5858,8977,3119,7966.836446,429.1554231
Cell S41,7500,3316,178019095.2,4158,8860,4702,7786.235826,560.6360401
Cell S42,7500,3318,178126465,5845,8920,3075,8187.875226,418.3194464
Cell S44,7500,3316,178019095.2,5645,9061,3416,7975.635706,498.9394029
Cell S56,7500,3316,178019095.2,5505,9061,3556,7676.138721,524.0377874
Cell S67,7500,3323,178394889.5,5623,9032,3409,7997.244358,520.187003
Cell S78,7500,3317,178072780.1,5898,9081,3183,8223.9388,481.9144462
Cell S88,7500,3320,178233834.8,5600,9081,3481,8237.325602,459.4452925
Cell S94,7500,3319,178180149.9,5543,9085,3542,8203.037361,405.4129321
Cell S95,7500,3307,177535931.2,5712,9085,3373,8185.292108,392.2168561
W287,7500,3310,177696985.9,894,9507,8613,4252.611178,2065.997583
W295,7500,3317,178072780.1,1633,9145,7512,6829.080796,1721.501867
W338,7500,3314,177911725.5,697,9484,8787,3663.733555,2354.00732
W342,7500,3316,178019095.2,976,8946,7970,5377.008745,2367.457007
W345,7500,3314,177911725.5,1609,8580,6971,7383.820157,935.9317305
W387,7500,3316,178019095.2,632,9470,8838,4815.183957,2308.046923
W393,7500,3314,177911725.5,728,8860,8132,5477.281835,2493.791988
W440,7500,3307,177535931.2,1073,9239,8166,5269.647415,2200.023688
W441,7500,3314,177911725.5,1101,9239,8138,6461.145444,1636.173272
W445,7500,3315,177965410.3,2651,8548,5897,6805.291101,1016.075105
W500,7500,3316,178019095.2,1196,8598,7402,6315.313631,1707.926437
1,7750,3540,190044510.6,-1954,9513,11467,6169.164407,2071.674434
2,7750,3541,190098195.5,-1958,9292,11250,6355.679187,1939.127688
3,7750,3539,189990825.7,1025,9498,8473,7138.587454,1522.127967
4,7750,3538,189937140.8,1806,8678,6872,7449.405314,1138.553481
5,7750,3538,189937140.8,-1836,9972,11808,5715.027699,2085.625014
6,7750,3541,190098195.5,1036,9787,8751,6322.157583,2260.106719
7,7750,3543,190205565.3,1373,9571,8198,6242.519616,2154.281283
8,7750,3539,189990825.7,1806,8692,6886,7218.606103,1300.577263
9,7750,3541,190098195.5,4978,8920,3942,7968.221971,489.4334418
10,7750,3541,190098195.5,-1005,9882,10887,5112.568483,2673.052621
11,7750,3538,189937140.8,-92,9787,9879,6077.464387,2427.368604
12,7750,3549,190527674.6,705,9836,9131,4481.941674,2483.496585
13,7750,3539,189990825.7,1319,9552,8233,6613.079118,1926.596486
14,7750,3538,189937140.8,5717,8967,3250,8126.307518,434.3092439
16,7750,3539,189990825.7,-159,9741,9900,5160.067533,2646.594762
17,7750,3537,189883455.9,457,9823,9366,6410.18773,2019.428042
18,7750,3542,190151880.4,705,9950,9245,4805.948052,2538.209341
19,7750,3539,189990825.7,1104,9552,8448,5020.235942,2573.391289
20,7750,3543,190205565.3,4051,9400,5349,7933.65961,509.0671366
21,7750,3545,190312935,6445,9036,2591,8261.898731,386.5836707
22,7750,3542,190151880.4,-1781,9972,11753,4799.667984,2921.703108
23,7750,3545,190312935,418,9959,9541,5886.83244,2455.461995
24,7750,3541,190098195.5,853,9841,8988,6565.468512,2244.634263
25,7750,3549,190527674.6,1304,9904,8600,6835.688645,1981.356118
26,7750,3545,190312935,5543,9085,3542,8067.963047,476.2571635
27,7750,3542,190151880.4,1336,9757,8421,6887.800113,2154.149763
28,7750,3541,190098195.5,1375,9692,8317,7227.222254,1799.266366
29,7750,3540,190044510.6,1375,9692,8317,7150.266102,1726.277639
31,7750,3543,190205565.3,1254,9468,8214,7215.297206,1747.703282
32,7750,3544,190259250.2,1681,8980,7299,7231.373871,1237.963694
33,7750,3542,190151880.4,1430,9542,8112,7039.812535,1460.901655
34,7750,3545,190312935,1894,8780,6886,6905.490268,1059.116643
10A,7750,3539,189990825.7,-1005,9882,10887,4816.967505,2786.182964
10NE,7750,3539,189990825.7,-1005,9882,10887,4987.181407,2643.018464
10NW,7750,3535,189776086.1,-1836,9736,11572,5396.850071,2330.546175
10SW,7750,3539,189990825.7,-1005,9882,10887,5288.33145,2679.768024
11NE,7750,3547,190420304.8,-92,9804,9896,6028.550042,2501.094552
11NW,7750,3537,189883455.9,-92,9804,9896,5935.358213,2480.311725
11SE,7750,3544,190259250.2,270,9787,9517,6203.045711,2263.189305
17NW,7750,3540,190044510.6,-908,9693,10601,6111.315537,2322.428472
17SE,7750,3540,190044510.6,-1781,9972,11753,5920.04435,2407.230438
17SW,7750,3539,189990825.7,-1781,9972,11753,5514.684374,2680.551716
22S,7750,3535,189776086.1,-1781,9972,11753,4680.700424,2918.855004
23S,7750,3548,190473989.7,1111,9571,8460,4754.659245,2337.823112
24S,7750,3537,189883455.9,853,9841,8988,6562.952785,2243.599677
27A,7750,3541,190098195.5,1120,9427,8307,7028.363174,1972.241587
2A,7750,3537,189883455.9,-1958,9292,11250,6561.780888,1774.887185
5NE,7750,3539,189990825.7,-1836,9736,11572,4742.367618,2367.288635
5NW,7750,3541,190098195.5,-1836,9736,11572,5081.438577,2308.703118
5SE,7750,3538,189937140.8,463,9804,9341,5107.345676,2615.491113
6NE,7750,3546,190366619.9,1254,9292,8038,6465.839538,2010.065616
6NW,7750,3544,190259250.2,614,9804,9190,6009.419018,2471.221148
6SW,7750,3536,189829771,-92,9804,9896,6027.04836,2606.548503
Cell 1 2011/12,7750,3540,190044510.6,-1954,9513,11467,6169.164407,2071.674434
Cell 1 SW 2013,7750,3535,189776086.1,-1428,9285,10713,5631.648656,2126.769391
Cell 10 2011/12,7750,3541,190098195.5,-1005,9882,10887,5112.568483,2673.052621
Cell 10 NE 2011/12,7750,3539,189990825.7,-1005,9882,10887,4987.181407,2643.018464
Cell 10 NW 2011/12,7750,3535,189776086.1,-1836,9736,11572,5396.850071,2330.546175
Cell 10 SE 2013,7750,3544,190259250.2,614,9804,9190,6009.419018,2471.221148
Cell 10 SW 2011/12,7750,3539,189990825.7,-1005,9882,10887,5288.33145,2679.768024
Cell 10-A 2011/12,7750,3539,189990825.7,-1005,9882,10887,4816.967505,2786.182964
Cell 11 NE 2011/12,7750,3547,190420304.8,-92,9804,9896,6028.550042,2501.094552
Cell 11 NW 2013,7750,3536,189829771,-1958,9292,11250,6485.569853,1839.428011
Cell 11 SW 2013,7750,3539,189990825.7,1036,9287,8251,6453.715456,2132.267969
Cell 12 2013,7750,3545,190312935,1373,9571,8198,6242.396897,2154.318972
Cell 13 2013,7750,3541,190098195.5,1806,8692,6886,7206.162948,1300.012324
Cell 14 2013,7750,3542,190151880.4,2161,8863,6702,7798.546302,732.6879063
Cell 15 2013,7750,3543,190205565.3,4961,8933,3972,8006.96359,451.1373279
Cell 15-A 2013,7750,3543,190205565.3,5061,8963,3902,8028.37313,399.6775333
Cell 16 2013,7750,3544,190259250.2,5858,8963,3105,8002.131208,408.8403699
Cell 17 NW 2011/12,7750,3540,190044510.6,-908,9693,10601,6111.315537,2322.428472
Cell 17 NW 2013,7750,3545,190312935,-1836,9972,11808,5418.104937,2234.38949
Cell 17 SE 2013,7750,3534,189722401.3,-1836,9736,11572,5396.357668,2330.692019
Cell 17 SW 2013,7750,3536,189829771,-1836,9972,11808,5716.637161,2085.251232
Cell 18 2011/12,7750,3542,190151880.4,705,9950,9245,4805.948052,2538.209341
Cell 18 NE 2013,7750,3537,189883455.9,-92,9804,9896,6141.118745,2546.902124
Cell 18 NW 2013,7750,3543,190205565.3,592,9804,9212,5082.003669,2602.832129
Cell 18 SE 2013,7750,3547,190420304.8,-92,9804,9896,6028.550042,2501.094552
Cell 18 SSE 2013,7750,3542,190151880.4,-92,9787,9879,5992.127612,2467.987808
Cell 19 NW 2013,7750,3541,190098195.5,1036,9287,8251,6396.846089,2207.185524
Cell 2 2011/12,7750,3541,190098195.5,-1958,9292,11250,6355.679187,1939.127688
Cell 2 NE 2013,7750,3535,189776086.1,-1958,9292,11250,6618.7471,1764.969674
Cell 2 SW 2013,7750,3540,190044510.6,-1954,9513,11467,6169.031356,2071.459249
Cell 20 2013,7750,3539,189990825.7,1368,9571,8203,6455.810681,2043.288418
Cell 21 2013,7750,3540,190044510.6,1810,9552,7742,7327.177401,1227.239285
Cell 22 2013,7750,3538,189937140.8,4978,8920,3942,7984.09186,503.9801222
Cell 23 2013,7750,3544,190259250.2,5845,8920,3075,8178.044018,418.2927461
Cell 24 2013,7750,3546,190366619.9,5858,9061,3203,7970.802876,434.7746125
Cell 25 NE 2013,7750,3541,190098195.5,-1005,9882,10887,5112.568483,2673.052621
Cell 25 SE 2013,7750,3539,189990825.7,-1005,9882,10887,5288.33145,2679.768024
Cell 26 NE 2013,7750,3538,189937140.8,-92,9787,9879,6077.464387,2427.368604
Cell 26 NNW 2013,7750,3539,189990825.7,-1005,9882,10887,4987.181407,2643.018464
Cell 26 NW 2013,7750,3539,189990825.7,-1005,9882,10887,4819.272676,2785.222964
Cell 27 NW 2013,7750,3543,190205565.3,270,9787,9517,6203.420265,2263.398841
Cell 28 2013,7750,3549,190527674.6,705,9836,9131,4482.404621,2483.130324
Cell 29 2013,7750,3540,190044510.6,1319,9552,8233,6613.468644,1925.041672
Cell 3 NE 2013,7750,3538,189937140.8,-1958,9292,11250,7180.631713,1330.937176
Cell 3 NW 2013,7750,3537,189883455.9,-1958,9292,11250,6509.830082,1814.447058
Cell 30 2013,7750,3542,190151880.4,4051,8980,4929,8088.828063,483.4347583
Cell 31 2013,7750,3542,190151880.4,5623,9061,3438,8150.502541,458.9220182
Cell 32 2013,7750,3539,189990825.7,5623,9032,3409,8000.247528,519.1583613
Cell 33 NE 2013,7750,3541,190098195.5,-908,9693,10601,6111.012991,2322.170285
Cell 33 SE 2013,7750,3538,189937140.8,-1781,9972,11753,5515.642736,2680.324232
Cell 33 SW 2013,7750,3536,189829771,-159,9741,9900,5202.945984,2651.447822
Cell 34 N 2013,7750,3538,189937140.8,457,9823,9366,6200.147258,2172.789435
Cell 34 NW 2013,7750,3537,189883455.9,457,9823,9366,6410.18773,2019.428042
Cell 34 SE 2013,7750,3537,189883455.9,-1781,9972,11753,5920.72095,2407.421083
Cell 35 2013,7750,3543,190205565.3,705,9950,9245,4753.29269,2581.601079
Cell 37 2013,7750,3545,190312935,4051,9400,5349,7935.414669,510.2610384
Cell 38 2013,7750,3543,190205565.3,6445,9036,2591,8264.775614,387.1258067
Cell 39 2013,7750,3542,190151880.4,5898,9081,3183,8215.151045,482.0837072
Cell 4 2013,7750,3538,189937140.8,2311,9270,6959,7719.189373,678.6186846
Cell 40 NE 2013,7750,3546,190366619.9,-1781,9972,11753,4895.533841,2877.172841
Cell 41 N 2013,7750,3541,190098195.5,-1781,9972,11753,5963.310647,2439.022762
Cell 41 NW 2013,7750,3540,190044510.6,-1781,9972,11753,5531.961299,2742.867918
Cell 42 NW 2013,7750,3540,190044510.6,418,9959,9541,5882.138136,2457.034625
Cell 43 2013,7750,3546,190366619.9,1175,9841,8666,6025.021997,2404.418606
Cell 44 2013,7750,3543,190205565.3,1292,9400,8108,7398.079311,1479.383016
Cell 45 2013,7750,3542,190151880.4,5543,9085,3542,8068.459627,475.9020072
Cell 47 2013,7750,3541,190098195.5,853,9571,8718,6900.802033,2092.056223
Cell 48 2013,7750,3542,190151880.4,853,9841,8988,6560.089215,2243.709591
Cell 49 2013,7750,3549,190527674.6,1304,9904,8600,6835.688645,1981.356118
Cell 5 2011/12 Summer,7750,3537,189883455.9,-1836,9972,11808,5717.007068,2085.072461
Cell 5 2013,7750,3538,189937140.8,5788,8863,3075,7942.544093,391.2104484
Cell 50 2013,7750,3540,190044510.6,1375,9692,8317,7150.266102,1726.277639
Cell 51 2013,7750,3551,190635044.4,5712,9085,3373,8180.999155,396.2865445
Cell 52 2013,7750,3541,190098195.5,1375,9483,8108,7088.709404,1913.287605
Cell 53 2013,7750,3541,190098195.5,1375,9692,8317,7227.222254,1799.266366
Cell 54 2013,7750,3544,190259250.2,2289,8980,6691,8014.289221,715.174362
Cell 55 2013,7750,3547,190420304.8,5712,9005,3293,8116.517339,508.2442177
Cell 56 2013,7750,3542,190151880.4,1430,9542,8112,7037.990119,1463.606633
Cell 57 2013,7750,3547,190420304.8,1681,8980,7299,7229.142938,1239.809498
Cell 58 2013,7750,3539,189990825.7,1681,8980,7299,8049.329754,949.5865108
Cell 59 2013,7750,3543,190205565.3,1327,9542,8215,6934.091166,1520.888294
Cell 6 2011/12,7750,3541,190098195.5,1036,9787,8751,6322.157583,2260.106719
Cell 6 2013,7750,3541,190098195.5,5676,8868,3192,8023.232138,374.0969264
Cell 6 NE 2011/12,7750,3546,190366619.9,1254,9292,8038,6465.839538,2010.065616
Cell 6 NW 2011/12,7750,3544,190259250.2,614,9804,9190,6009.419018,2471.221148
Cell 6 SW 2011/12,7750,3536,189829771,-92,9804,9896,6027.04836,2606.548503
Cell 60 2013,7750,3542,190151880.4,1894,8780,6886,6915.643139,1061.012709
Cell 61 2013,7750,3544,190259250.2,1912,8849,6937,7515.653781,1101.707023
Cell 7 2013,7750,3548,190473989.7,4961,9168,4207,7940.834273,537.4123605
Cell 9 NW 2013,7750,3542,190151880.4,-76,9736,9812,5070.767928,2301.890985
Cell 9 SE 2013,7750,3537,189883455.9,-1836,9736,11572,4741.575064,2367.433633
Cell 9 SW 2013,7750,3542,190151880.4,-1836,9736,11572,5081.955675,2308.582268
Cell R1,7750,3541,190098195.5,1080,8693,7613,5716.994634,1895.204271
Cell R10,7750,3538,189937140.8,2311,9270,6959,7719.189373,678.6186846
Cell R100,7750,3540,190044510.6,1375,9692,8317,7149.65339,1726.349142
Cell R101,7750,3544,190259250.2,1974,9692,7718,7946.620203,694.4219726
Cell R104,7750,3536,189829771,1301,9468,8167,7088.117364,1992.695476
Cell R105,7750,3540,190044510.6,1375,9692,8317,7228.564689,1797.746537
Cell R106,7750,3544,190259250.2,1375,9692,8317,7434.071953,1414.555336
Cell R107,7750,3544,190259250.2,2289,8980,6691,8014.289221,715.174362
Cell R11,7750,3537,189883455.9,5788,8863,3075,7942.486005,391.2504914
Cell R111,7750,3536,189829771,1197,9468,8271,6757.061086,2244.11719
Cell R112,7750,3540,190044510.6,1681,8980,7299,7592.896328,967.821802
Cell R113,7750,3546,190366619.9,1681,8980,7299,7228.816413,1239.831802
Cell R114,7750,3539,189990825.7,1681,8980,7299,8049.329754,949.5865108
Cell R117,7750,3544,190259250.2,1235,9542,8307,6365.523702,2090.000826
Cell R118,7750,3541,190098195.5,1430,9542,8112,7037.995482,1463.81325
Cell R119,7750,3540,190044510.6,1681,8980,7299,7029.660169,1262.579081
Cell R120,7750,3549,190527674.6,1841,8874,7033,7424.202592,1213.00078
Cell R121,7750,3541,190098195.5,5236,8874,3638,8146.583733,467.9042142
Cell R123,7750,3542,190151880.4,1327,9542,8215,6759.020327,1689.026153
Cell R124,7750,3542,190151880.4,1894,8780,6886,6947.145963,1052.76615
Cell R125,7750,3542,190151880.4,1894,8780,6886,6835.099379,1117.172387
Cell R126,7750,3542,190151880.4,1894,8849,6955,7293.894128,1244.839999
Cell R15,7750,3538,189937140.8,-1428,9285,10713,5632.59299,2126.258538
Cell R16,7750,3542,190151880.4,-76,9736,9812,5070.741389,2301.758135
Cell R17,7750,3535,189776086.1,614,9513,8899,6095.222348,2329.581369
Cell R18,7750,3544,190259250.2,-1958,9292,11250,6492.097912,1835.99179
Cell R19,7750,3542,190151880.4,1477,9571,8094,6805.684641,1758.13275
Cell R20,7750,3540,190044510.6,1806,8750,6944,7458.137571,1135.405888
Cell R21,7750,3541,190098195.5,1806,8863,7057,7353.80514,1309.915027
Cell R22,7750,3541,190098195.5,2161,8863,6702,7798.365151,732.7120445
Cell R24,7750,3545,190312935,-1836,9972,11808,5418.104937,2234.38949
Cell R25,7750,3543,190205565.3,592,9804,9212,5082.003669,2602.832129
Cell R26,7750,3535,189776086.1,614,9804,9190,6002.877511,2467.470167
Cell R27,7750,3543,190205565.3,1036,9287,8251,6397.543607,2206.82988
Cell R28,7750,3540,190044510.6,1373,9571,8198,5964.361017,2262.692186
Cell R29,7750,3539,189990825.7,1368,9571,8203,6455.810681,2043.288418
Cell R30,7750,3537,189883455.9,1872,8727,6855,7487.64207,1053.599149
Cell R31,7750,3541,190098195.5,2556,8740,6184,7733.121999,689.2582176
Cell R35,7750,3536,189829771,-1836,9972,11808,5718.012726,2084.509423
Cell R36,7750,3535,189776086.1,-1836,9736,11572,5396.850071,2330.546175
Cell R37,7750,3547,190420304.8,-92,9804,9896,6028.550042,2501.094552
Cell R38,7750,3541,190098195.5,956,9787,8831,5719.134425,2491.797637
Cell R39,7750,3544,190259250.2,1335,9548,8213,6620.651242,1985.162046
Cell R40,7750,3540,190044510.6,1810,9552,7742,7326.923164,1227.238674
Cell R46,7750,3540,190044510.6,-1005,9882,10887,5269.19887,2698.129385
Cell R47,7750,3539,189990825.7,-1005,9882,10887,4816.967505,2786.182964
Cell R48,7750,3538,189937140.8,-92,9787,9879,6077.464387,2427.368604
Cell R49,7750,3544,190259250.2,270,9787,9517,6204.018341,2263.35947
Cell R5,7750,3545,190312935,-1428,9210,10638,5753.098166,1943.48678
Cell R50,7750,3547,190420304.8,705,9836,9131,4483.121229,2483.645001
Cell R51,7750,3540,190044510.6,1319,9552,8233,6631.433333,1913.586855
Cell R52,7750,3540,190044510.6,2206,8914,6708,7569.094633,849.376968
Cell R53,7750,3538,189937140.8,2213,8794,6581,7693.844545,695.4494678
Cell R54,7750,3542,190151880.4,5623,9061,3438,8150.502541,458.9220182
Cell R58,7750,3536,189829771,-1005,9693,10698,5062.081448,2746.7974
Cell R59,7750,3539,189990825.7,-908,9693,10601,6112.00113,2322.398359
Cell R6,7750,3540,190044510.6,-1954,9513,11467,6169.031356,2071.459249
Cell R60,7750,3537,189883455.9,457,9823,9366,6410.18773,2019.428042
Cell R61,7750,3543,190205565.3,705,9950,9245,4753.29269,2581.601079
Cell R62,7750,3537,189883455.9,987,9552,8565,4992.892564,2577.739119
Cell R63,7750,3539,189990825.7,1104,9552,8448,6315.189319,2150.661235
Cell R64,7750,3543,190205565.3,4051,8980,4929,7928.500988,550.6944323
Cell R65,7750,3543,190205565.3,4051,8980,4929,8088.689529,483.4368411
Cell R66,7750,3543,190205565.3,5623,8980,3357,8154.520745,482.7976058
Cell R69,7750,3536,189829771,-159,9741,9900,5202.414593,2652.231768
Cell R7,7750,3537,189883455.9,-1958,9292,11250,6509.830082,1814.447058
Cell R70,7750,3538,189937140.8,-1781,9972,11753,5515.642736,2680.324232
Cell R71,7750,3538,189937140.8,-1781,9972,11753,5921.081967,2407.17659
Cell R72,7750,3538,189937140.8,418,9959,9541,5545.322216,2540.770771
Cell R73,7750,3540,190044510.6,418,9950,9532,4702.472034,2669.539971
Cell R74,7750,3542,190151880.4,540,9400,8860,6342.663749,2380.8014
Cell R75,7750,3546,190366619.9,4051,9400,5349,7935.334179,510.2115917
Cell R76,7750,3543,190205565.3,6445,8980,2535,8219.777307,382.2185277
Cell R77,7750,3543,190205565.3,6445,9036,2591,8264.474174,387.1068263
Cell R8,7750,3541,190098195.5,-1958,9292,11250,7119.369387,1359.57022
Cell R80,7750,3545,190312935,-1781,9972,11753,4894.657828,2877.105754
Cell R81,7750,3543,190205565.3,-1781,9972,11753,5923.047417,2532.543611
Cell R82,7750,3540,190044510.6,418,9959,9541,5882.138136,2457.034625
Cell R83,7750,3542,190151880.4,418,9571,9153,6248.317335,2470.54391
Cell R84,7750,3543,190205565.3,540,9841,9301,5634.309907,2527.513886
Cell R85,7750,3546,190366619.9,1175,9841,8666,6024.503666,2404.191976
Cell R86,7750,3542,190151880.4,1470,9629,8159,7701.6214,1059.516777
Cell R87,7750,3544,190259250.2,5543,9085,3542,8068.317438,475.8567632
Cell R9,7750,3539,189990825.7,-1958,9270,11228,7275.907318,1299.055857
Cell R90,7750,3542,190151880.4,853,9571,8718,6901.304912,2091.974918
Cell R91,7750,3542,190151880.4,853,9841,8988,6560.089215,2243.709591
Cell R92,7750,3543,190205565.3,1175,9904,8729,5542.91335,2503.909646
Cell R93,7750,3549,190527674.6,1304,9904,8600,6835.688645,1981.356118
Cell R97,7750,3542,190151880.4,1120,9152,8032,7171.774986,1868.727808
Cell R98,7750,3541,190098195.5,1336,9757,8421,6887.551257,2154.403006
Cell R99,7750,3541,190098195.5,1375,9483,8108,7088.709404,1913.287605
Cell S102,7750,3545,190312935,5712,9085,3373,8201.252186,403.3016197
Cell S108,7750,3546,190366619.9,5712,9005,3293,8116.559504,508.3096741
Cell S13,7750,3541,190098195.5,5654,9168,3514,8013.730585,411.8209393
Cell S14,7750,3547,190420304.8,4961,9168,4207,7940.587539,537.2871444
Cell S2,7750,3542,190151880.4,5676,8868,3192,8023.162055,374.0673616
Cell S23,7750,3542,190151880.4,4961,8877,3916,7955.658103,461.5058421
Cell S32,7750,3538,189937140.8,4978,8920,3942,7983.524308,482.4946622
Cell S33,7750,3543,190205565.3,5061,8963,3902,8028.37313,399.6775333
Cell S34,7750,3546,190366619.9,5858,9061,3203,7970.802876,434.7746125
Cell S41,7750,3543,190205565.3,3327,8860,5533,7783.112616,574.9802049
Cell S42,7750,3544,190259250.2,5845,8920,3075,8178.044018,418.2927461
Cell S44,7750,3545,190312935,5645,9061,3416,7968.628773,508.9060059
Cell S56,7750,3541,190098195.5,5505,9061,3556,7684.344818,526.6944501
Cell S67,7750,3539,189990825.7,5623,9032,3409,8000.247528,519.1583613
Cell S78,7750,3543,190205565.3,5898,9081,3183,8215.209992,482.0284357
Cell S88,7750,3542,190151880.4,5600,9081,3481,8232.834557,465.8562637
Cell S94,7750,3542,190151880.4,5543,9085,3542,8189.82157,417.7475352
Cell S95,7750,3551,190635044.4,5712,9085,3373,8180.999155,396.2865445
W287,7750,3536,189829771,894,9754,8860,4319.853507,2084.127061
W295,7750,3538,189937140.8,1619,9145,7526,6827.442058,1734.344107
W338,7750,3544,190259250.2,697,9484,8787,3654.143059,2340.67366
W342,7750,3539,189990825.7,976,8946,7970,5394.559763,2357.203864
W345,7750,3538,189937140.8,1609,8580,6971,7350.430752,989.0634943
W387,7750,3538,189937140.8,393,9470,9077,4783.117015,2310.632116
W393,7750,3542,190151880.4,728,8860,8132,5401.9952,2528.073852
W440,7750,3536,189829771,1073,9239,8166,5299.304581,2194.088547
W441,7750,3532,189615031.5,1101,9239,8138,6404.357871,1684.897761
W445,7750,3545,190312935,2175,8548,6373,6807.722426,1010.803813
W500,7750,3534,189722401.3,1196,8598,7402,6329.248161,1687.783377
1,8000,3767,202230980.6,-1954,9513,11467,6143.979028,2073.809479
2,8000,3766,202177295.7,-1958,9292,11250,6368.150027,1955.374874
3,8000,3779,202875199.3,-959,9571,10530,7114.745965,1539.059703
4,8000,3776,202714144.6,1806,8961,7155,7461.785487,1124.678797
5,8000,3776,202714144.6,-1836,9972,11808,5652.669492,2117.856404
6,8000,3771,202445720.2,1036,9787,8751,6280.838239,2264.117959
7,8000,3771,202445720.2,1373,9571,8198,6228.531159,2150.646132
8,8000,3778,202821514.4,1806,8727,6921,7244.439386,1273.958599
9,8000,3782,203036254,4978,8920,3942,7967.621629,485.5321693
10,8000,3769,202338350.4,-1005,9882,10887,5095.552401,2686.770583
11,8000,3769,202338350.4,-92,9787,9879,6115.368002,2414.601584
12,8000,3772,202499405.1,705,9931,9226,4497.281283,2494.27122
13,8000,3773,202553090,1172,9552,8380,6578.715081,1949.892333
14,8000,3779,202875199.3,5717,8967,3250,8124.946017,443.8646306
16,8000,3768,202284665.5,-218,9741,9959,5142.683386,2643.007175
17,8000,3771,202445720.2,457,9823,9366,6392.046672,2042.957585
18,8000,3772,202499405.1,705,9950,9245,4822.410657,2537.095617
19,8000,3780,202928884.2,987,9552,8565,5066.376984,2572.582581
20,8000,3777,202767829.5,4051,9400,5349,7930.58565,513.0991882
21,8000,3773,202553090,6445,9036,2591,8262.597138,389.829187
22,8000,3770,202392035.3,-1781,9972,11753,4819.870557,2908.093217
23,8000,3772,202499405.1,418,9959,9541,5964.935843,2439.810412
24,8000,3776,202714144.6,853,9841,8988,6522.613083,2261.989795
25,8000,3775,202660459.8,1304,9904,8600,6834.606887,1985.945546
26,8000,3774,202606774.9,5543,9085,3542,8070.220986,478.1128348
27,8000,3779,202875199.3,1336,9904,8568,6818.571315,2196.706089
28,8000,3778,202821514.4,1375,9692,8317,7196.467708,1837.780104
29,8000,3774,202606774.9,1375,9692,8317,7151.509274,1731.060691
31,8000,3773,202553090,1224,9468,8244,7182.552876,1765.30829
32,8000,3771,202445720.2,1681,8980,7299,7239.750199,1232.04952
33,8000,3775,202660459.7,1430,9542,8112,6998.477351,1527.478913
34,8000,3775,202660459.8,1894,8780,6886,6918.005298,1058.429472
10A,8000,3770,202392035.3,-1005,9882,10887,4833.839788,2779.156568
10NE,8000,3774,202606774.9,-1005,9882,10887,5008.438262,2658.377687
10NW,8000,3773,202553090,-1836,9736,11572,5421.339518,2320.501822
10SW,8000,3770,202392035.3,-1005,9882,10887,5251.699469,2686.445424
11NE,8000,3773,202553090,-92,9804,9896,5996.29181,2494.482413
11NW,8000,3773,202553090,-92,9804,9896,5981.998145,2476.164277
11SE,8000,3772,202499405.1,190,9787,9597,6209.521209,2264.303316
17NW,8000,3768,202284665.5,-908,9693,10601,6076.872611,2346.379024
17SE,8000,3770,202392035.3,-1781,9972,11753,5938.707692,2410.709738
17SW,8000,3768,202284665.5,-1781,9972,11753,5501.884554,2684.779981
22S,8000,3774,202606774.9,-1781,9972,11753,4701.043985,2906.936879
23S,8000,3770,202392035.3,1111,9571,8460,4830.199469,2357.160103
24S,8000,3776,202714144.6,853,9841,8988,6522.111494,2259.237086
27A,8000,3776,202714144.6,1120,9427,8307,7031.034693,1975.405616
2A,8000,3772,202499405.1,-1958,9292,11250,6578.195652,1778.207441
5NE,8000,3770,202392035.3,-1836,9736,11572,4778.887798,2364.476233
5NW,8000,3764,202069926,-1836,9736,11572,5087.700319,2309.686546
5SE,8000,3773,202553090,-92,9804,9896,5172.851312,2608.331813
6NE,8000,3771,202445720.2,1254,9292,8038,6371.125431,2054.582888
6NW,8000,3772,202499405.1,614,9804,9190,6020.937964,2452.509864
6SW,8000,3775,202660459.8,-92,9804,9896,5952.082649,2636.047871
Cell 1 2011/12,8000,3767,202230980.6,-1954,9513,11467,6143.979028,2073.809479
Cell 1 SW 2013,8000,3768,202284665.5,-1428,9285,10713,5651.957537,2126.487965
Cell 10 2011/12,8000,3769,202338350.4,-1005,9882,10887,5095.552401,2686.770583
Cell 10 NE 2011/12,8000,3774,202606774.9,-1005,9882,10887,5008.438262,2658.377687
Cell 10 NW 2011/12,8000,3773,202553090,-1836,9736,11572,5421.339518,2320.501822
Cell 10 SE 2013,8000,3772,202499405.1,614,9804,9190,6020.3921,2452.908721
Cell 10 SW 2011/12,8000,3770,202392035.3,-1005,9882,10887,5251.699469,2686.445424
Cell 10-A 2011/12,8000,3770,202392035.3,-1005,9882,10887,4833.839788,2779.156568
Cell 11 NE 2011/12,8000,3773,202553090,-92,9804,9896,5996.29181,2494.482413
Cell 11 NW 2013,8000,3779,202875199.3,-1958,9292,11250,6493.693305,1857.263863
Cell 11 SW 2013,8000,3776,202714144.6,1036,9287,8251,6373.563294,2162.86527
Cell 12 2013,8000,3772,202499405.1,1373,9571,8198,6227.569194,2151.211379
Cell 13 2013,8000,3780,202928884.2,1806,8692,6886,7234.125132,1271.201582
Cell 14 2013,8000,3776,202714144.6,2161,8863,6702,7776.342426,813.5977272
Cell 15 2013,8000,3770,202392035.3,4961,8933,3972,8012.183554,454.3536923
Cell 15-A 2013,8000,3780,202928884.2,5061,8963,3902,8032.018254,404.6947023
Cell 16 2013,8000,3775,202660459.8,5848,8963,3115,8000.130066,411.3550855
Cell 17 NW 2011/12,8000,3768,202284665.5,-908,9693,10601,6076.872611,2346.379024
Cell 17 NW 2013,8000,3772,202499405.1,-1836,9972,11808,5388.29772,2240.110278
Cell 17 SE 2013,8000,3774,202606774.9,-1836,9736,11572,5420.731055,2320.495373
Cell 17 SW 2013,8000,3770,202392035.3,-1836,9972,11808,5650.829708,2123.583558
Cell 18 2011/12,8000,3772,202499405.1,705,9950,9245,4822.410657,2537.095617
Cell 18 NE 2013,8000,3770,202392035.3,-92,9804,9896,6064.732095,2578.976951
Cell 18 NW 2013,8000,3767,202230980.6,-1428,9804,11232,5144.904699,2596.745063
Cell 18 SE 2013,8000,3773,202553090,-92,9804,9896,5996.29181,2494.482413
Cell 18 SSE 2013,8000,3771,202445720.2,-92,9787,9879,6044.316362,2457.598669
Cell 19 NW 2013,8000,3769,202338350.4,1036,9787,8751,6373.968692,2214.599656
Cell 2 2011/12,8000,3766,202177295.7,-1958,9292,11250,6368.150027,1955.374874
Cell 2 NE 2013,8000,3774,202606774.9,-1958,9292,11250,6624.45151,1758.161885
Cell 2 SW 2013,8000,3768,202284665.5,-1954,9513,11467,6142.734342,2075.131428
Cell 20 2013,8000,3777,202767829.5,1335,9571,8236,6414.776542,2062.584223
Cell 21 2013,8000,3777,202767829.5,1810,9552,7742,7278.983585,1287.060979
Cell 22 2013,8000,3777,202767829.5,4978,8920,3942,7985.481334,497.87494
Cell 23 2013,8000,3773,202553090,5845,8920,3075,8163.994699,422.1396661
Cell 24 2013,8000,3772,202499405.1,5858,9061,3203,7973.485419,439.3377591
Cell 25 NE 2013,8000,3769,202338350.4,-1005,9882,10887,5095.552401,2686.770583
Cell 25 SE 2013,8000,3771,202445720.2,-1005,9882,10887,5252.117741,2686.211973
Cell 26 NE 2013,8000,3769,202338350.4,-92,9787,9879,6115.254179,2414.520965
Cell 26 NNW 2013,8000,3774,202606774.9,-1005,9882,10887,5008.438262,2658.377687
Cell 26 NW 2013,8000,3771,202445720.2,-1005,9882,10887,4834.64943,2779.232692
Cell 27 NW 2013,8000,3772,202499405.1,190,9787,9597,6209.521209,2264.303316
Cell 28 2013,8000,3770,202392035.3,705,9931,9226,4497.142971,2493.900961
Cell 29 2013,8000,3776,202714144.6,1172,9552,8380,6579.408633,1949.278083
Cell 3 NE 2013,8000,3776,202714144.6,-1958,9292,11250,7159.888242,1350.530473
Cell 3 NW 2013,8000,3769,202338350.4,-1958,9292,11250,6511.870523,1797.616765
Cell 30 2013,8000,3772,202499405.1,4051,8980,4929,8084.148462,482.6977056
Cell 31 2013,8000,3775,202660459.7,5623,9061,3438,8154.483974,459.3643096
Cell 32 2013,8000,3781,202982569.1,5623,9032,3409,8004.424226,517.2893471
Cell 33 NE 2013,8000,3768,202284665.5,-908,9693,10601,6076.872611,2346.379024
Cell 33 SE 2013,8000,3770,202392035.3,-1781,9972,11753,5501.187003,2685.498848
Cell 33 SW 2013,8000,3775,202660459.7,-834,9741,10575,5164.531921,2646.076358
Cell 34 N 2013,8000,3775,202660459.7,457,9823,9366,6169.843179,2194.826747
Cell 34 NW 2013,8000,3770,202392035.3,457,9823,9366,6391.708223,2043.122808
Cell 34 SE 2013,8000,3772,202499405.1,-1781,9972,11753,5939.356575,2410.211346
Cell 35 2013,8000,3773,202553090,586,9950,9364,4780.642725,2574.799189
Cell 37 2013,8000,3771,202445720.2,4051,9400,5349,7932.75126,513.7636215
Cell 38 2013,8000,3772,202499405.1,6445,9036,2591,8264.877519,389.4243037
Cell 39 2013,8000,3780,202928884.2,5898,9081,3183,8208.598677,480.9081395
Cell 4 2013,8000,3773,202553090,1704,9270,7566,7684.748211,774.8066217
Cell 40 NE 2013,8000,3773,202553090,-1781,9972,11753,4896.169891,2866.885498
Cell 41 N 2013,8000,3768,202284665.5,-1781,9972,11753,5930.767251,2448.001946
Cell 41 NW 2013,8000,3769,202338350.4,-1781,9972,11753,5497.805519,2761.611011
Cell 42 NW 2013,8000,3770,202392035.3,418,9959,9541,5961.214589,2440.586036
Cell 43 2013,8000,3774,202606774.9,1175,9841,8666,6012.751457,2425.821228
Cell 44 2013,8000,3771,202445720.2,1292,9400,8108,7349.446036,1537.786276
Cell 45 2013,8000,3775,202660459.8,5543,9085,3542,8070.652185,478.1297046
Cell 47 2013,8000,3778,202821514.4,853,9571,8718,6909.394653,2085.935331
Cell 48 2013,8000,3773,202553090,853,9841,8988,6519.405778,2261.14765
Cell 49 2013,8000,3775,202660459.8,1304,9904,8600,6834.606887,1985.945546
Cell 5 2011/12 Summer,8000,3770,202392035.3,-1836,9972,11808,5650.525995,2123.415672
Cell 5 2013,8000,3775,202660459.7,5788,8863,3075,7942.831523,388.232686
Cell 50 2013,8000,3774,202606774.9,1375,9692,8317,7151.509274,1731.060691
Cell 51 2013,8000,3777,202767829.5,5712,9085,3373,8178.126026,399.1814978
Cell 52 2013,8000,3778,202821514.4,1375,9483,8108,7035.568555,1966.006985
Cell 53 2013,8000,3778,202821514.4,1375,9692,8317,7196.467708,1837.780104
Cell 54 2013,8000,3771,202445720.2,2289,8980,6691,8005.782286,734.5056609
Cell 55 2013,8000,3781,202982569.1,5712,9005,3293,8107.22137,509.8579356
Cell 56 2013,8000,3772,202499405.1,1430,9542,8112,6998.863733,1527.920894
Cell 57 2013,8000,3770,202392035.3,1681,8980,7299,7239.397082,1232.03015
Cell 58 2013,8000,3779,202875199.3,1681,8980,7299,8005.093146,1011.30248
Cell 59 2013,8000,3777,202767829.5,1327,9542,8215,6893.831348,1585.615827
Cell 6 2011/12,8000,3771,202445720.2,1036,9787,8751,6280.838239,2264.117959
Cell 6 2013,8000,3773,202553090,5647,8877,3230,8020.167506,378.9801603
Cell 6 NE 2011/12,8000,3771,202445720.2,1254,9292,8038,6371.125431,2054.582888
Cell 6 NW 2011/12,8000,3772,202499405.1,614,9804,9190,6020.937964,2452.509864
Cell 6 SW 2011/12,8000,3775,202660459.8,-92,9804,9896,5952.082649,2636.047871
Cell 60 2013,8000,3771,202445720.2,1894,8780,6886,6931.5179,1052.441428
Cell 61 2013,8000,3776,202714144.6,1894,8849,6955,7495.998941,1133.162778
Cell 7 2013,8000,3775,202660459.7,4961,9168,4207,7937.676556,539.1231434
Cell 9 NW 2013,8000,3771,202445720.2,-76,9736,9812,5122.16733,2302.357505
Cell 9 SE 2013,8000,3770,202392035.3,-1836,9736,11572,4778.887798,2364.476233
Cell 9 SW 2013,8000,3766,202177295.7,-1836,9736,11572,5085.186405,2309.06957
Cell R1,8000,3765,202123610.8,1080,8693,7613,5693.607437,1901.238462
Cell R10,8000,3775,202660459.8,1704,9270,7566,7684.451656,774.8026734
Cell R100,8000,3775,202660459.7,1375,9692,8317,7150.06543,1733.102686
Cell R101,8000,3770,202392035.3,1685,9692,8007,7913.880637,778.5732855
Cell R104,8000,3777,202767829.5,1301,9468,8167,7109.55229,1960.204351
Cell R105,8000,3776,202714144.6,1375,9692,8317,7195.730932,1837.987537
Cell R106,8000,3771,202445720.2,1375,9692,8317,7447.456112,1392.521589
Cell R107,8000,3771,202445720.2,2289,8980,6691,8005.782286,734.5056609
Cell R11,8000,3775,202660459.7,5788,8863,3075,7942.831523,388.232686
Cell R111,8000,3779,202875199.3,1168,9468,8300,6752.364911,2232.856386
Cell R112,8000,3780,202928884.2,1681,8980,7299,7568.76164,990.2246183
Cell R113,8000,3768,202284665.5,1681,8980,7299,7238.878185,1232.143114
Cell R114,8000,3779,202875199.3,1681,8980,7299,8005.093146,1011.30248
Cell R117,8000,3774,202606774.9,1168,9542,8374,6374.106253,2096.030081
Cell R118,8000,3772,202499405.1,1430,9542,8112,6998.837752,1527.90688
Cell R119,8000,3777,202767829.5,1681,8980,7299,7056.149854,1245.039912
Cell R120,8000,3773,202553090,1841,8874,7033,7417.720647,1230.231676
Cell R121,8000,3778,202821514.4,5097,8874,3777,8138.216781,490.6807868
Cell R123,8000,3780,202928884.2,1327,9730,8403,6748.782804,1700.845292
Cell R124,8000,3776,202714144.6,1894,8780,6886,6951.803496,1048.298913
Cell R125,8000,3778,202821514.4,1894,8780,6886,6837.080731,1106.725408
Cell R126,8000,3777,202767829.5,1894,8849,6955,7286.792163,1257.077348
Cell R15,8000,3768,202284665.5,-1428,9285,10713,5651.957537,2126.487965
Cell R16,8000,3767,202230980.6,-76,9736,9812,5123.632333,2303.553218
Cell R17,8000,3774,202606774.9,614,9513,8899,6081.356386,2323.574603
Cell R18,8000,3762,201962556.2,-1958,9292,11250,6503.123073,1849.969706
Cell R19,8000,3772,202499405.1,1373,9571,8198,6782.53473,1775.773833
Cell R20,8000,3780,202928884.2,1806,8863,7057,7466.24418,1125.847822
Cell R21,8000,3781,202982569.1,1806,8863,7057,7368.612536,1293.557035
Cell R22,8000,3777,202767829.5,2161,8863,6702,7775.641514,814.6294048
Cell R24,8000,3773,202553090,-1836,9972,11808,5388.877021,2240.095958
Cell R25,8000,3768,202284665.5,-1428,9804,11232,5145.390393,2596.571583
Cell R26,8000,3776,202714144.6,614,9804,9190,6015.262182,2450.478812
Cell R27,8000,3769,202338350.4,1036,9787,8751,6373.968692,2214.599656
Cell R28,8000,3777,202767829.5,1373,9571,8198,5912.490071,2289.34599
Cell R29,8000,3780,202928884.2,1335,9571,8236,6415.709788,2062.077923
Cell R30,8000,3777,202767829.5,1872,8727,6855,7483.673286,1076.544266
Cell R31,8000,3772,202499405.1,2239,8740,6501,7725.366119,718.5736482
Cell R35,8000,3771,202445720.2,-1836,9972,11808,5650.989128,2123.324534
Cell R36,8000,3774,202606774.9,-1836,9736,11572,5420.731055,2320.495373
Cell R37,8000,3773,202553090,-92,9804,9896,5996.29181,2494.482413
Cell R38,8000,3770,202392035.3,956,9787,8831,5706.988329,2492.840997
Cell R39,8000,3770,202392035.3,1335,9552,8217,6570.745358,2027.353463
Cell R40,8000,3777,202767829.5,1810,9552,7742,7278.983585,1287.060979
Cell R46,8000,3772,202499405.1,-1005,9882,10887,5280.567073,2699.941905
Cell R47,8000,3770,202392035.3,-1005,9882,10887,4833.839788,2779.156568
Cell R48,8000,3769,202338350.4,-92,9787,9879,6114.850093,2414.297794
Cell R49,8000,3771,202445720.2,190,9787,9597,6209.370724,2264.584662
Cell R5,8000,3770,202392035.3,-1428,9210,10638,5749.171088,1946.284452
Cell R50,8000,3769,202338350.4,705,9931,9226,4496.008756,2493.259372
Cell R51,8000,3772,202499405.1,1172,9552,8380,6591.017497,1942.689556
Cell R52,8000,3773,202553090,2206,8914,6708,7579.911476,840.5469841
Cell R53,8000,3777,202767829.5,2213,8794,6581,7699.301827,694.6121357
Cell R54,8000,3775,202660459.7,5623,9061,3438,8154.483974,459.3643096
Cell R58,8000,3770,202392035.3,-1005,9693,10698,5081.880106,2743.758254
Cell R59,8000,3768,202284665.5,-908,9693,10601,6076.872611,2346.379024
Cell R6,8000,3767,202230980.6,-1954,9513,11467,6142.657287,2075.401455
Cell R60,8000,3771,202445720.2,457,9823,9366,6392.013524,2042.937895
Cell R61,8000,3773,202553090,586,9950,9364,4780.642725,2574.799189
Cell R62,8000,3774,202606774.9,987,9552,8565,5052.624271,2577.91851
Cell R63,8000,3776,202714144.6,1104,9552,8448,6282.655191,2170.163006
Cell R64,8000,3779,202875199.3,4051,8980,4929,7933.117756,551.4038747
Cell R65,8000,3772,202499405.1,4051,8980,4929,8084.148462,482.6977056
Cell R66,8000,3775,202660459.7,5623,8980,3357,8143.331656,479.8281819
Cell R69,8000,3775,202660459.7,-834,9741,10575,5164.531921,2646.076358
Cell R7,8000,3767,202230980.6,-1958,9292,11250,6511.252456,1797.893179
Cell R70,8000,3769,202338350.4,-1781,9972,11753,5500.29663,2685.298648
Cell R71,8000,3773,202553090,-1781,9972,11753,5936.172277,2411.208601
Cell R72,8000,3778,202821514.4,418,9959,9541,5531.840656,2559.533909
Cell R73,8000,3771,202445720.2,418,9950,9532,4690.29939,2653.655844
Cell R74,8000,3770,202392035.3,540,9400,8860,6344.92069,2384.536048
Cell R75,8000,3771,202445720.2,4051,9400,5349,7932.75126,513.7636215
Cell R76,8000,3777,202767829.5,6445,8980,2535,8211.476304,381.2736345
Cell R77,8000,3773,202553090,6445,9036,2591,8264.981977,389.4255424
Cell R8,8000,3778,202821514.4,-1958,9292,11250,7100.699576,1387.58785
Cell R80,8000,3774,202606774.9,-1781,9972,11753,4897.085851,2867.057748
Cell R81,8000,3769,202338350.4,-1781,9972,11753,5873.347307,2552.351515
Cell R82,8000,3769,202338350.4,418,9959,9541,5960.741045,2440.736607
Cell R83,8000,3776,202714144.6,418,9571,9153,6274.830508,2450.149936
Cell R84,8000,3771,202445720.2,540,9841,9301,5658.543888,2538.661901
Cell R85,8000,3775,202660459.7,1175,9841,8666,6010.395232,2426.783794
Cell R86,8000,3772,202499405.1,1470,9629,8159,7691.366384,1097.327794
Cell R87,8000,3775,202660459.8,5543,9085,3542,8070.652185,478.1297046
Cell R9,8000,3772,202499405.1,-1958,9270,11228,7256.973489,1319.41193
Cell R90,8000,3778,202821514.4,853,9571,8718,6909.394653,2085.935331
Cell R91,8000,3772,202499405.1,853,9841,8988,6519.997349,2261.155405
Cell R92,8000,3777,202767829.5,1175,9904,8729,5616.629865,2490.108062
Cell R93,8000,3775,202660459.8,1304,9904,8600,6834.606887,1985.945546
Cell R97,8000,3772,202499405.1,1120,9427,8307,7170.319989,1880.082984
Cell R98,8000,3777,202767829.5,1336,9904,8568,6819.498544,2195.614262
Cell R99,8000,3779,202875199.3,1375,9483,8108,7036.046044,1965.965927
Cell S102,8000,3778,202821514.4,5712,9085,3373,8201.010058,400.9646018
Cell S108,8000,3781,202982569.1,5712,9005,3293,8107.163713,509.8187157
Cell S13,8000,3781,202982569.1,5654,9168,3514,8022.949484,409.8492977
Cell S14,8000,3776,202714144.6,4961,9168,4207,7937.881091,539.1666965
Cell S2,8000,3773,202553090,5647,8877,3230,8020.167506,378.9801603
Cell S23,8000,3778,202821514.4,4961,8877,3916,7948.23081,461.2208058
Cell S32,8000,3780,202928884.2,4978,8920,3942,7983.312434,477.9358799
Cell S33,8000,3780,202928884.2,5061,8963,3902,8032.018254,404.6947023
Cell S34,8000,3772,202499405.1,5858,9061,3203,7973.485419,439.3377591
Cell S41,8000,3779,202875199.3,3327,8914,5587,7779.555438,581.588706
Cell S42,8000,3773,202553090,5845,8920,3075,8163.994699,422.1396661
Cell S44,8000,3777,202767829.5,5645,9061,3416,7966.438973,513.9102405
Cell S56,8000,3773,202553090,5505,9061,3556,7696.015902,525.7164271
Cell S67,8000,3781,202982569.1,5623,9032,3409,8004.424226,517.2893471
Cell S78,8000,3781,202982569.1,5898,9081,3183,8208.561492,480.849975
Cell S88,8000,3778,202821514.4,5031,9081,4050,8224.574907,479.6254972
Cell S94,8000,3780,202928884.2,5543,9085,3542,8176.74709,430.1606542
Cell S95,8000,3777,202767829.5,5712,9085,3373,8178.217633,399.0942436
W287,8000,3774,202606774.9,894,9837,8943,4388.293058,2107.99576
W295,8000,3770,202392035.3,1465,9145,7680,6809.667109,1762.384959
W338,8000,3770,202392035.3,697,9484,8787,3663.854642,2333.180685
W342,8000,3769,202338350.4,976,8946,7970,5423.008225,2352.319052
W345,8000,3773,202553090,1609,8580,6971,7314.570633,1044.123129
W387,8000,3765,202123610.8,3,9470,9467,4750.721381,2315.821136
W393,8000,3767,202230980.6,728,9151,8423,5354.998407,2546.011705
W440,8000,3767,202230980.6,1073,9239,8166,5314.289089,2192.631216
W441,8000,3773,202553090,1101,9239,8138,6334.584151,1742.626994
W445,8000,3770,202392035.3,2175,8898,6723,6810.580637,1004.756892
W500,8000,3769,202338350.4,1196,8598,7402,6349.188114,1668.090308
1,8250,4006,215061669.3,-1954,9513,11467,6124.25362,2074.740638
2,8250,4010,215276408.9,-1958,9292,11250,6381.171571,1966.424487
3,8250,4008,215169039.1,-1067,9571,10638,7091.159431,1568.051974
4,8250,4009,215222724,1806,9498,7692,7472.585682,1117.939062
5,8250,4012,215383778.7,-1836,9972,11808,5596.633101,2155.783515
6,8250,4011,215330093.8,1036,9787,8751,6248.277487,2267.588812
7,8250,4007,215115354.2,1373,9571,8198,6214.182181,2145.521201
8,8250,4011,215330093.8,1806,8727,6921,7269.749938,1247.82056
9,8250,4017,215652203.1,4978,8920,3942,7968.499129,484.2922716
10,8250,4009,215222724,-1005,9882,10887,5092.72462,2687.880162
11,8250,4022,215920627.6,-92,9787,9879,6154.116857,2398.555594
12,8250,4021,215866942.7,705,9950,9245,4505.652823,2498.181019
13,8250,4014,215491148.5,1172,9552,8380,6540.080468,1979.088784
14,8250,4014,215491148.5,5717,8967,3250,8120.166418,452.9341206
16,8250,4019,215759572.9,-834,9741,10575,5112.292361,2646.324656
17,8250,4007,215115354.2,-1451,9823,11274,6366.569753,2072.317092
18,8250,4010,215276408.9,705,9950,9245,4858.611222,2538.507834
19,8250,4012,215383778.7,987,9552,8565,5111.924227,2570.465904
20,8250,4012,215383778.7,3453,9400,5947,7921.144068,536.2297652
21,8250,4015,215544833.3,6371,9036,2665,8263.032628,396.1633903
22,8250,4012,215383778.7,-1781,9972,11753,4837.130608,2894.08406
23,8250,4007,215115354.2,418,9959,9541,6037.704018,2423.740411
24,8250,4014,215491148.5,853,9841,8988,6476.802691,2290.842304
25,8250,4010,215276408.9,1304,9904,8600,6833.001746,1986.224694
26,8250,4014,215491148.5,5543,9510,3967,8072.975835,481.2114851
27,8250,4014,215491148.5,1336,9904,8568,6758.245142,2234.181978
28,8250,4016,215598518.2,1375,9692,8317,7165.169572,1872.25855
29,8250,4017,215652203.1,1375,9692,8317,7153.451332,1733.898205
31,8250,4014,215491148.5,1197,9468,8271,7155.428749,1773.590259
32,8250,4009,215222724,1681,8980,7299,7240.441507,1227.254809
33,8250,4017,215652203.1,1430,9542,8112,6968.584267,1580.906858
34,8250,4014,215491148.5,1894,8780,6886,6932.658445,1061.779373
10A,8250,4016,215598518.2,-1005,9882,10887,4867.507968,2770.240431
10NE,8250,4010,215276408.9,-1005,9882,10887,5037.871322,2668.805454
10NW,8250,4009,215222724,-1836,9804,11640,5451.42654,2309.369633
10SW,8250,4018,215705888,-1005,9882,10887,5216.300647,2697.785939
11NE,8250,4012,215383778.7,-92,9804,9896,5968.080508,2487.430596
11NW,8250,4008,215169039.1,-92,9804,9896,6013.096058,2472.119541
11SE,8250,4010,215276408.9,190,9787,9597,6209.358603,2273.613551
17NW,8250,4009,215222724,-908,9823,10731,6017.758793,2376.803342
17SE,8250,4011,215330093.8,-1781,9972,11753,5960.73074,2408.033225
17SW,8250,4023,215974312.5,-1781,9972,11753,5473.698235,2685.701472
22S,8250,4011,215330093.8,-1781,9972,11753,4720.135128,2898.651579
23S,8250,4022,215920627.6,1111,9571,8460,4919.009697,2372.445143
24S,8250,4012,215383778.7,853,9841,8988,6470.574776,2291.660246
27A,8250,4009,215222724,1120,9427,8307,7040.683961,1978.649419
2A,8250,4008,215169039.1,-1958,9292,11250,6599.336577,1791.029426
5NE,8250,4010,215276408.9,-1836,9804,11640,4830.636658,2356.649379
5NW,8250,4008,215169039.1,-1836,9736,11572,5080.013972,2311.570165
5SE,8250,4014,215491148.5,-1428,9804,11232,5220.572496,2599.998639
6NE,8250,4013,215437463.6,1254,9292,8038,6275.769499,2101.016921
6NW,8250,4009,215222724,614,9804,9190,6024.531055,2440.042908
6SW,8250,4013,215437463.6,-92,9804,9896,5890.469225,2654.149005
Cell 1 2011/12,8250,4006,215061669.3,-1954,9513,11467,6124.25362,2074.740638
Cell 1 SW 2013,8250,4011,215330093.8,-1428,9285,10713,5671.593119,2112.148753
Cell 10 2011/12,8250,4009,215222724,-1005,9882,10887,5092.72462,2687.880162
Cell 10 NE 2011/12,8250,4010,215276408.9,-1005,9882,10887,5037.871322,2668.805454
Cell 10 NW 2011/12,8250,4009,215222724,-1836,9804,11640,5451.42654,2309.369633
Cell 10 SE 2013,8250,4008,215169039.1,614,9804,9190,6025.355539,2439.788856
Cell 10 SW 2011/12,8250,4018,215705888,-1005,9882,10887,5216.300647,2697.785939
Cell 10-A 2011/12,8250,4016,215598518.2,-1005,9882,10887,4867.507968,2770.240431
Cell 11 NE 2011/12,8250,4012,215383778.7,-92,9804,9896,5968.080508,2487.430596
Cell 11 NW 2013,8250,4009,215222724,-1958,9292,11250,6507.426041,1864.876048
Cell 11 SW 2013,8250,4009,215222724,674,9287,8613,6311.440509,2185.569349
Cell 12 2013,8250,4010,215276408.9,1373,9571,8198,6213.602244,2145.392672
Cell 13 2013,8250,4014,215491148.5,1806,8710,6904,7263.408819,1245.528865
Cell 14 2013,8250,4011,215330093.8,2161,8863,6702,7761.447769,855.865089
Cell 15 2013,8250,4008,215169039.1,4961,8963,4002,8015.223303,457.6847901
Cell 15-A 2013,8250,4016,215598518.2,5061,8963,3902,8034.791086,410.8057091
Cell 16 2013,8250,4014,215491148.5,5848,8963,3115,7998.868959,413.7801099
Cell 17 NW 2011/12,8250,4009,215222724,-908,9823,10731,6017.758793,2376.803342
Cell 17 NW 2013,8250,4014,215491148.5,-1836,9972,11808,5357.96288,2252.338835
Cell 17 SE 2013,8250,4008,215169039.1,-1836,9804,11640,5451.091317,2309.560181
Cell 17 SW 2013,8250,4013,215437463.6,-1836,9972,11808,5597.010217,2156.258973
Cell 18 2011/12,8250,4010,215276408.9,705,9950,9245,4858.611222,2538.507834
Cell 18 NE 2013,8250,4010,215276408.9,-92,9804,9896,5986.035411,2604.61041
Cell 18 NW 2013,8250,4010,215276408.9,-1428,9804,11232,5200.340898,2592.065312
Cell 18 SE 2013,8250,4013,215437463.6,-92,9804,9896,5967.843509,2487.165958
Cell 18 SSE 2013,8250,4006,215061669.3,-92,9787,9879,6079.556415,2447.821799
Cell 19 NW 2013,8250,4010,215276408.9,1036,9787,8751,6348.957357,2225.852383
Cell 2 2011/12,8250,4010,215276408.9,-1958,9292,11250,6381.171571,1966.424487
Cell 2 NE 2013,8250,4011,215330093.8,-1958,9292,11250,6628.387933,1752.734887
Cell 2 SW 2013,8250,4005,215007984.5,-1954,9513,11467,6123.41598,2074.942026
Cell 20 2013,8250,4011,215330093.8,1335,9571,8236,6367.08003,2085.445079
Cell 21 2013,8250,4010,215276408.9,1734,9552,7818,7246.221945,1329.572146
Cell 22 2013,8250,4015,215544833.3,4978,8920,3942,7988.988294,492.3032711
Cell 23 2013,8250,4010,215276408.9,5845,8920,3075,8150.439152,426.1880966
Cell 24 2013,8250,4015,215544833.3,5858,9061,3203,7973.125529,448.1935566
Cell 25 NE 2013,8250,4011,215330093.8,-1005,9882,10887,5094.148342,2687.969673
Cell 25 SE 2013,8250,4018,215705888,-1005,9882,10887,5216.300647,2697.785939
Cell 26 NE 2013,8250,4023,215974312.5,-92,9787,9879,6153.178225,2398.996123
Cell 26 NNW 2013,8250,4011,215330093.8,-1005,9882,10887,5038.542757,2668.811462
Cell 26 NW 2013,8250,4017,215652203.1,-1005,9882,10887,4866.817028,2770.241657
Cell 27 NW 2013,8250,4011,215330093.8,190,9787,9597,6209.811269,2273.510824
Cell 28 2013,8250,4023,215974312.5,705,9950,9245,4505.055183,2497.846192
Cell 29 2013,8250,4009,215222724,1172,9552,8380,6540.237715,1978.655367
Cell 3 NE 2013,8250,4006,215061669.3,-1958,9292,11250,7146.934099,1362.340034
Cell 3 NW 2013,8250,4008,215169039.1,-1958,9292,11250,6512.218563,1788.287381
Cell 30 2013,8250,4011,215330093.8,4051,8980,4929,8084.493892,477.9441713
Cell 31 2013,8250,4022,215920627.6,5623,9061,3438,8155.820239,457.838492
Cell 32 2013,8250,4017,215652203.1,5528,9032,3504,8005.608414,516.6403675
Cell 33 NE 2013,8250,4009,215222724,-908,9823,10731,6016.692193,2377.803506
Cell 33 SE 2013,8250,4024,216027997.4,-1781,9972,11753,5473.433151,2685.77303
Cell 33 SW 2013,8250,4008,215169039.1,-834,9741,10575,5137.006487,2645.92795
Cell 34 N 2013,8250,4009,215222724,457,9823,9366,6150.936144,2209.876828
Cell 34 NW 2013,8250,4007,215115354.2,-1451,9823,11274,6366.569753,2072.317092
Cell 34 SE 2013,8250,4010,215276408.9,-1781,9972,11753,5957.3798,2409.621676
Cell 35 2013,8250,4005,215007984.4,586,9950,9364,4803.325593,2569.936008
Cell 37 2013,8250,4013,215437463.6,3470,9400,5930,7925.71692,531.0032159
Cell 38 2013,8250,4020,215813257.8,6371,9036,2665,8264.705721,394.9704734
Cell 39 2013,8250,4011,215330093.8,5898,9081,3183,8201.428322,482.2484471
Cell 4 2013,8250,4012,215383778.7,1681,9270,7589,7644.847458,867.5706172
Cell 40 NE 2013,8250,4007,215115354.2,-1781,9972,11753,4902.939356,2853.328687
Cell 41 N 2013,8250,4020,215813257.8,-1781,9972,11753,5876.636567,2468.073189
Cell 41 NW 2013,8250,4006,215061669.3,-1781,9972,11753,5467.357713,2774.043993
Cell 42 NW 2013,8250,4017,215652203.1,418,9959,9541,6032.912621,2423.317855
Cell 43 2013,8250,4023,215974312.5,1175,9904,8729,6004.023614,2448.944247
Cell 44 2013,8250,4021,215866942.7,1292,9652,8360,7300.235514,1597.465775
Cell 45 2013,8250,4013,215437463.6,5543,9510,3967,8073.377523,481.384249
Cell 47 2013,8250,4010,215276408.9,853,9571,8718,6896.990524,2086.944949
Cell 48 2013,8250,4011,215330093.8,853,9841,8988,6469.825231,2291.810834
Cell 49 2013,8250,4010,215276408.9,1304,9904,8600,6833.001746,1986.224694
Cell 5 2011/12 Summer,8250,4013,215437463.6,-1836,9972,11808,5597.010217,2156.258973
Cell 5 2013,8250,4012,215383778.7,5139,8863,3724,7943.540379,387.2755917
Cell 50 2013,8250,4017,215652203.1,1375,9692,8317,7153.451332,1733.898205
Cell 51 2013,8250,4028,216242736.9,5712,9085,3373,8173.364697,403.6175091
Cell 52 2013,8250,4012,215383778.7,1375,9483,8108,6977.610668,2009.243031
Cell 53 2013,8250,4016,215598518.2,1375,9692,8317,7165.169572,1872.25855
Cell 54 2013,8250,4011,215330093.8,1998,8980,6982,7998.638494,756.2061516
Cell 55 2013,8250,4015,215544833.3,5712,9005,3293,8101.313574,506.1447167
Cell 56 2013,8250,4023,215974312.5,1430,9542,8112,6963.231916,1586.784496
Cell 57 2013,8250,4013,215437463.6,1681,8980,7299,7239.398953,1227.270468
Cell 58 2013,8250,4018,215705888,1681,8980,7299,7974.249876,1034.380963
Cell 59 2013,8250,4009,215222724,1327,9542,8215,6855.478424,1641.347186
Cell 6 2011/12,8250,4011,215330093.8,1036,9787,8751,6248.277487,2267.588812
Cell 6 2013,8250,4013,215437463.6,5647,8877,3230,8018.340145,382.0670982
Cell 6 NE 2011/12,8250,4013,215437463.6,1254,9292,8038,6275.769499,2101.016921
Cell 6 NW 2011/12,8250,4009,215222724,614,9804,9190,6024.531055,2440.042908
Cell 6 SW 2011/12,8250,4013,215437463.6,-92,9804,9896,5890.469225,2654.149005
Cell 60 2013,8250,4022,215920627.6,1894,8780,6886,6944.119095,1044.930393
Cell 61 2013,8250,4017,215652203.1,1894,8849,6955,7481.463032,1158.807852
Cell 7 2013,8250,4027,216189052,4961,9168,4207,7937.779985,538.3180197
Cell 9 NW 2013,8250,4011,215330093.8,-76,9736,9812,5163.126402,2302.747086
Cell 9 SE 2013,8250,4010,215276408.9,-1836,9804,11640,4830.636658,2356.649379
Cell 9 SW 2013,8250,4009,215222724,-1836,9736,11572,5080.36019,2311.385778
Cell R1,8250,4003,214900614.7,1080,8693,7613,5684.464652,1896.477823
Cell R10,8250,4012,215383778.7,1681,9270,7589,7644.847458,867.5706172
Cell R100,8250,4015,215544833.4,1375,9692,8317,7153.024658,1734.222085
Cell R101,8250,4012,215383778.7,1685,9692,8007,7875.582502,856.1289888
Cell R104,8250,4016,215598518.2,1301,9468,8167,7124.479333,1934.917139
Cell R105,8250,4016,215598518.2,1375,9692,8317,7165.169572,1872.25855
Cell R106,8250,4010,215276408.9,1375,9692,8317,7461.814464,1370.454158
Cell R107,8250,4010,215276408.9,1998,8980,6982,7998.536658,756.2729355
Cell R11,8250,4014,215491148.5,5139,8863,3724,7943.619581,387.3294086
Cell R111,8250,4014,215491148.5,1168,9468,8300,6745.678127,2225.281908
Cell R112,8250,4013,215437463.6,1681,8985,7304,7553.753302,999.1302884
Cell R113,8250,4012,215383778.7,1681,8980,7299,7239.371884,1227.422211
Cell R114,8250,4017,215652203.1,1681,8980,7299,7974.405029,1034.462956
Cell R117,8250,4013,215437463.6,1168,9542,8374,6380.029404,2104.996608
Cell R118,8250,4024,216027997.4,1430,9542,8112,6963.056909,1586.626149
Cell R119,8250,4015,215544833.3,1681,8980,7299,7084.52005,1229.879984
Cell R120,8250,4010,215276408.9,1841,8874,7033,7412.086783,1250.680776
Cell R121,8250,4016,215598518.2,3582,8874,5292,8126.342629,513.9423035
Cell R123,8250,4016,215598518.2,1327,9730,8403,6740.533367,1716.835256
Cell R124,8250,4012,215383778.7,1894,8780,6886,6962.263709,1041.87208
Cell R125,8250,4026,216135367.1,1894,8780,6886,6838.304769,1097.188824
Cell R126,8250,4017,215652203.1,1894,8849,6955,7291.659447,1255.382621
Cell R15,8250,4012,215383778.7,-1428,9285,10713,5671.985793,2112.031928
Cell R16,8250,4011,215330093.8,-76,9736,9812,5160.294939,2303.127786
Cell R17,8250,4009,215222724,614,9513,8899,6071.244699,2316.334261
Cell R18,8250,4020,215813257.8,-1958,9292,11250,6515.971891,1858.22803
Cell R19,8250,4011,215330093.8,1373,9571,8198,6767.000499,1777.077474
Cell R20,8250,4009,215222724,1806,8863,7057,7477.85757,1115.716567
Cell R21,8250,4010,215276408.9,1806,8863,7057,7389.624439,1275.903639
Cell R22,8250,4009,215222724,2161,8863,6702,7761.26665,855.9722839
Cell R24,8250,4013,215437463.6,-1836,9972,11808,5357.54149,2252.461234
Cell R25,8250,4011,215330093.8,-1428,9804,11232,5200.783096,2591.89344
Cell R26,8250,4010,215276408.9,614,9804,9190,6023.114963,2434.696018
Cell R27,8250,4008,215169039.1,1036,9787,8751,6349.952096,2225.181028
Cell R28,8250,4015,215544833.3,1356,9571,8215,5883.528269,2293.873557
Cell R29,8250,4010,215276408.9,1335,9571,8236,6367.997257,2084.895984
Cell R30,8250,4014,215491148.5,1872,8727,6855,7482.320877,1085.859563
Cell R31,8250,4017,215652203.1,2239,8740,6501,7716.144386,744.4775544
Cell R35,8250,4013,215437463.6,-1836,9972,11808,5597.010217,2156.258973
Cell R36,8250,4009,215222724,-1836,9804,11640,5451.42654,2309.369633
Cell R37,8250,4013,215437463.6,-92,9804,9896,5967.843509,2487.165958
Cell R38,8250,4023,215974312.5,956,9787,8831,5683.342779,2497.138041
Cell R39,8250,4008,215169039.1,1335,9552,8217,6544.023952,2048.223789
Cell R40,8250,4010,215276408.9,1734,9552,7818,7246.221945,1329.572146
Cell R46,8250,4011,215330093.8,-1005,9882,10887,5278.148342,2708.06137
Cell R47,8250,4016,215598518.2,-1005,9882,10887,4867.507968,2770.240431
Cell R48,8250,4024,216027997.4,-92,9787,9879,6153.492048,2398.780604
Cell R49,8250,4011,215330093.8,190,9787,9597,6209.811269,2273.510824
Cell R5,8250,4007,215115354.2,-1428,9210,10638,5740.036935,1947.40537
Cell R50,8250,4022,215920627.6,705,9950,9245,4505.05644,2498.156695
Cell R51,8250,4012,215383778.7,1172,9552,8380,6549.245513,1973.578193
Cell R52,8250,4015,215544833.4,2206,8914,6708,7589.982814,826.8551976
Cell R53,8250,4014,215491148.5,2213,8860,6647,7703.215745,699.4254399
Cell R54,8250,4021,215866942.7,5623,9061,3438,8155.839343,457.8938164
Cell R58,8250,4009,215222724,-1005,9693,10698,5102.978798,2736.850885
Cell R59,8250,4010,215276408.9,-908,9823,10731,6016.669576,2377.507434
Cell R6,8250,4008,215169039.1,-1954,9513,11467,6122.446357,2075.21359
Cell R60,8250,4008,215169039.1,-1451,9823,11274,6365.421906,2073.33212
Cell R61,8250,4005,215007984.4,586,9950,9364,4803.325593,2569.936008
Cell R62,8250,4012,215383778.7,540,9552,9012,5101.364158,2581.680164
Cell R63,8250,4011,215330093.8,1104,9552,8448,6257.533283,2193.372734
Cell R64,8250,4013,215437463.6,4051,8980,4929,7939.117369,552.1899666
Cell R65,8250,4011,215330093.8,4051,8980,4929,8084.493892,477.9441713
Cell R66,8250,4022,215920627.6,5623,8980,3357,8134.19269,474.4339436
Cell R69,8250,4009,215222724,-834,9741,10575,5135.812422,2646.677726
Cell R7,8250,4007,215115354.2,-1958,9292,11250,6511.836786,1788.34719
Cell R70,8250,4023,215974312.5,-1781,9972,11753,5473.090977,2686.01911
Cell R71,8250,4009,215222724,-1781,9972,11753,5956.90646,2409.735771
Cell R72,8250,4008,215169039.1,418,9959,9541,5535.328593,2567.11554
Cell R73,8250,4016,215598518.2,418,9950,9532,4684.854582,2641.178001
Cell R74,8250,4010,215276408.9,540,9400,8860,6349.61197,2377.763002
Cell R75,8250,4012,215383778.7,3470,9400,5930,7925.934447,530.890581
Cell R76,8250,4021,215866942.7,5854,8980,3126,8204.5143,380.8350602
Cell R77,8250,4021,215866942.7,6371,9036,2665,8264.839592,395.0125593
Cell R8,8250,4013,215437463.6,-1958,9292,11250,7077.469723,1409.028853
Cell R80,8250,4007,215115354.2,-1781,9972,11753,4902.939356,2853.328687
Cell R81,8250,4010,215276408.9,-1781,9972,11753,5824.495262,2566.418794
Cell R82,8250,4018,215705888,418,9959,9541,6033.319562,2423.153545
Cell R83,8250,4009,215222724,418,9571,9153,6294.882265,2434.420051
Cell R84,8250,4008,215169039.1,540,9904,9364,5691.63024,2542.880613
Cell R85,8250,4025,216081682.3,1175,9904,8729,6002.754534,2448.363215
Cell R86,8250,4013,215437463.6,1451,9629,8178,7680.136307,1135.061283
Cell R87,8250,4013,215437463.6,5543,9510,3967,8073.472963,481.3632477
Cell R9,8250,4005,215007984.4,-1958,9292,11250,7250.165293,1325.874103
Cell R90,8250,4011,215330093.8,853,9571,8718,6897.231613,2086.740628
Cell R91,8250,4011,215330093.8,853,9841,8988,6469.825231,2291.810834
Cell R92,8250,4012,215383778.7,1175,9904,8729,5696.075773,2466.631612
Cell R93,8250,4009,215222724,1304,9904,8600,6832.690945,1986.374899
Cell R97,8250,4018,215705888,1120,9427,8307,7169.223245,1889.809339
Cell R98,8250,4014,215491148.5,1336,9904,8568,6758.245142,2234.181978
Cell R99,8250,4012,215383778.7,1375,9483,8108,6977.878863,2009.364128
Cell S102,8250,4014,215491148.5,5712,9085,3373,8200.112108,401.3728855
Cell S108,8250,4013,215437463.6,5712,9005,3293,8101.433591,506.227959
Cell S13,8250,4009,215222724,5654,9168,3514,8031.544026,406.2520787
Cell S14,8250,4028,216242736.9,4961,9168,4207,7937.82001,538.2571862
Cell S2,8250,4013,215437463.6,5647,8877,3230,8018.340145,382.0670982
Cell S23,8250,4015,215544833.4,4961,8877,3916,7942.521295,459.75979
Cell S32,8250,4010,215276408.9,4978,8920,3942,7981.850873,474.6021263
Cell S33,8250,4016,215598518.2,5061,8963,3902,8034.791086,410.8057091
Cell S34,8250,4014,215491148.5,5858,9061,3203,7973.24564,448.184767
Cell S41,8250,4010,215276408.9,2206,8914,6708,7760.699501,628.1646847
Cell S42,8250,4011,215330093.8,5845,8920,3075,8150.205435,426.3918973
Cell S44,8250,4018,215705888,5645,9061,3416,7965.558985,515.159494
Cell S56,8250,4018,215705888,5505,9061,3556,7705.832753,528.0438547
Cell S67,8250,4017,215652203.1,5528,9032,3504,8005.608414,516.6403675
Cell S78,8250,4010,215276408.9,5898,9081,3183,8201.325686,482.2647695
Cell S88,8250,4016,215598518.2,4469,9081,4612,8218.212898,497.0154332
Cell S94,8250,4018,215705888,5543,9085,3542,8163.43106,444.3351898
Cell S95,8250,4025,216081682.3,5712,9085,3373,8173.653665,403.6114383
W287,8250,4010,215276408.9,894,9837,8943,4456.488279,2127.071194
W295,8250,4010,215276408.9,1465,9145,7680,6792.696509,1792.064047
W338,8250,4006,215061669.3,697,9484,8787,3681.407888,2332.849399
W342,8250,4005,215007984.4,976,8946,7970,5434.048439,2353.192791
W345,8250,4012,215383778.7,1609,8580,6971,7282.363161,1095.091397
W387,8250,4003,214900614.7,3,9470,9467,4727.536098,2319.156207
W393,8250,4010,215276408.9,728,9484,8756,5322.421446,2559.257687
W440,8250,4012,215383778.7,1073,9239,8166,5308.022682,2194.463704
W441,8250,4009,215222724,1101,9239,8138,6281.70217,1777.932671
W445,8250,4008,215169039.1,2175,8898,6723,6812.218064,997.6426253
W500,8250,4005,215007984.5,1196,8598,7402,6365.696629,1651.474723
1,8500,4256,228482891.8,-1954,9513,11467,6095.145207,2081.88418
2,8500,4252,228268152.3,-1958,9292,11250,6389.376294,1978.715395
3,8500,4261,228751316.3,-1067,9571,10638,7086.360244,1566.085924
4,8500,4266,229019740.7,1806,9498,7692,7479.951008,1112.034362
5,8500,4259,228643946.5,-1836,9972,11808,5547.737732,2188.16577
6,8500,4254,228375522.1,1036,9787,8751,6214.755759,2271.232295
7,8500,4256,228482891.8,1373,9571,8198,6213.128759,2132.784777
8,8500,4263,228858686.1,1806,8727,6921,7292.646962,1222.828067
9,8500,4266,229019740.7,4978,8920,3942,7970.292077,482.3786585
10,8500,4254,228375522.1,-1005,9882,10887,5090.389986,2686.796546
11,8500,4261,228751316.3,-92,9787,9879,6173.8092,2386.494431
12,8500,4266,229019740.7,705,9950,9245,4516.97023,2492.678073
13,8500,4263,228858686.1,1172,9552,8380,6494.033544,2016.301369
14,8500,4263,228858686.1,4902,9061,4159,8116.583157,462.480347
16,8500,4261,228751316.3,-834,9741,10575,5071.884299,2651.773476
17,8500,4261,228751316.3,-1781,9823,11604,6342.552218,2098.810534
18,8500,4250,228160782.5,705,9950,9245,4884.041176,2533.942161
19,8500,4260,228697631.4,540,9950,9410,5154.646009,2569.771086
20,8500,4272,229341850.1,1825,9400,7575,7909.841994,581.5397923
21,8500,4258,228590261.6,6371,9036,2665,8263.031705,399.5741811
22,8500,4254,228375522.1,-1781,9972,11753,4865.685472,2887.482799
23,8500,4255,228429206.9,418,9959,9541,6085.800705,2407.870888
24,8500,4264,228912371,853,9904,9051,6432.231707,2315.425605
25,8500,4258,228590261.6,1304,9904,8600,6830.969469,1991.690327
26,8500,4261,228751316.3,2307,9510,7203,8072.80521,499.2838717
27,8500,4262,228805001.2,1330,9904,8574,6697.989676,2264.98022
28,8500,4260,228697631.4,1301,9692,8391,7130.776526,1906.217189
29,8500,4268,229127110.5,1375,9692,8317,7149.966026,1747.636892
31,8500,4257,228536576.7,1197,9468,8271,7126.969697,1792.067803
32,8500,4261,228751316.3,1681,8980,7299,7246.439099,1221.190316
33,8500,4263,228858686.1,1421,9542,8121,6943.13019,1621.576671
34,8500,4256,228482891.8,1894,8780,6886,6941.227444,1073.362192
10A,8500,4261,228751316.3,-1005,9882,10887,4916.22131,2765.715679
10NE,8500,4264,228912371,-1005,9882,10887,5069.152205,2684.948153
10NW,8500,4257,228536576.7,-1836,9882,11718,5476.601832,2310.539395
10SW,8500,4258,228590261.6,-1005,9882,10887,5187.402302,2704.214618
11NE,8500,4249,228107097.6,-92,9804,9896,5936.838786,2486.437258
11NW,8500,4263,228858686.1,-92,9804,9896,6038.976542,2467.216965
11SE,8500,4255,228429206.9,-92,9787,9879,6210.910458,2279.992967
17NW,8500,4255,228429206.9,-908,9823,10731,5975.996945,2393.130337
17SE,8500,4255,228429206.9,-1781,9972,11753,5970.619506,2402.774732
17SW,8500,4261,228751316.3,-1781,9972,11753,5443.135414,2686.681921
22S,8500,4259,228643946.5,-1781,9972,11753,4755.629256,2888.390304
23S,8500,4266,229019740.7,1111,9571,8460,5008.023207,2382.999743
24S,8500,4259,228643946.5,853,9904,9051,6428.991078,2316.304141
27A,8500,4263,228858686.1,1029,9427,8398,7051.87239,1979.661132
2A,8500,4262,228805001.2,-1958,9292,11250,6609.152041,1805.451495
5NE,8500,4257,228536576.7,-1836,9804,11640,4881.190275,2349.064649
5NW,8500,4249,228107097.6,-1836,9736,11572,5082.763003,2315.522278
5SE,8500,4260,228697631.4,-1428,9804,11232,5265.911033,2596.76488
6NE,8500,4255,228429206.9,1242,9292,8050,6191.635488,2141.559023
6NW,8500,4253,228321837.2,614,9804,9190,6030.982365,2419.612214
6SW,8500,4258,228590261.6,-92,9804,9896,5833.629873,2656.84131
Cell 1 2011/12,8500,4256,228482891.8,-1954,9513,11467,6095.145207,2081.88418
Cell 1 SW 2013,8500,4260,228697631.4,-1428,9285,10713,5689.371362,2102.499016
Cell 10 2011/12,8500,4254,228375522.1,-1005,9882,10887,5090.389986,2686.796546
Cell 10 NE 2011/12,8500,4264,228912371,-1005,9882,10887,5069.152205,2684.948153
Cell 10 NW 2011/12,8500,4257,228536576.7,-1836,9882,11718,5476.601832,2310.539395
Cell 10 SE 2013,8500,4252,228268152.3,614,9804,9190,6030.907338,2419.891777
Cell 10 SW 2011/12,8500,4258,228590261.6,-1005,9882,10887,5187.402302,2704.214618
Cell 10-A 2011/12,8500,4261,228751316.3,-1005,9882,10887,4916.22131,2765.715679
Cell 11 NE 2011/12,8500,4249,228107097.6,-92,9804,9896,5936.838786,2486.437258
Cell 11 NW 2013,8500,4262,228805001.2,-1958,9292,11250,6527.263022,1872.864907
Cell 11 SW 2013,8500,4266,229019740.7,674,9287,8613,6243.053915,2215.413213
Cell 12 2013,8500,4258,228590261.6,1373,9571,8198,6212.213715,2132.619961
Cell 13 2013,8500,4268,229127110.5,1806,8727,6921,7290.805061,1221.501478
Cell 14 2013,8500,4266,229019740.7,1872,8863,6991,7748.390764,884.9927236
Cell 15 2013,8500,4262,228805001.2,4961,8963,4002,8018.852417,458.8485313
Cell 15-A 2013,8500,4264,228912371,5061,8963,3902,8037.09076,419.5391484
Cell 16 2013,8500,4259,228643946.5,5848,8963,3115,7997.630899,413.3259857
Cell 17 NW 2011/12,8500,4255,228429206.9,-908,9823,10731,5975.996945,2393.130337
Cell 17 NW 2013,8500,4248,228053412.7,-1836,9972,11808,5324.289548,2265.761038
Cell 17 SE 2013,8500,4258,228590261.6,-1836,9882,11718,5475.56294,2311.262227
Cell 17 SW 2013,8500,4260,228697631.4,-1836,9972,11808,5549.146948,2188.742571
Cell 18 2011/12,8500,4250,228160782.5,705,9950,9245,4884.041176,2533.942161
Cell 18 NE 2013,8500,4262,228805001.2,-92,9804,9896,5914.967855,2621.78599
Cell 18 NW 2013,8500,4247,227999727.8,-1428,9804,11232,5249.926065,2587.827232
Cell 18 SE 2013,8500,4249,228107097.6,-92,9804,9896,5936.838786,2486.437258
Cell 18 SSE 2013,8500,4254,228375522.1,-92,9804,9896,6111.485661,2435.472402
Cell 19 NW 2013,8500,4257,228536576.7,1036,9787,8751,6324.448673,2236.809071
Cell 2 2011/12,8500,4252,228268152.3,-1958,9292,11250,6389.376294,1978.715395
Cell 2 NE 2013,8500,4260,228697631.4,-1958,9292,11250,6622.849531,1753.069304
Cell 2 SW 2013,8500,4251,228214467.4,-1954,9513,11467,6096.731828,2081.738841
Cell 20 2013,8500,4265,228966055.8,1335,9571,8236,6325.022978,2100.249945
Cell 21 2013,8500,4267,229073425.6,1650,9552,7902,7204.125146,1376.536658
Cell 22 2013,8500,4264,228912371,4978,8920,3942,7990.62969,487.8883781
Cell 23 2013,8500,4257,228536576.7,5619,8962,3343,8136.569415,432.6611944
Cell 24 2013,8500,4256,228482891.8,5754,9061,3307,7971.0625,456.3226977
Cell 25 NE 2013,8500,4252,228268152.3,-1005,9882,10887,5089.209548,2686.831125
Cell 25 SE 2013,8500,4258,228590261.6,-1005,9882,10887,5187.248708,2704.418817
Cell 26 NE 2013,8500,4261,228751316.3,-92,9787,9879,6173.8092,2386.494431
Cell 26 NNW 2013,8500,4263,228858686.1,-1005,9882,10887,5070.903824,2684.605542
Cell 26 NW 2013,8500,4261,228751316.3,-1005,9882,10887,4916.22131,2765.715679
Cell 27 NW 2013,8500,4254,228375522.1,-92,9787,9879,6211.609779,2279.804602
Cell 28 2013,8500,4266,229019740.7,705,9950,9245,4516.97023,2492.678073
Cell 29 2013,8500,4264,228912371,1172,9552,8380,6492.560976,2017.728131
Cell 3 NE 2013,8500,4261,228751316.3,-1958,9292,11250,7123.402018,1394.128504
Cell 3 NW 2013,8500,4255,228429206.9,-1958,9292,11250,6510.273561,1786.15762
Cell 30 2013,8500,4256,228482891.8,4051,8980,4929,8081.788299,473.664976
Cell 31 2013,8500,4265,228966055.8,5623,9061,3438,8158.783587,457.3391223
Cell 32 2013,8500,4265,228966055.8,5505,9032,3527,8005.002814,514.8276894
Cell 33 NE 2013,8500,4255,228429206.9,-908,9823,10731,5975.996945,2393.130337
Cell 33 SE 2013,8500,4260,228697631.4,-1781,9972,11753,5441.853521,2687.714543
Cell 33 SW 2013,8500,4265,228966055.8,-834,9741,10575,5097.818992,2655.851585
Cell 34 N 2013,8500,4265,228966055.8,457,9823,9366,6133.455334,2217.937362
Cell 34 NW 2013,8500,4260,228697631.4,-1781,9823,11604,6342.32277,2099.003423
Cell 34 SE 2013,8500,4260,228697631.4,-1781,9972,11753,5971.002817,2402.668336
Cell 35 2013,8500,4258,228590261.6,418,9950,9532,4819.133396,2560.085494
Cell 37 2013,8500,4257,228536576.7,1825,9400,7575,7913.312427,573.7406301
Cell 38 2013,8500,4263,228858686.1,6371,9036,2665,8265.34647,398.6795833
Cell 39 2013,8500,4270,229234480.3,5898,9081,3183,8193.862998,481.6207023
Cell 4 2013,8500,4258,228590261.6,1653,9270,7617,7607.248004,949.2847316
Cell 40 NE 2013,8500,4253,228321837.2,-1781,9972,11753,4930.047966,2837.724013
Cell 41 N 2013,8500,4262,228805001.2,-1781,9972,11753,5817.795167,2489.227509
Cell 41 NW 2013,8500,4258,228590261.6,-1781,9972,11753,5429.711837,2790.704032
Cell 42 NW 2013,8500,4260,228697631.4,418,9959,9541,6076.319953,2407.614654
Cell 43 2013,8500,4264,228912371,1175,9904,8729,5994.348265,2463.059012
Cell 44 2013,8500,4264,228912371,1292,9652,8360,7256.616088,1649.513822
Cell 45 2013,8500,4257,228536576.7,2307,9510,7203,8073.407564,498.8579087
Cell 47 2013,8500,4266,229019740.7,853,9571,8718,6866.206282,2097.486579
Cell 48 2013,8500,4259,228643946.5,853,9904,9051,6428.598967,2316.032539
Cell 49 2013,8500,4258,228590261.6,1304,9904,8600,6830.969469,1991.690327
Cell 5 2011/12 Summer,8500,4260,228697631.4,-1836,9972,11808,5549.146948,2188.742571
Cell 5 2013,8500,4258,228590261.6,4424,8863,4439,7938.661343,405.6833566
Cell 50 2013,8500,4269,229180795.4,1375,9692,8317,7150.110096,1747.457538
Cell 51 2013,8500,4268,229127110.5,5712,9085,3373,8168.040769,407.8586344
Cell 52 2013,8500,4271,229288165.2,1375,9483,8108,6903.373917,2061.424215
Cell 53 2013,8500,4262,228805001.2,1301,9692,8391,7129.883857,1907.273339
Cell 54 2013,8500,4257,228536576.7,1681,9005,7324,7991.385718,777.8252303
Cell 55 2013,8500,4265,228966055.8,5712,9005,3293,8094.650645,504.4173581
Cell 56 2013,8500,4267,229073425.6,1421,9542,8121,6942.075932,1622.963726
Cell 57 2013,8500,4255,228429206.9,1681,8980,7299,7245.964982,1221.761153
Cell 58 2013,8500,4263,228858686.1,1681,8980,7299,7949.767535,1036.835862
Cell 59 2013,8500,4252,228268152.3,1327,9542,8215,6819.648401,1680.091013
Cell 6 2011/12,8500,4254,228375522.1,1036,9787,8751,6214.755759,2271.232295
Cell 6 2013,8500,4255,228429206.9,5597,8877,3280,8014.024442,391.6184945
Cell 6 NE 2011/12,8500,4255,228429206.9,1242,9292,8050,6191.635488,2141.559023
Cell 6 NW 2011/12,8500,4253,228321837.2,614,9804,9190,6030.982365,2419.612214
Cell 6 SW 2011/12,8500,4258,228590261.6,-92,9804,9896,5833.629873,2656.84131
Cell 60 2013,8500,4263,228858686.1,1894,8780,6886,6961.197279,1037.727972
Cell 61 2013,8500,4258,228590261.6,1894,8867,6973,7469.1752,1181.313497
Cell 7 2013,8500,4264,228912371,4961,9168,4207,7944.153612,533.765228
Cell 9 NW 2013,8500,4254,228375522.1,-128,9736,9864,5194.059003,2299.91399
Cell 9 SE 2013,8500,4257,228536576.7,-1836,9804,11640,4880.383134,2348.810641
Cell 9 SW 2013,8500,4250,228160782.5,-1836,9736,11572,5081.256235,2315.196376
Cell R1,8500,4253,228321837.2,1080,8693,7613,5681.227839,1891.426526
Cell R10,8500,4257,228536576.7,1653,9270,7617,7607.186516,949.3877438
Cell R100,8500,4268,229127110.5,1375,9692,8317,7149.656748,1747.411208
Cell R101,8500,4260,228697631.4,1685,9692,8007,7838.920188,924.8512197
Cell R104,8500,4261,228751316.3,1301,9468,8167,7136.585778,1911.225914
Cell R105,8500,4262,228805001.2,1301,9692,8391,7129.883857,1907.273339
Cell R106,8500,4256,228482891.8,1375,9692,8317,7470.120066,1360.370389
Cell R107,8500,4257,228536576.7,1681,9005,7324,7991.385718,777.8252303
Cell R11,8500,4260,228697631.4,4424,8863,4439,7938.641315,405.5896542
Cell R111,8500,4261,228751316.3,1168,9468,8300,6748.599155,2213.083519
Cell R112,8500,4264,228912371,1681,8985,7304,7537.027908,1016.522059
Cell R113,8500,4255,228429206.9,1681,8980,7299,7245.872385,1221.753038
Cell R114,8500,4264,228912371,1681,8980,7299,7949.766886,1036.714276
Cell R117,8500,4254,228375522.1,1168,9542,8374,6391.972732,2104.514036
Cell R118,8500,4266,229019740.7,1421,9542,8121,6941.765823,1623.027527
Cell R119,8500,4259,228643946.5,1681,8980,7299,7105.639117,1219.052384
Cell R120,8500,4262,228805001.2,1841,8874,7033,7411.568512,1262.175469
Cell R121,8500,4264,228912371,3582,8955,5373,8112.644231,542.7853227
Cell R123,8500,4258,228590261.6,1327,9889,8562,6733.084077,1736.315192
Cell R124,8500,4267,229073425.6,1894,8780,6886,6973.876728,1036.316102
Cell R125,8500,4268,229127110.5,1894,8780,6886,6840.050843,1093.94465
Cell R126,8500,4271,229288165.2,1894,8849,6955,7298.00679,1251.216248
Cell R15,8500,4260,228697631.4,-1428,9285,10713,5689.371362,2102.499016
Cell R16,8500,4251,228214467.4,-128,9736,9864,5195.700306,2300.512204
Cell R17,8500,4261,228751316.3,614,9513,8899,6069.940859,2307.75515
Cell R18,8500,4264,228912371,-1958,9292,11250,6535.939259,1864.88601
Cell R19,8500,4253,228321837.2,1373,9571,8198,6762.070068,1773.519946
Cell R20,8500,4263,228858686.1,1806,8863,7057,7488.029322,1109.118772
Cell R21,8500,4267,229073425.6,1806,8863,7057,7414.023201,1253.374198
Cell R22,8500,4266,229019740.7,1872,8863,6991,7748.390764,884.9927236
Cell R24,8500,4248,228053412.7,-1836,9972,11808,5323.126412,2266.223629
Cell R25,8500,4247,227999727.8,-1428,9804,11232,5249.926065,2587.827232
Cell R26,8500,4261,228751316.3,614,9804,9190,6030.307674,2419.756949
Cell R27,8500,4257,228536576.7,1036,9787,8751,6324.448673,2236.809071
Cell R28,8500,4258,228590261.6,1356,9571,8215,5867.453969,2290.942586
Cell R29,8500,4265,228966055.8,1335,9571,8236,6325.022978,2100.249945
Cell R30,8500,4264,228912371,1806,8727,6921,7474.731942,1107.519025
Cell R31,8500,4262,228805001.2,2239,8740,6501,7710.535195,770.2769338
Cell R35,8500,4261,228751316.3,-1836,9972,11808,5549.710397,2188.794689
Cell R36,8500,4257,228536576.7,-1836,9882,11718,5476.601832,2310.539395
Cell R37,8500,4248,228053412.7,-92,9804,9896,5936.695621,2486.71239
Cell R38,8500,4259,228643946.5,956,9787,8831,5669.12139,2500.59325
Cell R39,8500,4256,228482891.8,1335,9552,8217,6500.93844,2072.466263
Cell R40,8500,4268,229127110.5,1650,9552,7902,7204.118791,1376.375449
Cell R46,8500,4260,228697631.4,-1005,9882,10887,5275.300235,2706.290267
Cell R47,8500,4261,228751316.3,-1005,9882,10887,4916.22131,2765.715679
Cell R48,8500,4260,228697631.4,-92,9787,9879,6174.084507,2386.706862
Cell R49,8500,4254,228375522.1,-92,9787,9879,6211.609779,2279.804602
Cell R5,8500,4250,228160782.5,-1428,9210,10638,5723.308471,1953.019704
Cell R50,8500,4266,229019740.7,705,9950,9245,4516.97023,2492.678073
Cell R51,8500,4263,228858686.1,1172,9552,8380,6505.350927,2008.605076
Cell R52,8500,4268,229127110.5,2206,8914,6708,7603.575211,811.9441911
Cell R53,8500,4261,228751316.3,2206,8860,6654,7704.725886,718.7199105
Cell R54,8500,4266,229019740.7,5623,9061,3438,8158.811064,457.2890371
Cell R58,8500,4257,228536576.7,-1005,9693,10698,5115.947616,2734.022467
Cell R59,8500,4255,228429206.9,-908,9823,10731,5975.996945,2393.130337
Cell R6,8500,4251,228214467.4,-1954,9513,11467,6096.731828,2081.738841
Cell R60,8500,4261,228751316.3,-1781,9823,11604,6343.348744,2098.714154
Cell R61,8500,4258,228590261.6,418,9950,9532,4819.133396,2560.085494
Cell R62,8500,4265,228966055.8,540,9950,9410,5152.16272,2583.625557
Cell R63,8500,4264,228912371,1104,9552,8448,6225.810741,2220.422166
Cell R64,8500,4264,228912371,4051,8980,4929,7939.863977,554.239844
Cell R65,8500,4256,228482891.8,4051,8980,4929,8081.788299,473.664976
Cell R66,8500,4265,228966055.8,5623,8980,3357,8127.535756,468.7504086
Cell R69,8500,4264,228912371,-834,9741,10575,5097.992026,2656.138956
Cell R7,8500,4255,228429206.9,-1958,9292,11250,6510.273561,1786.15762
Cell R70,8500,4260,228697631.4,-1781,9972,11753,5441.853521,2687.714543
Cell R71,8500,4260,228697631.4,-1781,9972,11753,5972.298357,2401.867936
Cell R72,8500,4261,228751316.3,418,9959,9541,5537.444731,2573.45125
Cell R73,8500,4262,228805001.2,418,9950,9532,4684.185594,2631.471758
Cell R74,8500,4258,228590261.6,540,9400,8860,6344.774307,2376.605429
Cell R75,8500,4257,228536576.7,1825,9400,7575,7913.312427,573.7406301
Cell R76,8500,4265,228966055.8,5854,8980,3126,8195.712075,381.016945
Cell R77,8500,4264,228912371,6371,9036,2665,8265.449343,398.6960163
Cell R8,8500,4258,228590261.6,-1958,9292,11250,7058.388915,1428.457383
Cell R80,8500,4254,228375522.1,-1781,9972,11753,4930.589563,2837.610284
Cell R81,8500,4257,228536576.7,-1781,9972,11753,5779.080808,2581.552864
Cell R82,8500,4260,228697631.4,418,9959,9541,6076.319953,2407.614654
Cell R83,8500,4263,228858686.1,418,9571,9153,6326.814919,2415.370031
Cell R84,8500,4257,228536576.7,540,9904,9364,5729.929058,2542.972911
Cell R85,8500,4264,228912371,1175,9904,8729,5994.348265,2463.059012
Cell R86,8500,4260,228697631.4,1451,9629,8178,7662.890141,1193.565126
Cell R87,8500,4257,228536576.7,2307,9510,7203,8073.407564,498.8579087
Cell R9,8500,4257,228536576.7,-1958,9292,11250,7253.543105,1325.311685
Cell R90,8500,4267,229073425.6,853,9571,8718,6866.513476,2097.336759
Cell R91,8500,4259,228643946.5,853,9904,9051,6428.598967,2316.032539
Cell R92,8500,4266,229019740.7,1175,9904,8729,5778.057431,2440.050422
Cell R93,8500,4258,228590261.6,1304,9904,8600,6830.969469,1991.690327
Cell R97,8500,4265,228966055.8,1120,9427,8307,7162.849472,1898.329273
Cell R98,8500,4262,228805001.2,1330,9904,8574,6697.83787,2265.009872
Cell R99,8500,4271,229288165.2,1375,9483,8108,6903.373917,2061.424215
Cell S102,8500,4264,228912371,5712,9085,3373,8197.466463,402.7189187
Cell S108,8500,4266,229019740.7,5712,9005,3293,8094.500234,504.4538794
Cell S13,8500,4268,229127110.5,5654,9168,3514,8037.293814,403.5518905
Cell S14,8500,4265,228966055.8,4961,9168,4207,7944.133177,533.7043173
Cell S2,8500,4255,228429206.9,5597,8877,3280,8014.024442,391.6184945
Cell S23,8500,4261,228751316.3,4961,8877,3916,7937.851443,460.8308153
Cell S32,8500,4268,229127110.5,4978,8920,3942,7981.730787,473.6035136
Cell S33,8500,4264,228912371,5061,8963,3902,8037.140244,419.6005226
Cell S34,8500,4256,228482891.8,5754,9061,3307,7971.0625,456.3226977
Cell S41,8500,4267,229073425.6,2206,8914,6708,7744.837356,666.677669
Cell S42,8500,4257,228536576.7,5619,8962,3343,8136.569415,432.6611944
Cell S44,8500,4264,228912371,5645,9061,3416,7967.595919,513.70551
Cell S56,8500,4272,229341850.1,5505,9061,3556,7712.397004,528.7761926
Cell S67,8500,4264,228912371,5505,9032,3527,8005.004221,514.8880468
Cell S78,8500,4269,229180795.4,5898,9081,3183,8193.812368,481.6657461
Cell S88,8500,4265,228966055.8,4469,9081,4612,8211.843142,507.5980188
Cell S94,8500,4263,228858686.1,5543,9085,3542,8151.425053,456.0992809
Cell S95,8500,4268,229127110.5,5712,9085,3373,8168.040769,407.8586344
W287,8500,4263,228858686.1,894,9837,8943,4526.174056,2136.692165
W295,8500,4257,228536576.7,1465,9145,7680,6768.352831,1821.774119
W338,8500,4252,228268152.3,697,9484,8787,3708.97413,2331.792203
W342,8500,4254,228375522.1,894,8946,8052,5445.251293,2354.045781
W345,8500,4256,228482891.8,1609,8580,6971,7254.159539,1130.543232
W387,8500,4253,228321837.2,3,9470,9467,4717.813543,2316.847958
W393,8500,4251,228214467.4,728,9484,8756,5324.616561,2560.328955
W440,8500,4257,228536576.7,1073,9239,8166,5288.389476,2198.630659
W441,8500,4256,228482891.8,1101,9239,8138,6230.458647,1812.797119
W445,8500,4251,228214467.4,2175,8898,6723,6818.701952,992.0495738
W500,8500,4258,228590261.6,1196,8598,7402,6386.951855,1632.809473
1,8750,4514,242333593.5,-1954,9513,11467,6072.440186,2081.716237
2,8750,4514,242333593.5,-1958,9292,11250,6399.600576,1977.235922
3,8750,4512,242226223.7,-1067,9571,10638,7082.245567,1564.801308
4,8750,4514,242333593.5,1806,9498,7692,7478.685866,1117.642945
5,8750,4506,241904114.3,-1836,9972,11808,5508.776298,2215.327011
6,8750,4511,242172538.8,1036,9787,8751,6182.3589,2280.888207
7,8750,4514,242333593.5,1373,9571,8198,6208.89455,2127.861816
8,8750,4516,242440963.2,1806,8727,6921,7317.708149,1200.618528
9,8750,4511,242172538.8,4978,8920,3942,7968.614498,482.3534158
10,8750,4510,242118853.9,-1005,9882,10887,5094.713082,2681.353486
11,8750,4519,242602017.9,-92,9787,9879,6183.051118,2376.131191
12,8750,4520,242655702.8,705,9950,9245,4550.532743,2485.715353
13,8750,4517,242494648.1,1172,9552,8380,6449.802745,2051.901279
14,8750,4518,242548333,4902,9061,4159,8112.038291,470.5811333
16,8750,4520,242655702.8,-834,9741,10575,5048.185841,2666.725719
17,8750,4512,242226223.7,-1781,9823,11604,6305.931516,2134.722619
18,8750,4510,242118853.9,705,9950,9245,4919.22439,2526.167962
19,8750,4518,242548333,540,9950,9410,5207.124391,2569.248246
20,8750,4515,242387278.4,1473,9400,7927,7886.635659,664.689548
21,8750,4517,242494648.1,6371,9059,2688,8264.438787,400.6300126
22,8750,4510,242118853.9,-1781,9972,11753,4894.509978,2881.897569
23,8750,4501,241635689.9,418,9959,9541,6127.022217,2391.375324
24,8750,4517,242494648.1,853,9904,9051,6388.359309,2330.831275
25,8750,4503,241743059.7,1304,9904,8600,6817.004886,2011.978426
26,8750,4511,242172538.8,2095,9510,7415,8066.368876,545.4456428
27,8750,4516,242440963.2,1175,9904,8729,6648.033215,2285.491885
28,8750,4516,242440963.2,1301,9692,8391,7103.010407,1936.271246
29,8750,4521,242709387.7,1375,9692,8317,7157.56514,1748.837023
31,8750,4513,242279908.6,1197,9468,8271,7089.926878,1818.08804
32,8750,4519,242602017.9,1681,8980,7299,7255.27152,1208.36417
33,8750,4519,242602017.9,1327,9542,8215,6917.682673,1668.021547
34,8750,4512,242226223.7,1841,8780,6939,6941.677305,1094.589177
10A,8750,4519,242602017.9,-1005,9882,10887,4974.160212,2758.058032
10NE,8750,4511,242172538.8,-1005,9882,10887,5112.415651,2691.414998
10NW,8750,4508,242011484.1,-1836,9972,11808,5499.558563,2313.81066
10SW,8750,4520,242655702.8,-1005,9882,10887,5166.20531,2707.651627
11NE,8750,4507,241957799.2,-92,9804,9896,5904.803417,2490.682892
11NW,8750,4514,242333593.5,-92,9804,9896,6052.579087,2460.180064
11SE,8750,4508,242011484.1,-92,9787,9879,6197.537933,2289.757178
17NW,8750,4506,241904114.3,-908,9823,10731,5920.224811,2415.442879
17SE,8750,4515,242387278.4,-1781,9972,11753,5980.363898,2396.012487
17SW,8750,4519,242602017.9,-1781,9972,11753,5404.570923,2689.188024
22S,8750,4506,241904114.3,-1781,9972,11753,4798.582335,2878.636825
23S,8750,4521,242709387.7,1111,9571,8460,5096.881885,2384.913606
24S,8750,4512,242226223.7,853,9904,9051,6382.205009,2335.415933
27A,8750,4516,242440963.2,1029,9427,8398,7064.367803,1976.239135
2A,8750,4513,242279908.6,-1958,9292,11250,6632.324396,1815.804937
5NE,8750,4510,242118853.9,-1836,9804,11640,4935.354324,2344.348376
5NW,8750,4513,242279908.6,-1836,9804,11640,5090.805451,2322.534077
5SE,8750,4517,242494648.1,-1428,9804,11232,5315.125304,2589.477904
6NE,8750,4503,241743059.7,1242,9292,8050,6111.474573,2176.769538
6NW,8750,4502,241689374.8,614,9804,9190,6023.531542,2413.380408
6SW,8750,4509,242065169,-92,9804,9896,5789.359725,2653.583805
Cell 1 2011/12,8750,4514,242333593.5,-1954,9513,11467,6072.440186,2081.716237
Cell 1 SW 2013,8750,4517,242494648.1,-1428,9285,10713,5707.461147,2091.582449
Cell 10 2011/12,8750,4510,242118853.9,-1005,9882,10887,5094.713082,2681.353486
Cell 10 NE 2011/12,8750,4511,242172538.8,-1005,9882,10887,5112.415651,2691.414998
Cell 10 NW 2011/12,8750,4508,242011484.1,-1836,9972,11808,5499.558563,2313.81066
Cell 10 SE 2013,8750,4504,241796744.6,614,9804,9190,6022.613677,2413.360945
Cell 10 SW 2011/12,8750,4520,242655702.8,-1005,9882,10887,5166.20531,2707.651627
Cell 10-A 2011/12,8750,4519,242602017.9,-1005,9882,10887,4974.160212,2758.058032
Cell 11 NE 2011/12,8750,4507,241957799.2,-92,9804,9896,5904.803417,2490.682892
Cell 11 NW 2013,8750,4512,242226223.7,-1958,9292,11250,6544.040115,1880.424085
Cell 11 SW 2013,8750,4510,242118853.9,674,9287,8613,6190.288914,2233.927221
Cell 12 2013,8750,4510,242118853.9,1373,9571,8198,6207.62816,2129.096885
Cell 13 2013,8750,4512,242226223.7,1806,8727,6921,7315.292996,1199.080809
Cell 14 2013,8750,4515,242387278.4,1872,8863,6991,7737.0299,922.9968188
Cell 15 2013,8750,4519,242602017.9,4961,8963,4002,8023.176588,458.0229233
Cell 15-A 2013,8750,4517,242494648.1,5061,8963,3902,8039.104273,424.6370657
Cell 16 2013,8750,4514,242333593.5,5848,8963,3115,7997.531901,413.3067533
Cell 17 NW 2011/12,8750,4506,241904114.3,-908,9823,10731,5920.224811,2415.442879
Cell 17 NW 2013,8750,4504,241796744.6,-1836,9972,11808,5295.152975,2284.612079
Cell 17 SE 2013,8750,4508,242011484.1,-1836,9972,11808,5499.558563,2313.81066
Cell 17 SW 2013,8750,4514,242333593.5,-1836,9972,11808,5510.437306,2215.264932
Cell 18 2011/12,8750,4510,242118853.9,705,9950,9245,4919.22439,2526.167962
Cell 18 NE 2013,8750,4514,242333593.5,-92,9804,9896,5850.229508,2628.819657
Cell 18 NW 2013,8750,4505,241850429.5,-1836,9804,11640,5295.247503,2586.396486
Cell 18 SE 2013,8750,4507,241957799.2,-92,9804,9896,5904.803417,2490.682892
Cell 18 SSE 2013,8750,4514,242333593.5,-92,9804,9896,6120.125166,2423.416097
Cell 19 NW 2013,8750,4511,242172538.8,1036,9787,8751,6305.483263,2242.071107
Cell 2 2011/12,8750,4514,242333593.5,-1958,9292,11250,6399.600576,1977.235922
Cell 2 NE 2013,8750,4505,241850429.5,-1958,9292,11250,6615.621532,1757.990501
Cell 2 SW 2013,8750,4514,242333593.5,-1954,9513,11467,6071.928002,2081.672129
Cell 20 2013,8750,4515,242387278.4,1335,9571,8236,6275.480399,2121.634781
Cell 21 2013,8750,4514,242333593.5,1499,9552,8053,7167.163713,1417.519842
Cell 22 2013,8750,4514,242333593.5,4978,8920,3942,7990.154409,484.6222523
Cell 23 2013,8750,4505,241850429.5,5619,9061,3442,8124.980022,438.5308684
Cell 24 2013,8750,4516,242440963.2,5706,9061,3355,7964.858503,469.9974225
Cell 25 NE 2013,8750,4510,242118853.9,-1005,9882,10887,5094.713082,2681.353486
Cell 25 SE 2013,8750,4520,242655702.8,-1005,9882,10887,5166.20531,2707.651627
Cell 26 NE 2013,8750,4519,242602017.9,-92,9787,9879,6183.051118,2376.131191
Cell 26 NNW 2013,8750,4512,242226223.7,-1005,9882,10887,5112.943041,2691.349838
Cell 26 NW 2013,8750,4518,242548333,-1005,9882,10887,4973.706507,2758.19462
Cell 27 NW 2013,8750,4508,242011484.1,-92,9787,9879,6197.537933,2289.757178
Cell 28 2013,8750,4521,242709387.7,705,9950,9245,4551.549657,2486.239355
Cell 29 2013,8750,4516,242440963.2,1172,9552,8380,6448.346988,2052.913417
Cell 3 NE 2013,8750,4513,242279908.6,-1958,9292,11250,7107.792378,1414.707889
Cell 3 NW 2013,8750,4515,242387278.4,-1958,9292,11250,6502.563012,1791.325022
Cell 30 2013,8750,4515,242387278.4,4051,8980,4929,8080.397121,470.9622258
Cell 31 2013,8750,4524,242870442.4,5623,9061,3438,8159.950928,458.8231816
Cell 32 2013,8750,4517,242494648.1,5505,9032,3527,8004.158512,514.0872123
Cell 33 NE 2013,8750,4507,241957799.2,-908,9823,10731,5920.823608,2415.509356
Cell 33 SE 2013,8750,4520,242655702.8,-1781,9972,11753,5405.110398,2689.135078
Cell 33 SW 2013,8750,4509,242065169,-834,9741,10575,5065.863828,2668.68438
Cell 34 N 2013,8750,4511,242172538.8,457,9823,9366,6108.976502,2234.122929
Cell 34 NW 2013,8750,4512,242226223.7,-1781,9823,11604,6305.931516,2134.722619
Cell 34 SE 2013,8750,4514,242333593.5,-1781,9972,11753,5981.474967,2395.635468
Cell 35 2013,8750,4501,241635689.9,418,9950,9532,4834.245945,2553.859623
Cell 37 2013,8750,4512,242226223.7,1473,9400,7927,7892.036791,656.4914233
Cell 38 2013,8750,4521,242709387.7,6371,9059,2688,8265.405662,400.9918178
Cell 39 2013,8750,4515,242387278.4,5043,9081,4038,8184.687708,485.9185914
Cell 4 2013,8750,4512,242226223.7,1025,9270,8245,7566.496011,1038.211297
Cell 40 NE 2013,8750,4502,241689374.8,-1781,9972,11753,4967.758552,2821.349945
Cell 41 N 2013,8750,4519,242602017.9,-1781,9972,11753,5761.678911,2519.432086
Cell 41 NW 2013,8750,4516,242440963.2,-1781,9972,11753,5396.081267,2804.532856
Cell 42 NW 2013,8750,4517,242494648.1,418,9959,9541,6111.277839,2396.678147
Cell 43 2013,8750,4522,242763072.6,540,9904,9364,5990.65701,2471.830726
Cell 44 2013,8750,4521,242709387.7,1292,9652,8360,7197.464057,1719.764299
Cell 45 2013,8750,4514,242333593.5,2095,9510,7415,8066.750111,545.3765322
Cell 47 2013,8750,4511,242172538.8,853,9571,8718,6823.91155,2119.370256
Cell 48 2013,8750,4512,242226223.7,853,9904,9051,6381.562722,2335.227864
Cell 49 2013,8750,4503,241743059.7,1304,9904,8600,6817.004886,2011.978426
Cell 5 2011/12 Summer,8750,4515,242387278.4,-1836,9972,11808,5510.836545,2215.182002
Cell 5 2013,8750,4516,242440963.2,4134,8863,4729,7932.036537,431.3128985
Cell 50 2013,8750,4520,242655702.8,1375,9692,8317,7157.374115,1748.983305
Cell 51 2013,8750,4524,242870442.4,5712,9085,3373,8164.054598,411.026706
Cell 52 2013,8750,4515,242387278.4,1375,9483,8108,6837.469767,2106.395165
Cell 53 2013,8750,4514,242333593.5,1301,9692,8391,7102.460789,1936.523934
Cell 54 2013,8750,4520,242655702.8,1681,9005,7324,7983.177655,801.3643342
Cell 55 2013,8750,4519,242602017.9,5712,9005,3293,8090.356937,501.7524896
Cell 56 2013,8750,4524,242870442.4,1327,9542,8215,6916.888373,1668.152145
Cell 57 2013,8750,4519,242602017.9,1681,8980,7299,7254.553884,1208.893823
Cell 58 2013,8750,4519,242602017.9,1681,8980,7299,7933.041602,1028.599472
Cell 59 2013,8750,4513,242279908.6,1327,9542,8215,6792.979614,1701.137444
Cell 6 2011/12,8750,4511,242172538.8,1036,9787,8751,6182.3589,2280.888207
Cell 6 2013,8750,4513,242279908.6,5597,8877,3280,8010.62043,393.1957953
Cell 6 NE 2011/12,8750,4503,241743059.7,1242,9292,8050,6111.474573,2176.769538
Cell 6 NW 2011/12,8750,4502,241689374.8,614,9804,9190,6023.531542,2413.380408
Cell 6 SW 2011/12,8750,4509,242065169,-92,9804,9896,5789.359725,2653.583805
Cell 60 2013,8750,4522,242763072.6,1894,8780,6886,6977.543344,1037.377195
Cell 61 2013,8750,4515,242387278.4,1894,8874,6980,7455.853378,1204.102947
Cell 7 2013,8750,4524,242870442.4,4961,9168,4207,7949.855217,529.5514672
Cell 9 NW 2013,8750,4508,242011484.1,-1428,9736,11164,5224.970497,2296.546411
Cell 9 SE 2013,8750,4511,242172538.8,-1836,9804,11640,4935.753935,2344.242129
Cell 9 SW 2013,8750,4514,242333593.5,-1836,9804,11640,5090.706912,2322.286239
Cell R1,8750,4501,241635689.9,1080,8693,7613,5688.1022,1885.857696
Cell R10,8750,4511,242172538.8,1025,9270,8245,7566.228552,1038.17093
Cell R100,8750,4520,242655702.8,1375,9692,8317,7157.374115,1748.983305
Cell R101,8750,4516,242440963.2,1554,9692,8138,7806.74225,989.0053285
Cell R104,8750,4508,242011484.1,1301,9468,8167,7140.000222,1905.597142
Cell R105,8750,4514,242333593.5,1301,9692,8391,7102.460789,1936.523934
Cell R106,8750,4517,242494648.1,1375,9692,8317,7474.499004,1368.255075
Cell R107,8750,4520,242655702.8,1681,9005,7324,7983.177655,801.3643342
Cell R11,8750,4516,242440963.2,4134,8863,4729,7932.036537,431.3128985
Cell R111,8750,4511,242172538.8,1168,9468,8300,6760.788517,2194.350993
Cell R112,8750,4517,242494648.1,1681,8985,7304,7515.665486,1044.281963
Cell R113,8750,4519,242602017.9,1681,8980,7299,7254.553884,1208.893823
Cell R114,8750,4518,242548333,1681,8980,7299,7933.05467,1028.712924
Cell R117,8750,4511,242172538.8,1168,9542,8374,6399.973177,2107.070257
Cell R118,8750,4525,242924127.3,1327,9542,8215,6917.127293,1668.045219
Cell R119,8750,4512,242226223.7,1681,8980,7299,7126.071809,1209.097184
Cell R120,8750,4504,241796744.6,1746,8874,7128,7411.638988,1272.348201
Cell R121,8750,4522,242763072.6,3582,8955,5373,8091.985626,583.2940158
Cell R123,8750,4518,242548333,1318,9889,8571,6726.818504,1751.406023
Cell R124,8750,4518,242548333,1894,8780,6886,6984.150509,1030.718019
Cell R125,8750,4526,242977812.1,1894,8780,6886,6849.717411,1087.473649
Cell R126,8750,4524,242870442.4,1894,8867,6973,7312.092838,1248.578522
Cell R15,8750,4517,242494648.1,-1428,9285,10713,5707.461147,2091.582449
Cell R16,8750,4513,242279908.6,-1428,9736,11164,5228.044981,2296.167042
Cell R17,8750,4511,242172538.8,614,9513,8899,6073.373975,2295.411102
Cell R18,8750,4519,242602017.9,-1958,9292,11250,6549.37287,1878.352674
Cell R19,8750,4514,242333593.5,1373,9571,8198,6752.618963,1778.465067
Cell R20,8750,4515,242387278.4,1806,8863,7057,7500.431672,1102.337632
Cell R21,8750,4513,242279908.6,1806,8863,7057,7434.218037,1231.441697
Cell R22,8750,4515,242387278.4,1872,8863,6991,7737.0299,922.9968188
Cell R24,8750,4504,241796744.6,-1836,9972,11808,5296.043961,2284.854994
Cell R25,8750,4506,241904114.3,-1836,9804,11640,5295.783622,2586.359809
Cell R26,8750,4508,242011484.1,614,9804,9190,6025.762866,2410.018914
Cell R27,8750,4510,242118853.9,1036,9787,8751,6305.587583,2242.308714
Cell R28,8750,4513,242279908.6,1356,9571,8215,5852.334146,2288.552418
Cell R29,8750,4515,242387278.4,1335,9571,8236,6275.480399,2121.634781
Cell R30,8750,4513,242279908.6,1806,8727,6921,7477.378905,1105.05189
Cell R31,8750,4520,242655702.8,2239,8740,6501,7707.438053,795.9596102
Cell R35,8750,4514,242333593.5,-1836,9972,11808,5510.437306,2215.264932
Cell R36,8750,4508,242011484.1,-1836,9972,11808,5499.558563,2313.81066
Cell R37,8750,4507,241957799.2,-92,9804,9896,5904.803417,2490.682892
Cell R38,8750,4521,242709387.7,956,9787,8831,5642.397257,2501.959335
Cell R39,8750,4514,242333593.5,1335,9552,8217,6473.373726,2083.694676
Cell R40,8750,4513,242279908.6,1499,9552,8053,7167.044538,1417.654271
Cell R46,8750,4516,242440963.2,-1005,9882,10887,5269.027236,2703.722765
Cell R47,8750,4517,242494648.1,-1005,9882,10887,4973.62785,2758.494849
Cell R48,8750,4520,242655702.8,-92,9787,9879,6182.978761,2375.873309
Cell R49,8750,4508,242011484.1,-92,9787,9879,6197.537933,2289.757178
Cell R5,8750,4504,241796744.6,-1428,9210,10638,5715.819716,1963.531465
Cell R50,8750,4521,242709387.7,705,9950,9245,4551.549657,2486.239355
Cell R51,8750,4518,242548333,1172,9552,8380,6454.915892,2050.561691
Cell R52,8750,4521,242709387.7,2206,8914,6708,7617.868613,798.1421249
Cell R53,8750,4515,242387278.4,2206,8860,6654,7708.758361,722.0147174
Cell R54,8750,4523,242816757.5,5623,9061,3438,8159.922176,458.8698246
Cell R58,8750,4513,242279908.6,-1005,9693,10698,5127.521604,2733.81598
Cell R59,8750,4506,241904114.3,-908,9823,10731,5920.224811,2415.442879
Cell R6,8750,4515,242387278.4,-1954,9513,11467,6071.960354,2081.442723
Cell R60,8750,4512,242226223.7,-1781,9823,11604,6306.166888,2134.266865
Cell R61,8750,4501,241635689.9,418,9950,9532,4834.245945,2553.859623
Cell R62,8750,4516,242440963.2,540,9950,9410,5202.481399,2579.593285
Cell R63,8750,4515,242387278.4,1104,9552,8448,6202.139313,2243.407961
Cell R64,8750,4517,242494648.1,4051,8980,4929,7943.244631,551.3116982
Cell R65,8750,4515,242387278.4,4051,8980,4929,8080.397121,470.9622258
Cell R66,8750,4525,242924127.3,5623,8980,3357,8122.294144,464.067294
Cell R69,8750,4510,242118853.9,-834,9741,10575,5066.465188,2668.694025
Cell R7,8750,4515,242387278.4,-1958,9292,11250,6502.563012,1791.325022
Cell R70,8750,4520,242655702.8,-1781,9972,11753,5405.110398,2689.135078
Cell R71,8750,4513,242279908.6,-1781,9972,11753,5981.155772,2395.804888
Cell R72,8750,4515,242387278.4,418,9959,9541,5543.951052,2578.155549
Cell R73,8750,4519,242602017.9,418,9950,9532,4689.899757,2622.674896
Cell R74,8750,4515,242387278.4,540,9400,8860,6330.525138,2379.581753
Cell R75,8750,4513,242279908.6,1473,9400,7927,7892.015732,656.42021
Cell R76,8750,4523,242816757.5,5854,8980,3126,8188.113199,382.9661584
Cell R77,8750,4521,242709387.7,6371,9059,2688,8265.405662,400.9918178
Cell R8,8750,4510,242118853.9,-1958,9292,11250,7040.025721,1443.730239
Cell R80,8750,4501,241635689.9,-1781,9972,11753,4967.189069,2821.404608
Cell R81,8750,4508,242011484.1,-1781,9972,11753,5739.072094,2590.777322
Cell R82,8750,4519,242602017.9,418,9959,9541,6112.244744,2396.589876
Cell R83,8750,4515,242387278.4,418,9571,9153,6343.704983,2400.891649
Cell R84,8750,4517,242494648.1,540,9904,9364,5758.922072,2540.1834
Cell R85,8750,4522,242763072.6,540,9904,9364,5990.65701,2471.830726
Cell R86,8750,4520,242655702.8,1304,9629,8325,7635.344912,1269.262067
Cell R87,8750,4514,242333593.5,2095,9510,7415,8066.750111,545.3765322
Cell R9,8750,4498,241474635.2,-1958,9292,11250,7249.312139,1326.084968
Cell R90,8750,4512,242226223.7,853,9571,8718,6823.110816,2119.817708
Cell R91,8750,4510,242118853.9,853,9904,9051,6381.318182,2335.533559
Cell R92,8750,4517,242494648.1,1175,9904,8729,5858.842373,2413.341735
Cell R93,8750,4501,241635689.9,1304,9904,8600,6816.430571,2012.220306
Cell R97,8750,4517,242494648.1,1120,9427,8307,7157.149878,1904.782993
Cell R98,8750,4514,242333593.5,1175,9904,8729,6647.957023,2285.995273
Cell R99,8750,4515,242387278.4,1375,9483,8108,6837.456478,2106.428302
Cell S102,8750,4520,242655702.8,5712,9085,3373,8191.846681,407.6688094
Cell S108,8750,4517,242494648.1,5712,9005,3293,8090.131946,501.7484663
Cell S13,8750,4515,242387278.4,5654,9168,3514,8042.398228,401.0225341
Cell S14,8750,4524,242870442.4,4961,9168,4207,7949.855217,529.5514672
Cell S2,8750,4512,242226223.7,5597,8877,3280,8010.620346,393.2393651
Cell S23,8750,4513,242279908.6,4961,8877,3916,7933.552404,462.9198648
Cell S32,8750,4514,242333593.5,4978,8920,3942,7981.775144,472.1965182
Cell S33,8750,4517,242494648.1,5061,8963,3902,8038.845915,424.7322575
Cell S34,8750,4516,242440963.2,5706,9061,3355,7964.858503,469.9974225
Cell S41,8750,4513,242279908.6,2206,8914,6708,7722.861068,708.6037919
Cell S42,8750,4506,241904114.3,5619,9061,3442,8124.943187,438.4891751
Cell S44,8750,4520,242655702.8,5645,9061,3416,7966.307522,514.8736666
Cell S56,8750,4521,242709387.7,5505,9061,3556,7717.624198,529.2000617
Cell S67,8750,4516,242440963.2,5505,9032,3527,8004.206599,514.1339701
Cell S78,8750,4515,242387278.4,5043,9081,4038,8184.687708,485.9185914
Cell S88,8750,4518,242548333,4469,9085,4616,8206.694555,510.31934
Cell S94,8750,4519,242602017.9,5543,9085,3542,8141.445453,465.0027029
Cell S95,8750,4525,242924127.3,5712,9085,3373,8164.058785,410.9813826
W287,8750,4511,242172538.8,894,9837,8943,4598.665041,2144.573131
W295,8750,4514,242333593.5,1465,9159,7694,6743.354453,1855.789066
W338,8750,4499,241528320.1,697,9484,8787,3727.682374,2324.949268
W342,8750,4501,241635689.9,894,8946,8052,5454.086425,2353.921997
W345,8750,4513,242279908.6,1609,8580,6971,7230.057611,1159.499257
W387,8750,4503,241743059.7,3,9470,9467,4728.858095,2316.077888
W393,8750,4508,242011484.1,728,9484,8756,5323.586957,2554.946558
W440,8750,4514,242333593.5,1073,9239,8166,5255.159282,2208.969805
W441,8750,4506,241904114.3,1101,9239,8138,6189.037949,1837.453249
W445,8750,4503,241743059.7,2175,8898,6723,6827.696869,991.071828
W500,8750,4510,242118853.9,1196,8598,7402,6408.307761,1616.958347
1,9000,4775,256345349.7,-1954,9513,11467,6053.57466,2080.330605
2,9000,4773,256237980,-1958,9292,11250,6411.485439,1981.174573
3,9000,4776,256399034.6,-1958,9571,11529,7071.644472,1570.138266
4,9000,4781,256667459.1,1806,9571,7765,7468.879523,1141.05334
5,9000,4774,256291664.9,-1836,9972,11808,5475.451613,2237.184967
6,9000,4768,255969555.5,1036,9787,8751,6148.454908,2291.201551
7,9000,4775,256345349.7,1373,9571,8198,6210.59644,2123.694659
8,9000,4777,256452719.5,1806,8730,6924,7344.047519,1178.734139
9,9000,4779,256560089.3,4978,8920,3942,7965.098556,482.4129038
10,9000,4763,255701131.1,-1005,9882,10887,5090.177829,2678.043177
11,9000,4776,256399034.6,-92,9787,9879,6185.363275,2365.706928
12,9000,4784,256828513.8,705,9950,9245,4594.440635,2485.867104
13,9000,4778,256506404.4,1104,9552,8448,6417.605274,2080.044122
14,9000,4777,256452719.5,4902,9061,4159,8109.330752,472.6413554
16,9000,4776,256399034.6,-1781,9741,11522,5032.205611,2688.22748
17,9000,4777,256452719.5,-1781,9823,11604,6259.835043,2165.236381
18,9000,4774,256291664.9,586,9950,9364,4937.224759,2519.930132
19,9000,4772,256184295.1,540,9950,9410,5267.131811,2563.682581
20,9000,4779,256560089.3,1473,9400,7927,7862.179954,754.8310835
21,9000,4771,256130610.2,6371,9059,2688,8264.540767,402.3067824
22,9000,4771,256130610.2,-1781,9972,11753,4928.57598,2873.258714
23,9000,4773,256237980,418,9972,9554,6143.56652,2388.698506
24,9000,4780,256613774.2,853,9904,9051,6345.527197,2346.847834
25,9000,4772,256184295.1,1304,9904,8600,6807.845557,2029.798691
26,9000,4778,256506404.4,1612,9510,7898,8051.307869,626.870956
27,9000,4776,256399034.6,1175,9904,8729,6605.319933,2296.932034
28,9000,4775,256345349.7,1301,9692,8391,7086.903037,1950.055388
29,9000,4781,256667459.1,1375,9692,8317,7160.794604,1751.140328
31,9000,4770,256076925.3,1197,9468,8271,7057.768344,1837.800096
32,9000,4779,256560089.3,1681,8980,7299,7268.747855,1193.312274
33,9000,4784,256828513.8,1327,9542,8215,6902.23495,1697.998161
34,9000,4771,256130610.2,1746,8780,7034,6945.439321,1109.711501
10A,9000,4775,256345349.7,-1005,9882,10887,5031.851728,2745.932661
10NE,9000,4777,256452719.5,-1005,9882,10887,5143.271719,2701.624618
10NW,9000,4769,256023240.4,-1836,9972,11808,5519.369889,2310.527956
10SW,9000,4775,256345349.7,-1005,9882,10887,5142.511832,2709.833653
11NE,9000,4764,255754816,-92,9804,9896,5874.941646,2497.217329
11NW,9000,4776,256399034.6,-92,9804,9896,6057.536223,2457.872189
11SE,9000,4771,256130610.2,-92,9787,9879,6182.283379,2300.866606
17NW,9000,4773,256237980,-908,9823,10731,5845.520637,2440.106263
17SE,9000,4779,256560089.3,-1781,9972,11753,5988.109856,2389.317901
17SW,9000,4776,256399034.6,-1781,9972,11753,5380.582705,2683.630912
22S,9000,4769,256023240.4,-1781,9972,11753,4841.956175,2869.800222
23S,9000,4784,256828513.8,1111,9571,8460,5188.231814,2387.580701
24S,9000,4775,256345349.7,853,9904,9051,6345.396649,2345.438878
27A,9000,4780,256613774.2,1029,9427,8398,7069.647908,1972.862547
2A,9000,4777,256452719.5,-1958,9292,11250,6647.544693,1830.881095
5NE,9000,4773,256237980,-1836,9804,11640,4994.068301,2341.547587
5NW,9000,4772,256184295.1,-1836,9804,11640,5098.737217,2320.133702
5SE,9000,4775,256345349.7,-1836,9804,11640,5352.033927,2584.374261
6NE,9000,4765,255808500.8,1038,9292,8254,6049.914166,2200.210444
6NW,9000,4766,255862185.7,614,9804,9190,6021.326479,2404.996977
6SW,9000,4771,256130610.2,-92,9804,9896,5750.973381,2643.291799
Cell 1 2011/12,9000,4775,256345349.7,-1954,9513,11467,6053.57466,2080.330605
Cell 1 SW 2013,9000,4776,256399034.6,-1428,9285,10713,5724.787479,2082.205878
Cell 10 2011/12,9000,4763,255701131.1,-1005,9882,10887,5090.177829,2678.043177
Cell 10 NE 2011/12,9000,4777,256452719.5,-1005,9882,10887,5143.271719,2701.624618
Cell 10 NW 2011/12,9000,4769,256023240.4,-1836,9972,11808,5519.369889,2310.527956
Cell 10 SE 2013,9000,4766,255862185.7,614,9804,9190,6021.326479,2404.996977
Cell 10 SW 2011/12,9000,4775,256345349.7,-1005,9882,10887,5142.511832,2709.833653
Cell 10-A 2011/12,9000,4775,256345349.7,-1005,9882,10887,5031.851728,2745.932661
Cell 11 NE 2011/12,9000,4764,255754816,-92,9804,9896,5874.941646,2497.217329
Cell 11 NW 2013,9000,4777,256452719.5,-1958,9292,11250,6539.843835,1904.320432
Cell 11 SW 2013,9000,4777,256452719.5,674,9287,8613,6147.265648,2250.847052
Cell 12 2013,9000,4774,256291664.9,1373,9571,8198,6209.286762,2124.524161
Cell 13 2013,9000,4778,256506404.4,1806,9497,7691,7338.851821,1177.687891
Cell 14 2013,9000,4781,256667459.1,1872,8863,6991,7718.196193,966.7160745
Cell 15 2013,9000,4778,256506404.4,4961,8963,4002,8028.477187,457.4583238
Cell 15-A 2013,9000,4778,256506404.4,5061,8963,3902,8043.267685,429.2491436
Cell 16 2013,9000,4778,256506404.4,5848,9021,3173,7996.285475,417.8398707
Cell 17 NW 2011/12,9000,4773,256237980,-908,9823,10731,5845.520637,2440.106263
Cell 17 NW 2013,9000,4763,255701131.1,-1836,9972,11808,5264.009868,2303.873616
Cell 17 SE 2013,9000,4769,256023240.4,-1836,9972,11808,5519.369889,2310.527956
Cell 17 SW 2013,9000,4776,256399034.6,-1836,9972,11808,5479.522404,2237.893115
Cell 18 2011/12,9000,4774,256291664.9,586,9950,9364,4937.224759,2519.930132
Cell 18 NE 2013,9000,4776,256399034.6,-92,9804,9896,5785.331449,2636.254203
Cell 18 NW 2013,9000,4769,256023240.4,-1836,9804,11640,5340.278465,2579.462522
Cell 18 SE 2013,9000,4764,255754816,-92,9804,9896,5874.941646,2497.217329
Cell 18 SSE 2013,9000,4776,256399034.6,-92,9804,9896,6115.255025,2419.182411
Cell 19 NW 2013,9000,4776,256399034.6,674,9804,9130,6288.351549,2243.633541
Cell 2 2011/12,9000,4773,256237980,-1958,9292,11250,6411.485439,1981.174573
Cell 2 NE 2013,9000,4770,256076925.3,-1958,9292,11250,6607.493291,1766.323582
Cell 2 SW 2013,9000,4776,256399034.6,-1954,9513,11467,6053.66876,2080.348247
Cell 20 2013,9000,4780,256613774.2,1335,9571,8236,6241.060879,2131.783026
Cell 21 2013,9000,4783,256774828.9,1406,9552,8146,7124.27535,1471.087813
Cell 22 2013,9000,4774,256291664.9,4978,8920,3942,7989.918726,481.764701
Cell 23 2013,9000,4775,256345349.7,5457,9061,3604,8113.277277,442.7500534
Cell 24 2013,9000,4775,256345349.7,5645,9061,3416,7961.932356,478.5908257
Cell 25 NE 2013,9000,4760,255540076.4,-1005,9882,10887,5091.218697,2677.866631
Cell 25 SE 2013,9000,4775,256345349.7,-1005,9882,10887,5142.511832,2709.833653
Cell 26 NE 2013,9000,4777,256452719.5,-92,9787,9879,6184.740423,2365.850909
Cell 26 NNW 2013,9000,4777,256452719.5,-1005,9882,10887,5143.271719,2701.624618
Cell 26 NW 2013,9000,4773,256237980,-1005,9882,10887,5031.155248,2746.10829
Cell 27 NW 2013,9000,4771,256130610.2,-92,9787,9879,6182.283379,2300.866606
Cell 28 2013,9000,4785,256882198.6,705,9950,9245,4595.138976,2486.076604
Cell 29 2013,9000,4780,256613774.2,1104,9552,8448,6416.267364,2081.473437
Cell 3 NE 2013,9000,4777,256452719.5,-1958,9292,11250,7089.671551,1434.90793
Cell 3 NW 2013,9000,4779,256560089.3,-1958,9292,11250,6487.096254,1800.385295
Cell 30 2013,9000,4774,256291664.9,4051,8980,4929,8075.365941,472.1712298
Cell 31 2013,9000,4781,256667459.1,5623,9061,3438,8159.913407,460.1545115
Cell 32 2013,9000,4776,256399034.6,5505,9059,3554,8005.580402,514.9057111
Cell 33 NE 2013,9000,4773,256237980,-908,9823,10731,5845.520637,2440.106263
Cell 33 SE 2013,9000,4775,256345349.7,-1781,9972,11753,5380.759162,2684.116302
Cell 33 SW 2013,9000,4777,256452719.5,-1781,9741,11522,5030.202847,2685.097952
Cell 34 N 2013,9000,4780,256613774.2,457,9823,9366,6079.820711,2247.241749
Cell 34 NW 2013,9000,4778,256506404.4,-1781,9823,11604,6258.802219,2166.186308
Cell 34 SE 2013,9000,4777,256452719.5,-1781,9972,11753,5989.290978,2388.236005
Cell 35 2013,9000,4773,256237980,418,9950,9532,4852.39912,2545.862064
Cell 37 2013,9000,4772,256184295.1,1473,9400,7927,7864.616932,750.5911542
Cell 38 2013,9000,4784,256828513.8,6371,9059,2688,8265.200042,403.035619
Cell 39 2013,9000,4785,256882198.6,5043,9081,4038,8173.892999,494.8942834
Cell 4 2013,9000,4774,256291664.9,-959,9270,10229,7534.727901,1101.888153
Cell 40 NE 2013,9000,4767,255915870.6,-1781,9972,11753,5012.640025,2802.56706
Cell 41 N 2013,9000,4777,256452719.5,-1781,9972,11753,5706.181285,2545.18645
Cell 41 NW 2013,9000,4775,256345349.7,-1781,9972,11753,5362.543037,2817.809412
Cell 42 NW 2013,9000,4781,256667459.1,418,9959,9541,6124.440494,2396.407413
Cell 43 2013,9000,4785,256882198.6,540,9904,9364,5996.012748,2476.878642
Cell 44 2013,9000,4780,256613774.2,1292,9652,8360,7140.300418,1786.81749
Cell 45 2013,9000,4778,256506404.4,1612,9510,7898,8052.586647,622.309224
Cell 47 2013,9000,4782,256721144,853,9571,8718,6771.788582,2148.811575
Cell 48 2013,9000,4776,256399034.6,853,9904,9051,6346.86139,2344.797971
Cell 49 2013,9000,4773,256237980,1304,9904,8600,6807.056568,2030.317736
Cell 5 2011/12 Summer,9000,4776,256399034.6,-1836,9972,11808,5479.399707,2237.792092
Cell 5 2013,9000,4778,256506404.4,3669,8863,5194,7921.992884,472.5952111
Cell 50 2013,9000,4781,256667459.1,1375,9692,8317,7160.528551,1751.098191
Cell 51 2013,9000,4788,257043253.3,5712,9085,3373,8159.865497,414.6743172
Cell 52 2013,9000,4778,256506404.4,1375,9483,8108,6784.902051,2137.225626
Cell 53 2013,9000,4775,256345349.7,1301,9692,8391,7086.903037,1950.055388
Cell 54 2013,9000,4780,256613774.2,1681,9005,7324,7970.309205,823.8926763
Cell 55 2013,9000,4777,256452719.5,5568,9005,3437,8084.042286,506.5614823
Cell 56 2013,9000,4781,256667459.1,1327,9542,8215,6901.817821,1698.403292
Cell 57 2013,9000,4779,256560089.3,1681,8980,7299,7269.224733,1193.362867
Cell 58 2013,9000,4779,256560089.3,1681,8980,7299,7915.83574,1020.254979
Cell 59 2013,9000,4777,256452719.5,1327,9542,8215,6781.288675,1703.815542
Cell 6 2011/12,9000,4768,255969555.5,1036,9787,8751,6148.454908,2291.201551
Cell 6 2013,9000,4769,256023240.4,5597,8886,3289,8006.223108,394.3667199
Cell 6 NE 2011/12,9000,4765,255808500.8,1038,9292,8254,6049.914166,2200.210444
Cell 6 NW 2011/12,9000,4766,255862185.7,614,9804,9190,6021.326479,2404.996977
Cell 6 SW 2011/12,9000,4771,256130610.2,-92,9804,9896,5750.973381,2643.291799
Cell 60 2013,9000,4783,256774828.9,1894,8780,6886,6990.91428,1040.656973
Cell 61 2013,9000,4774,256291664.9,1894,8955,7061,7445.034562,1224.860805
Cell 7 2013,9000,4786,256935883.5,4961,9168,4207,7955.026954,527.1345379
Cell 9 NW 2013,9000,4768,255969555.5,-1836,9736,11572,5246.487206,2304.993877
Cell 9 SE 2013,9000,4773,256237980,-1836,9804,11640,4994.068301,2341.547587
Cell 9 SW 2013,9000,4773,256237980,-1836,9804,11640,5097.26608,2320.228597
Cell R1,9000,4765,255808500.8,1080,8693,7613,5700.58405,1877.41793
Cell R10,9000,4774,256291664.9,-959,9270,10229,7534.727901,1101.888153
Cell R100,9000,4780,256613774.2,1375,9692,8317,7160.317364,1751.202464
Cell R101,9000,4779,256560089.3,1375,9692,8317,7769.471019,1059.107181
Cell R104,9000,4773,256237980,1301,9468,8167,7140.002514,1901.165461
Cell R105,9000,4774,256291664.9,1301,9692,8391,7088.013825,1948.748554
Cell R106,9000,4779,256560089.3,1375,9692,8317,7478.104415,1373.169816
Cell R107,9000,4779,256560089.3,1681,9005,7324,7970.29797,823.978505
Cell R11,9000,4777,256452719.5,3669,8863,5194,7921.967972,472.6415371
Cell R111,9000,4772,256184295.1,1168,9468,8300,6776.949497,2172.817696
Cell R112,9000,4779,256560089.3,1681,9074,7393,7492.7353,1077.440549
Cell R113,9000,4779,256560089.3,1681,8980,7299,7269.224733,1193.362867
Cell R114,9000,4779,256560089.3,1681,8980,7299,7915.83574,1020.254979
Cell R117,9000,4771,256130610.2,1168,9542,8374,6402.577237,2114.214653
Cell R118,9000,4782,256721144,1327,9542,8215,6900.887704,1699.443042
Cell R119,9000,4776,256399034.6,1681,8980,7299,7142.029523,1199.618917
Cell R120,9000,4779,256560089.3,1746,8874,7128,7421.209458,1274.230201
Cell R121,9000,4778,256506404.4,2412,8955,6543,8076.273964,618.0514521
Cell R123,9000,4778,256506404.4,1318,9889,8571,6719.29301,1765.544131
Cell R124,9000,4784,256828513.8,1894,8780,6886,6992.707358,1024.452661
Cell R125,9000,4781,256667459.1,1894,8780,6886,6865.732274,1079.997591
Cell R126,9000,4783,256774828.9,1894,8874,6980,7324.409785,1243.999784
Cell R15,9000,4777,256452719.5,-1428,9285,10713,5725.206406,2082.189211
Cell R16,9000,4763,255701131.1,-1836,9736,11572,5247.26286,2305.686713
Cell R17,9000,4774,256291664.9,614,9513,8899,6082.727482,2281.809413
Cell R18,9000,4784,256828513.8,-1958,9292,11250,6552.610368,1896.960218
Cell R19,9000,4771,256130610.2,1373,9571,8198,6746.121149,1785.217014
Cell R20,9000,4780,256613774.2,1806,8863,7057,7512.81841,1096.196617
Cell R21,9000,4779,256560089.3,1806,8863,7057,7460.080142,1207.246112
Cell R22,9000,4781,256667459.1,1872,8863,6991,7718.196193,966.7160745
Cell R24,9000,4762,255647446.2,-1836,9972,11808,5263.383242,2303.709623
Cell R25,9000,4768,255969555.5,-1836,9804,11640,5339.952601,2579.566324
Cell R26,9000,4768,255969555.5,614,9804,9190,6023.458263,2402.964663
Cell R27,9000,4774,256291664.9,674,9804,9130,6287.738375,2243.903356
Cell R28,9000,4774,256291664.9,1356,9571,8215,5831.158777,2289.161621
Cell R29,9000,4779,256560089.3,1335,9571,8236,6240.818163,2131.94001
Cell R30,9000,4773,256237980,1806,8730,6924,7479.199455,1104.067474
Cell R31,9000,4778,256506404.4,2161,8863,6702,7705.879866,822.9799566
Cell R35,9000,4776,256399034.6,-1836,9972,11808,5479.522404,2237.893115
Cell R36,9000,4769,256023240.4,-1836,9972,11808,5519.369889,2310.527956
Cell R37,9000,4764,255754816,-92,9804,9896,5874.941646,2497.217329
Cell R38,9000,4779,256560089.3,956,9787,8831,5622.623561,2502.563351
Cell R39,9000,4773,256237980,1335,9552,8217,6433.487325,2108.194443
Cell R40,9000,4783,256774828.9,1406,9552,8146,7124.27535,1471.087813
Cell R46,9000,4774,256291664.9,-1005,9882,10887,5265.421031,2694.702899
Cell R47,9000,4775,256345349.7,-1005,9882,10887,5031.851728,2745.932661
Cell R48,9000,4777,256452719.5,-92,9787,9879,6184.740423,2365.850909
Cell R49,9000,4770,256076925.3,-92,9787,9879,6183.268344,2300.101818
Cell R5,9000,4762,255647446.2,-1428,9210,10638,5699.546409,1978.953505
Cell R50,9000,4785,256882198.6,705,9950,9245,4595.138976,2486.076604
Cell R51,9000,4780,256613774.2,1104,9552,8448,6425.605858,2075.398883
Cell R52,9000,4778,256506404.4,2206,8914,6708,7629.61239,785.7326243
Cell R53,9000,4778,256506404.4,2206,8914,6708,7705.6036,728.0836868
Cell R54,9000,4782,256721144,5623,9061,3438,8159.884985,460.1105928
Cell R58,9000,4777,256452719.5,-1005,9693,10698,5141.21771,2732.519637
Cell R59,9000,4773,256237980,-908,9823,10731,5845.520637,2440.106263
Cell R6,9000,4776,256399034.6,-1954,9513,11467,6053.66876,2080.348247
Cell R60,9000,4778,256506404.4,-1781,9823,11604,6258.802219,2166.186308
Cell R61,9000,4774,256291664.9,418,9950,9532,4852.965228,2545.895843
Cell R62,9000,4778,256506404.4,540,9950,9410,5261.289242,2569.974939
Cell R63,9000,4778,256506404.4,1104,9552,8448,6171.913981,2268.211165
Cell R64,9000,4778,256506404.4,4051,8980,4929,7947.003349,548.8555294
Cell R65,9000,4774,256291664.9,4051,8980,4929,8075.365941,472.1712298
Cell R66,9000,4780,256613774.2,5623,8980,3357,8116.998536,460.097087
Cell R69,9000,4778,256506404.4,-1781,9741,11522,5032.13604,2684.625618
Cell R7,9000,4779,256560089.3,-1958,9292,11250,6487.096254,1800.385295
Cell R70,9000,4776,256399034.6,-1781,9972,11753,5380.311558,2684.013509
Cell R71,9000,4777,256452719.5,-1781,9972,11753,5989.290978,2388.236005
Cell R72,9000,4779,256560089.3,418,9959,9541,5544.112994,2583.021103
Cell R73,9000,4778,256506404.4,418,9950,9532,4704.084763,2614.627079
Cell R74,9000,4779,256560089.3,540,9400,8860,6324.634442,2377.264525
Cell R75,9000,4771,256130610.2,1473,9400,7927,7864.592329,750.6678879
Cell R76,9000,4777,256452719.5,5854,8980,3126,8182.067406,386.5971372
Cell R77,9000,4783,256774828.9,6371,9059,2688,8265.14907,403.0623302
Cell R8,9000,4775,256345349.7,-1958,9292,11250,7016.780733,1465.32568
Cell R80,9000,4766,255862185.7,-1781,9972,11753,5011.881242,2802.465632
Cell R81,9000,4774,256291664.9,-1781,9972,11753,5692.768119,2609.12684
Cell R82,9000,4779,256560089.3,418,9959,9541,6124.755807,2396.15151
Cell R83,9000,4779,256560089.3,418,9571,9153,6350.310316,2385.376772
Cell R84,9000,4780,256613774.2,540,9904,9364,5773.980335,2538.976916
Cell R85,9000,4785,256882198.6,540,9904,9364,5996.012748,2476.878642
Cell R86,9000,4780,256613774.2,1304,9629,8325,7608.60251,1344.442996
Cell R87,9000,4778,256506404.4,1612,9510,7898,8052.586647,622.309224
Cell R9,9000,4773,256237980,-1958,9292,11250,7239.900482,1339.516511
Cell R90,9000,4780,256613774.2,853,9571,8718,6772.702301,2147.887779
Cell R91,9000,4777,256452719.5,853,9904,9051,6346.560603,2344.64468
Cell R92,9000,4782,256721144,1175,9904,8729,5936.192179,2388.903795
Cell R93,9000,4773,256237980,1304,9904,8600,6805.770585,2031.698319
Cell R97,9000,4782,256721144,1029,9427,8398,7155.532413,1907.053613
Cell R98,9000,4776,256399034.6,1175,9904,8729,6605.319933,2296.932034
Cell R99,9000,4777,256452719.5,1375,9483,8108,6785.655851,2136.814134
Cell S102,9000,4778,256506404.4,5712,9085,3373,8184.848681,414.6649153
Cell S108,9000,4778,256506404.4,5568,9005,3437,8083.872332,506.6446597
Cell S13,9000,4783,256774828.9,5654,9168,3514,8046.654401,398.9310732
Cell S14,9000,4787,256989568.4,4961,9168,4207,7955.109463,527.1103834
Cell S2,9000,4770,256076925.3,5597,8886,3289,8006.209434,394.3265101
Cell S23,9000,4777,256452719.5,4961,8877,3916,7931.002303,465.6793689
Cell S32,9000,4783,256774828.9,4978,8920,3942,7983.52812,471.6108733
Cell S33,9000,4777,256452719.5,5061,8963,3902,8043.139209,429.2022039
Cell S34,9000,4774,256291664.9,5645,9061,3416,7961.829284,478.5879519
Cell S41,9000,4781,256667459.1,2206,8914,6708,7712.80799,720.8398292
Cell S42,9000,4775,256345349.7,5457,9061,3604,8113.277277,442.7500534
Cell S44,9000,4780,256613774.2,5645,9061,3416,7965.098117,514.6168337
Cell S56,9000,4782,256721144,5505,9061,3556,7723.517148,527.6812669
Cell S67,9000,4776,256399034.6,5505,9059,3554,8005.580402,514.9057111
Cell S78,9000,4785,256882198.6,5043,9081,4038,8173.892999,494.8942834
Cell S88,9000,4776,256399034.6,4469,9085,4616,8200.614112,508.0213641
Cell S94,9000,4779,256560089.3,5543,9085,3542,8134.151078,471.937647
Cell S95,9000,4789,257096938.2,5712,9085,3373,8159.923992,414.6507763
W287,9000,4775,256345349.7,894,9837,8943,4668.372775,2157.147006
W295,9000,4777,256452719.5,1465,9159,7694,6716.46054,1888.727183
W338,9000,4765,255808500.8,697,9484,8787,3757.342288,2316.161815
W342,9000,4771,256130610.2,894,8946,8052,5455.899602,2352.90084
W345,9000,4773,256237980,1609,8580,6971,7200.695579,1189.031207
W387,9000,4771,256130610.2,3,9470,9467,4752.78013,2311.584116
W393,9000,4760,255540076.4,728,9484,8756,5325.677311,2548.372951
W440,9000,4772,256184295.1,1073,9239,8166,5223.352682,2220.360919
W441,9000,4768,255969555.5,1101,9239,8138,6151.524329,1856.813768
W445,9000,4763,255701131.1,2175,8898,6723,6831.763804,994.5076016
W500,9000,4774,256291664.9,1196,8598,7402,6430.944491,1595.073302
1,9250,5043,270732900.3,-1954,9513,11467,6046.738053,2083.035312
2,9250,5044,270786585.2,-1958,9292,11250,6426.105472,1984.185252
3,9250,5042,270679215.4,-1958,9571,11529,7060.233836,1576.899871
4,9250,5044,270786585.2,1806,9571,7765,7458.307692,1173.447083
5,9250,5045,270840270.1,-1836,9972,11808,5453.817245,2254.834043
6,9250,5041,270625530.5,1036,9804,8768,6110.494545,2308.170846
7,9250,5045,270840270.1,1373,9571,8198,6207.828345,2125.070925
8,9250,5046,270893954.9,1806,8769,6963,7370.220769,1158.171991
9,9250,5044,270786585.2,4978,8920,3942,7963.041435,485.2151489
10,9250,5038,270464475.8,-1005,9882,10887,5083.098055,2679.933543
11,9250,5041,270625530.5,-92,9787,9879,6170.204325,2365.826175
12,9250,5045,270840270.1,705,9950,9245,4643.397621,2492.241456
13,9250,5046,270893954.9,1104,9552,8448,6394.859889,2102.355946
14,9250,5045,270840270.1,4902,9061,4159,8107.015263,475.0655079
16,9250,5045,270840270.1,-1781,9741,11522,5010.547671,2702.554606
17,9250,5042,270679215.4,-1781,9959,11740,6201.769536,2196.683847
18,9250,5042,270679215.4,586,9950,9364,4960.252281,2514.362067
19,9250,5052,271216064.3,540,9950,9410,5334.837688,2549.448904
20,9250,5042,270679215.4,1387,9400,8013,7831.146172,842.6829322
21,9250,5047,270947639.8,6337,9059,2722,8261.469982,407.2647289
22,9250,5040,270571845.6,-1781,9972,11753,4963.117659,2866.328071
23,9250,5039,270518160.7,418,9972,9554,6154.498115,2391.158223
24,9250,5045,270840270.1,853,9904,9051,6322.195639,2356.461974
25,9250,5045,270840270.1,1304,9904,8600,6783.145094,2055.027359
26,9250,5047,270947639.8,1499,9510,8011,8033.98514,688.1458716
27,9250,5048,271001324.7,1175,9904,8729,6561.748613,2306.016614
28,9250,5051,271162379.4,1301,9692,8391,7077.471194,1955.402739
29,9250,5046,270893954.9,1375,9692,8317,7167.391597,1754.908705
31,9250,5048,271001324.7,1168,9468,8300,7022.474643,1858.465994
32,9250,5048,271001324.7,1681,8980,7299,7285.609548,1177.55079
33,9250,5050,271108694.5,1254,9542,8288,6883.199604,1731.988294
34,9250,5043,270732900.3,1746,8780,7034,6952.027563,1119.027738
10A,9250,5047,270947639.8,-1005,9882,10887,5104.526055,2729.889015
10NE,9250,5042,270679215.4,-1005,9882,10887,5173.303451,2705.590769
10NW,9250,5043,270732900.3,-1836,9972,11808,5525.629387,2311.259239
10SW,9250,5042,270679215.4,-1005,9882,10887,5122.557914,2710.228681
11NE,9250,5038,270464475.8,-92,9804,9896,5852.32632,2506.924395
11NW,9250,5047,270947639.8,-92,9804,9896,6047.105409,2457.768271
11SE,9250,5042,270679215.4,-92,9787,9879,6155.787386,2315.708686
17NW,9250,5042,270679215.4,-908,9823,10731,5780.743554,2457.075678
17SE,9250,5044,270786585.2,-1781,9972,11753,5993.909596,2386.491845
17SW,9250,5041,270625530.5,-1781,9972,11753,5356.490181,2683.749551
22S,9250,5048,271001324.7,-1781,9972,11753,4893.475238,2859.677311
23S,9250,5045,270840270.1,1111,9571,8460,5272.095937,2389.482504
24S,9250,5044,270786585.2,853,9904,9051,6323.780135,2354.373843
27A,9250,5046,270893954.9,853,9427,8574,7077.333333,1968.653536
2A,9250,5042,270679215.4,-1958,9292,11250,6655.341729,1840.917844
5NE,9250,5040,270571845.6,-1836,9804,11640,5039.835317,2338.565932
5NW,9250,5038,270464475.8,-1836,9804,11640,5103.270742,2313.840133
5SE,9250,5046,270893954.9,-1836,9804,11640,5391.349584,2580.2324
6NE,9250,5039,270518160.7,1036,9292,8256,5990.05259,2227.627869
6NW,9250,5037,270410790.9,614,9804,9190,6023.077229,2396.466673
6SW,9250,5040,270571845.6,-92,9804,9896,5718.248214,2634.340736
Cell 1 2011/12,9250,5043,270732900.3,-1954,9513,11467,6046.738053,2083.035312
Cell 1 SW 2013,9250,5043,270732900.3,-1428,9550,10978,5738.279794,2076.447959
Cell 10 2011/12,9250,5038,270464475.8,-1005,9882,10887,5083.098055,2679.933543
Cell 10 NE 2011/12,9250,5042,270679215.4,-1005,9882,10887,5173.303451,2705.590769
Cell 10 NW 2011/12,9250,5043,270732900.3,-1836,9972,11808,5525.629387,2311.259239
Cell 10 SE 2013,9250,5037,270410790.9,614,9804,9190,6023.077229,2396.466673
Cell 10 SW 2011/12,9250,5042,270679215.4,-1005,9882,10887,5122.557914,2710.228681
Cell 10-A 2011/12,9250,5047,270947639.8,-1005,9882,10887,5104.526055,2729.889015
Cell 11 NE 2011/12,9250,5038,270464475.8,-92,9804,9896,5852.32632,2506.924395
Cell 11 NW 2013,9250,5045,270840270.1,-1958,9292,11250,6538.570664,1920.101386
Cell 11 SW 2013,9250,5040,270571845.6,674,9292,8618,6116.370635,2256.615644
Cell 12 2013,9250,5042,270679215.4,1373,9571,8198,6207.637445,2125.643663
Cell 13 2013,9250,5039,270518160.7,1806,9497,7691,7364.076404,1158.813552
Cell 14 2013,9250,5049,271055009.6,1872,8863,6991,7696.489602,1008.828117
Cell 15 2013,9250,5049,271055009.6,4961,8963,4002,8029.546445,460.4185893
Cell 15-A 2013,9250,5047,270947639.8,4961,9021,4060,8048.583119,435.3098341
Cell 16 2013,9250,5046,270893954.9,5848,9021,3173,7996.465715,423.1258946
Cell 17 NW 2011/12,9250,5042,270679215.4,-908,9823,10731,5780.743554,2457.075678
Cell 17 NW 2013,9250,5038,270464475.8,-1836,9972,11808,5248.06709,2314.05407
Cell 17 SE 2013,9250,5042,270679215.4,-1836,9972,11808,5525.367315,2311.413505
Cell 17 SW 2013,9250,5043,270732900.3,-1836,9972,11808,5454.645647,2254.17264
Cell 18 2011/12,9250,5042,270679215.4,586,9950,9364,4960.252281,2514.362067
Cell 18 NE 2013,9250,5043,270732900.3,-92,9804,9896,5733.816577,2636.85126
Cell 18 NW 2013,9250,5038,270464475.8,-1836,9804,11640,5384.065899,2572.927583
Cell 18 SE 2013,9250,5038,270464475.8,-92,9804,9896,5852.32632,2506.924395
Cell 18 SSE 2013,9250,5041,270625530.5,-92,9804,9896,6108.653839,2419.319779
Cell 19 NW 2013,9250,5043,270732900.3,674,9804,9130,6262.143169,2244.47452
Cell 2 2011/12,9250,5044,270786585.2,-1958,9292,11250,6426.105472,1984.185252
Cell 2 NE 2013,9250,5040,270571845.6,-1958,9292,11250,6598.879365,1772.579709
Cell 2 SW 2013,9250,5043,270732900.3,-1954,9513,11467,6046.435455,2083.578046
Cell 20 2013,9250,5047,270947639.8,1335,9571,8236,6210.44997,2141.890479
Cell 21 2013,9250,5044,270786585.2,1368,9552,8184,7093.785686,1510.886853
Cell 22 2013,9250,5045,270840270.1,4978,8920,3942,7988.047968,481.2778816
Cell 23 2013,9250,5042,270679215.4,5457,9061,3604,8103.698136,443.337887
Cell 24 2013,9250,5049,271055009.6,5645,9061,3416,7959.953456,486.5723881
Cell 25 NE 2013,9250,5038,270464475.8,-1005,9882,10887,5083.098055,2679.933543
Cell 25 SE 2013,9250,5042,270679215.4,-1005,9882,10887,5122.557914,2710.228681
Cell 26 NE 2013,9250,5041,270625530.5,-92,9787,9879,6170.204325,2365.826175
Cell 26 NNW 2013,9250,5042,270679215.4,-1005,9882,10887,5173.303451,2705.590769
Cell 26 NW 2013,9250,5048,271001324.7,-1005,9882,10887,5104.330824,2729.653845
Cell 27 NW 2013,9250,5040,270571845.6,-92,9787,9879,6156.659921,2315.529434
Cell 28 2013,9250,5045,270840270.1,705,9950,9245,4643.397621,2492.241456
Cell 29 2013,9250,5046,270893954.9,1104,9552,8448,6396.519421,2102.112699
Cell 3 NE 2013,9250,5041,270625530.5,-1958,9292,11250,7072.1341,1449.228478
Cell 3 NW 2013,9250,5044,270786585.2,-1958,9292,11250,6473.094171,1813.993868
Cell 30 2013,9250,5044,270786585.2,4051,8980,4929,8070.912173,475.2587346
Cell 31 2013,9250,5049,271055009.6,5623,9061,3438,8158.441474,463.0962852
Cell 32 2013,9250,5053,271269749.2,5505,9059,3554,8006.211953,517.2777034
Cell 33 NE 2013,9250,5042,270679215.4,-908,9823,10731,5780.743554,2457.075678
Cell 33 SE 2013,9250,5041,270625530.5,-1781,9972,11753,5356.490181,2683.749551
Cell 33 SW 2013,9250,5043,270732900.3,-1781,9741,11522,5004.590125,2698.789074
Cell 34 N 2013,9250,5043,270732900.3,457,9836,9379,6052.04997,2263.912413
Cell 34 NW 2013,9250,5041,270625530.5,-1781,9959,11740,6202.222178,2196.666594
Cell 34 SE 2013,9250,5046,270893954.9,-1781,9972,11753,5994.263377,2386.54437
Cell 35 2013,9250,5043,270732900.3,418,9950,9532,4882.14297,2540.573995
Cell 37 2013,9250,5045,270840270.1,1387,9400,8013,7839.691576,829.6071125
Cell 38 2013,9250,5051,271162379.4,6337,9059,2722,8261.317363,407.6441907
Cell 39 2013,9250,5047,270947639.8,5043,9081,4038,8161.173568,506.0138342
Cell 4 2013,9250,5043,270732900.3,-1067,9270,10337,7500.853262,1167.438569
Cell 40 NE 2013,9250,5038,270464475.8,-1781,9972,11753,5054.488884,2788.619924
Cell 41 N 2013,9250,5047,270947639.8,-1781,9972,11753,5650.242124,2571.991973
Cell 41 NW 2013,9250,5044,270786585.2,-1781,9972,11753,5320.748017,2833.434946
Cell 42 NW 2013,9250,5048,271001324.7,418,9972,9554,6128.934231,2401.857783
Cell 43 2013,9250,5045,270840270.1,540,9904,9364,6010.972646,2481.71585
Cell 44 2013,9250,5050,271108694.5,1292,9652,8360,7086.709703,1845.497656
Cell 45 2013,9250,5046,270893954.9,1499,9510,8011,8034.640904,688.2953069
Cell 47 2013,9250,5044,270786585.2,853,9571,8718,6714.086439,2186.814574
Cell 48 2013,9250,5044,270786585.2,853,9904,9051,6322.076725,2354.477321
Cell 49 2013,9250,5046,270893954.9,1304,9904,8600,6782.691439,2055.076347
Cell 5 2011/12 Summer,9250,5042,270679215.4,-1836,9972,11808,5454.751686,2254.383592
Cell 5 2013,9250,5044,270786585.2,2603,8863,6260,7912.089215,519.4820626
Cell 50 2013,9250,5047,270947639.8,1375,9692,8317,7167.3723,1754.698076
Cell 51 2013,9250,5050,271108694.5,5712,9085,3373,8156.791287,419.4923585
Cell 52 2013,9250,5042,270679215.4,1375,9483,8108,6745.767751,2161.65988
Cell 53 2013,9250,5050,271108694.5,1301,9692,8391,7077.513663,1955.66457
Cell 54 2013,9250,5048,271001324.7,1681,9005,7324,7962.772979,834.7073524
Cell 55 2013,9250,5050,271108694.5,5568,9005,3437,8080.766139,505.3628652
Cell 56 2013,9250,5050,271108694.5,1254,9542,8288,6881.115248,1732.928663
Cell 57 2013,9250,5050,271108694.5,1681,8980,7299,7285.202772,1177.264669
Cell 58 2013,9250,5047,270947639.8,1681,8980,7299,7902.929265,1006.909664
Cell 59 2013,9250,5042,270679215.4,1327,9542,8215,6774.94764,1699.346646
Cell 6 2011/12,9250,5041,270625530.5,1036,9804,8768,6110.494545,2308.170846
Cell 6 2013,9250,5046,270893954.9,5597,8945,3348,8000.917162,396.1751129
Cell 6 NE 2011/12,9250,5039,270518160.7,1036,9292,8256,5990.05259,2227.627869
Cell 6 NW 2011/12,9250,5037,270410790.9,614,9804,9190,6023.077229,2396.466673
Cell 6 SW 2011/12,9250,5040,270571845.6,-92,9804,9896,5718.248214,2634.340736
Cell 60 2013,9250,5051,271162379.4,1894,8780,6886,6994.457533,1048.95895
Cell 61 2013,9250,5052,271216064.3,1894,8955,7061,7443.206057,1230.821428
Cell 7 2013,9250,5045,270840270.1,4961,9168,4207,7955.459068,526.4114797
Cell 9 NW 2013,9250,5037,270410790.9,-1836,9736,11572,5269.140361,2315.557301
Cell 9 SE 2013,9250,5040,270571845.6,-1836,9804,11640,5039.835317,2338.565932
Cell 9 SW 2013,9250,5041,270625530.5,-1836,9804,11640,5103.761754,2314.055672
Cell R1,9250,5047,270947639.8,1080,8693,7613,5709.005548,1865.272767
Cell R10,9250,5043,270732900.3,-1067,9270,10337,7500.744398,1167.416683
Cell R100,9250,5047,270947639.8,1375,9692,8317,7167.3723,1754.698076
Cell R101,9250,5047,270947639.8,1375,9692,8317,7735.546067,1139.240941
Cell R104,9250,5048,271001324.7,1301,9468,8167,7130.13748,1914.118166
Cell R105,9250,5052,271216064.3,1301,9692,8391,7077.550871,1955.217402
Cell R106,9250,5045,270840270.1,1375,9692,8317,7483.838454,1378.382305
Cell R107,9250,5048,271001324.7,1681,9005,7324,7962.729794,834.6891795
Cell R11,9250,5044,270786585.2,2603,8863,6260,7912.064235,519.4562912
Cell R111,9250,5050,271108694.5,1168,9468,8300,6791.013267,2156.167694
Cell R112,9250,5045,270840270.1,1681,9074,7393,7466.650942,1107.512123
Cell R113,9250,5050,271108694.5,1681,8980,7299,7285.202772,1177.264669
Cell R114,9250,5046,270893954.9,1681,8980,7299,7903.002576,1006.995964
Cell R117,9250,5043,270732900.3,1168,9542,8374,6408.438231,2117.71331
Cell R118,9250,5050,271108694.5,1254,9542,8288,6881.115248,1732.928663
Cell R119,9250,5048,271001324.7,1681,8980,7299,7160.372821,1193.170437
Cell R120,9250,5050,271108694.5,1746,8874,7128,7422.797426,1280.132676
Cell R121,9250,5052,271216064.3,2412,8955,6543,8061.992478,647.1821967
Cell R123,9250,5051,271162379.4,1318,9889,8571,6705.040784,1780.76326
Cell R124,9250,5051,271162379.4,1894,8780,6886,6997.275787,1022.461948
Cell R125,9250,5046,270893954.9,1894,8780,6886,6887.761197,1070.558893
Cell R126,9250,5047,270947639.8,1894,8874,6980,7340.92451,1240.05493
Cell R15,9250,5042,270679215.4,-1428,9550,10978,5738.899445,2076.187594
Cell R16,9250,5039,270518160.7,-1836,9736,11572,5271.896805,2315.875481
Cell R17,9250,5042,270679215.4,614,9513,8899,6094.408568,2260.637408
Cell R18,9250,5046,270893954.9,-1958,9292,11250,6551.406262,1914.51529
Cell R19,9250,5039,270518160.7,1373,9571,8198,6736.863267,1792.706224
Cell R20,9250,5045,270840270.1,1806,8863,7057,7522.48107,1098.261912
Cell R21,9250,5046,270893954.9,1806,8863,7057,7483.09671,1182.719621
Cell R22,9250,5049,271055009.6,1872,8863,6991,7696.489602,1008.828117
Cell R24,9250,5037,270410790.9,-1836,9972,11808,5249.040699,2313.95303
Cell R25,9250,5037,270410790.9,-1836,9804,11640,5383.814969,2573.121332
Cell R26,9250,5044,270786585.2,614,9804,9190,6024.571174,2390.534718
Cell R27,9250,5042,270679215.4,674,9804,9130,6262.072392,2244.69146
Cell R28,9250,5046,270893954.9,1356,9571,8215,5817.489695,2285.075901
Cell R29,9250,5046,270893954.9,1335,9571,8236,6210.061237,2141.924679
Cell R30,9250,5046,270893954.9,1806,8730,6924,7485.330361,1098.323675
Cell R31,9250,5051,271162379.4,2161,8863,6702,7702.914076,864.9880048
Cell R35,9250,5042,270679215.4,-1836,9972,11808,5454.751686,2254.383592
Cell R36,9250,5043,270732900.3,-1836,9972,11808,5525.629387,2311.259239
Cell R37,9250,5038,270464475.8,-92,9804,9896,5852.32632,2506.924395
Cell R38,9250,5041,270625530.5,264,9787,9523,5590.983535,2508.087489
Cell R39,9250,5042,270679215.4,1319,9552,8233,6399.948631,2122.564117
Cell R40,9250,5044,270786585.2,1368,9552,8184,7092.783109,1512.078672
Cell R46,9250,5046,270893954.9,-1005,9882,10887,5262.372969,2686.460601
Cell R47,9250,5048,271001324.7,-1005,9882,10887,5104.330824,2729.653845
Cell R48,9250,5041,270625530.5,-92,9787,9879,6170.204325,2365.826175
Cell R49,9250,5039,270518160.7,-92,9787,9879,6156.608057,2315.756256
Cell R5,9250,5035,270303421.1,-1428,9210,10638,5675.566634,1996.887978
Cell R50,9250,5045,270840270.1,705,9950,9245,4643.397621,2492.241456
Cell R51,9250,5047,270947639.8,1104,9552,8448,6400.202695,2101.443141
Cell R52,9250,5043,270732900.3,2206,8914,6708,7637.541146,776.7397667
Cell R53,9250,5044,270786585.2,2206,8914,6708,7707.214512,724.0704955
Cell R54,9250,5050,271108694.5,5623,9061,3438,8158.510495,463.0764037
Cell R58,9250,5043,270732900.3,-1005,9693,10698,5154.039857,2734.759545
Cell R59,9250,5042,270679215.4,-908,9823,10731,5780.743554,2457.075678
Cell R6,9250,5042,270679215.4,-1954,9513,11467,6046.755454,2083.660745
Cell R60,9250,5041,270625530.5,-1781,9959,11740,6202.222178,2196.666594
Cell R61,9250,5039,270518160.7,418,9950,9532,4880.531256,2540.701959
Cell R62,9250,5044,270786585.2,540,9950,9410,5332.443497,2555.691886
Cell R63,9250,5047,270947639.8,1104,9552,8448,6151.708738,2290.443388
Cell R64,9250,5046,270893954.9,4051,8980,4929,7952.009711,546.3094631
Cell R65,9250,5044,270786585.2,4051,8980,4929,8070.912173,475.2587346
Cell R66,9250,5047,270947639.8,5623,8980,3357,8113.404201,457.1295871
Cell R69,9250,5043,270732900.3,-1781,9741,11522,5004.590125,2698.789074
Cell R7,9250,5045,270840270.1,-1958,9292,11250,6473.367889,1813.918249
Cell R70,9250,5041,270625530.5,-1781,9972,11753,5356.490181,2683.749551
Cell R71,9250,5046,270893954.9,-1781,9972,11753,5994.263377,2386.54437
Cell R72,9250,5043,270732900.3,418,9959,9541,5539.736665,2592.104843
Cell R73,9250,5051,271162379.4,418,9950,9532,4710.844387,2603.388981
Cell R74,9250,5045,270840270.1,540,9400,8860,6329.680674,2371.904023
Cell R75,9250,5047,270947639.8,1387,9400,8013,7839.477313,829.6593292
Cell R76,9250,5050,271108694.5,5854,8980,3126,8176.720594,388.9452808
Cell R77,9250,5052,271216064.3,6337,9059,2722,8261.361243,407.6157739
Cell R8,9250,5044,270786585.2,-1958,9292,11250,7002.05571,1488.742791
Cell R80,9250,5041,270625530.5,-1781,9972,11753,5052.665146,2789.352767
Cell R81,9250,5042,270679215.4,-1781,9972,11753,5662.861761,2621.311766
Cell R82,9250,5048,271001324.7,418,9972,9554,6128.934231,2401.857783
Cell R83,9250,5043,270732900.3,418,9571,9153,6351.577236,2374.47615
Cell R84,9250,5046,270893954.9,540,9904,9364,5795.301427,2534.508615
Cell R85,9250,5044,270786585.2,540,9904,9364,6010.52617,2481.759239
Cell R86,9250,5046,270893954.9,1304,9629,8325,7588.3587,1401.499776
Cell R87,9250,5045,270840270.1,1499,9510,8011,8034.497721,688.2883729
Cell R9,9250,5036,270357106,-1958,9292,11250,7220.51251,1362.495322
Cell R90,9250,5044,270786585.2,853,9571,8718,6714.086439,2186.814574
Cell R91,9250,5044,270786585.2,853,9904,9051,6321.048573,2354.927304
Cell R92,9250,5044,270786585.2,1175,9904,8729,6010.187748,2369.902011
Cell R93,9250,5045,270840270.1,1304,9904,8600,6782.444004,2055.204854
Cell R97,9250,5048,271001324.7,1029,9427,8398,7148.816363,1913.32189
Cell R98,9250,5048,271001324.7,1175,9904,8729,6561.748613,2306.016614
Cell R99,9250,5042,270679215.4,1375,9483,8108,6745.767751,2161.65988
Cell S102,9250,5048,271001324.7,5712,9085,3373,8179.361727,417.5243105
Cell S108,9250,5049,271055009.6,5568,9005,3437,8080.777184,505.4122991
Cell S13,9250,5049,271055009.6,5590,9168,3578,8046.796791,402.7609024
Cell S14,9250,5044,270786585.2,4961,9168,4207,7955.440127,526.46194
Cell S2,9250,5046,270893954.9,5597,8945,3348,8000.917162,396.1751129
Cell S23,9250,5048,271001324.7,4961,8877,3916,7929.945721,468.4503986
Cell S32,9250,5047,270947639.8,4978,8920,3942,7983.627501,472.9439872
Cell S33,9250,5047,270947639.8,4961,9021,4060,8048.583119,435.3098341
Cell S34,9250,5048,271001324.7,5645,9061,3416,7960.038431,486.5831189
Cell S41,9250,5047,270947639.8,2206,8914,6708,7696.064593,747.665514
Cell S42,9250,5041,270625530.5,5457,9061,3604,8103.680222,443.3800335
Cell S44,9250,5046,270893954.9,5645,9061,3416,7965.291518,515.7305233
Cell S56,9250,5050,271108694.5,5505,9061,3556,7731.613069,527.358659
Cell S67,9250,5052,271216064.3,5505,9059,3554,8006.212193,517.3288959
Cell S78,9250,5047,270947639.8,5043,9081,4038,8161.218546,506.0165278
Cell S88,9250,5054,271323434.1,4469,9085,4616,8192.335774,505.6316962
Cell S94,9250,5050,271108694.5,5543,9085,3542,8128.216238,476.8831884
Cell S95,9250,5049,271055009.6,5712,9085,3373,8156.668053,419.4424866
W287,9250,5041,270625530.5,894,9837,8943,4724.258084,2170.294227
W295,9250,5042,270679215.4,1465,9159,7694,6692.512297,1916.28614
W338,9250,5035,270303421.1,697,9484,8787,3800.513208,2310.576078
W342,9250,5037,270410790.9,894,8946,8052,5477.682946,2345.193831
W345,9250,5042,270679215.4,1609,8580,6971,7175.669972,1221.377059
W387,9250,5036,270357106,3,9470,9467,4784.274027,2306.871592
W393,9250,5038,270464475.8,728,9484,8756,5314.992259,2548.262464
W440,9250,5045,270840270.1,1073,9239,8166,5188.146482,2234.491188
W441,9250,5037,270410790.9,1101,9239,8138,6120.283502,1876.394515
W445,9250,5035,270303421.1,2175,8898,6723,6830.424826,1000.126426
W500,9250,5039,270518160.7,1196,8598,7402,6452.051994,1576.254887
1,9500,5319,285549929.9,-1954,9517,11471,6046.888137,2078.468283
2,9500,5319,285549929.9,-1958,9292,11250,6439.822147,1986.865833
3,9500,5316,285388875.2,-1958,9571,11529,7047.370203,1584.187689
4,9500,5317,285442560.1,1750,9571,7821,7438.02934,1219.036391
5,9500,5315,285335190.3,-1836,9972,11808,5445.949012,2263.592927
6,9500,5317,285442560.1,1036,9804,8768,6077.210833,2323.618854
7,9500,5323,285764669.5,1373,9571,8198,6204.749389,2127.297131
8,9500,5317,285442560.1,1806,9497,7691,7396.059244,1139.387478
9,9500,5317,285442560.1,4260,8920,4660,7959.677638,492.5438498
10,9500,5318,285496245,-1005,9882,10887,5080.549643,2679.179172
11,9500,5323,285764669.5,-92,9787,9879,6144.070449,2376.259283
12,9500,5319,285549929.9,705,9950,9245,4709.191389,2505.839368
13,9500,5323,285764669.5,1104,9552,8448,6378.256998,2119.916214
14,9500,5321,285657299.7,4412,9061,4649,8103.320804,479.7894203
16,9500,5321,285657299.7,-1781,9741,11522,4978.35125,2715.862579
17,9500,5316,285388875.2,-1781,9959,11740,6133.901618,2234.415319
18,9500,5321,285657299.7,418,9950,9532,4965.977448,2510.50205
19,9500,5322,285710984.6,540,9950,9410,5412.786734,2539.731763
20,9500,5322,285710984.6,1384,9400,8016,7799.271702,931.0033215
21,9500,5322,285710984.6,6337,9081,2744,8257.712514,410.5589059
22,9500,5319,285549929.9,-1781,9972,11753,4990.519083,2854.122667
23,9500,5325,285872039.2,418,9972,9554,6150.494272,2399.199102
24,9500,5319,285549929.9,853,9904,9051,6305.738297,2366.412058
25,9500,5330,286140463.7,1304,9904,8600,6771.800375,2073.140748
26,9500,5326,285925724.1,1499,9510,8011,8023.585805,729.5324727
27,9500,5320,285603614.8,1175,9904,8729,6519.854511,2314.703688
28,9500,5322,285710984.6,1301,9692,8391,7081.031379,1949.114356
29,9500,5321,285657299.7,1375,9692,8317,7167.781056,1764.840431
31,9500,5320,285603614.8,1168,9468,8300,7000.506015,1872.164207
32,9500,5324,285818354.4,1681,8980,7299,7303.156837,1162.98723
33,9500,5323,285764669.5,1254,9542,8288,6865.173586,1752.198246
34,9500,5324,285818354.4,1746,9079,7333,6968.086026,1124.846128
10A,9500,5318,285496245,-1005,9882,10887,5175.971982,2716.401864
10NE,9500,5316,285388875.2,-1005,9882,10887,5205.846689,2705.25855
10NW,9500,5321,285657299.7,-1836,9972,11808,5518.169893,2313.771313
10SW,9500,5323,285764669.5,-1005,9882,10887,5102.475108,2708.815822
11NE,9500,5318,285496245,-92,9804,9896,5817.24088,2520.894414
11NW,9500,5312,285174135.7,-92,9804,9896,6044.847515,2457.61207
11SE,9500,5321,285657299.7,-92,9787,9879,6124.312535,2326.062255
17NW,9500,5322,285710984.6,-908,9823,10731,5724.620443,2473.005943
17SE,9500,5318,285496245,-1781,9972,11753,5985.628996,2389.099842
17SW,9500,5324,285818354.4,-1781,9972,11753,5339.898948,2679.517807
22S,9500,5321,285657299.7,-1781,9972,11753,4942.93535,2851.019323
23S,9500,5320,285603614.8,1111,9571,8460,5354.214286,2389.240997
24S,9500,5324,285818354.4,853,9904,9051,6308.234222,2363.466007
27A,9500,5318,285496245,853,9427,8574,7077.750846,1973.988294
2A,9500,5314,285281505.5,-1958,9292,11250,6654.786978,1852.682487
5NE,9500,5318,285496245,-1836,9804,11640,5089.342422,2335.013416
5NW,9500,5318,285496245,-1836,9804,11640,5101.150809,2308.389559
5SE,9500,5316,285388875.2,-1836,9804,11640,5429.654251,2573.604733
6NE,9500,5325,285872039.2,1036,9292,8256,5953.511737,2239.138594
6NW,9500,5320,285603614.8,614,9804,9190,6024.025,2381.716651
6SW,9500,5318,285496245,-92,9804,9896,5677.615457,2635.00585
Cell 1 2011/12,9500,5319,285549929.9,-1954,9517,11471,6046.888137,2078.468283
Cell 1 SW 2013,9500,5317,285442560.1,-1428,9550,10978,5749.297536,2072.462633
Cell 10 2011/12,9500,5318,285496245,-1005,9882,10887,5080.549643,2679.179172
Cell 10 NE 2011/12,9500,5316,285388875.2,-1005,9882,10887,5205.846689,2705.25855
Cell 10 NW 2011/12,9500,5321,285657299.7,-1836,9972,11808,5518.169893,2313.771313
Cell 10 SE 2013,9500,5321,285657299.7,614,9804,9190,6024.133246,2381.505925
Cell 10 SW 2011/12,9500,5323,285764669.5,-1005,9882,10887,5102.475108,2708.815822
Cell 10-A 2011/12,9500,5318,285496245,-1005,9882,10887,5175.971982,2716.401864
Cell 11 NE 2011/12,9500,5318,285496245,-92,9804,9896,5817.24088,2520.894414
Cell 11 NW 2013,9500,5312,285174135.7,-1958,9292,11250,6537.266566,1925.878275
Cell 11 SW 2013,9500,5315,285335190.3,674,9804,9130,6084.292944,2265.68396
Cell 12 2013,9500,5322,285710984.6,1373,9571,8198,6202.938557,2127.059096
Cell 13 2013,9500,5317,285442560.1,1806,9548,7742,7386.771864,1144.517327
Cell 14 2013,9500,5318,285496245,1806,8863,7057,7673.762129,1041.37544
Cell 15 2013,9500,5325,285872039.2,4961,8963,4002,8032.966009,461.9451649
Cell 15-A 2013,9500,5322,285710984.6,4961,9021,4060,8053.099962,440.5606842
Cell 16 2013,9500,5327,285979409,5629,9021,3392,7996.784494,432.1023752
Cell 17 NW 2011/12,9500,5322,285710984.6,-908,9823,10731,5724.620443,2473.005943
Cell 17 NW 2013,9500,5316,285388875.2,-1836,9972,11808,5230.574304,2317.81809
Cell 17 SE 2013,9500,5321,285657299.7,-1836,9972,11808,5518.169893,2313.771313
Cell 17 SW 2013,9500,5315,285335190.3,-1836,9972,11808,5450.096707,2260.152049
Cell 18 2011/12,9500,5321,285657299.7,418,9950,9532,4965.977448,2510.50205
Cell 18 NE 2013,9500,5316,285388875.2,-92,9804,9896,5680.167419,2636.684478
Cell 18 NW 2013,9500,5319,285549929.9,-1836,9804,11640,5420.568716,2570.812327
Cell 18 SE 2013,9500,5318,285496245,-92,9804,9896,5817.24088,2520.894414
Cell 18 SSE 2013,9500,5318,285496245,-92,9804,9896,6088.808951,2427.479863
Cell 19 NW 2013,9500,5317,285442560.1,674,9804,9130,6215.91988,2251.953606
Cell 2 2011/12,9500,5319,285549929.9,-1958,9292,11250,6439.822147,1986.865833
Cell 2 NE 2013,9500,5320,285603614.8,-1958,9292,11250,6584.04812,1784.206107
Cell 2 SW 2013,9500,5318,285496245,-1954,9517,11471,6048.602482,2078.08087
Cell 20 2013,9500,5314,285281505.5,1335,9571,8236,6193.870531,2148.559081
Cell 21 2013,9500,5319,285549929.9,1368,9552,8184,7055.493326,1564.826067
Cell 22 2013,9500,5320,285603614.8,4978,8920,3942,7986.318797,481.9728062
Cell 23 2013,9500,5330,286140463.7,5457,9061,3604,8093.265854,444.4250814
Cell 24 2013,9500,5324,285818354.4,5645,9061,3416,7959.438956,491.7022207
Cell 25 NE 2013,9500,5318,285496245,-1005,9882,10887,5080.549643,2679.179172
Cell 25 SE 2013,9500,5323,285764669.5,-1005,9882,10887,5102.475108,2708.815822
Cell 26 NE 2013,9500,5323,285764669.5,-92,9787,9879,6144.070449,2376.259283
Cell 26 NNW 2013,9500,5317,285442560.1,-1005,9882,10887,5206.203686,2705.12937
Cell 26 NW 2013,9500,5318,285496245,-1005,9882,10887,5175.971982,2716.401864
Cell 27 NW 2013,9500,5322,285710984.6,-92,9787,9879,6124.596204,2325.935756
Cell 28 2013,9500,5320,285603614.8,705,9950,9245,4709.862218,2506.081451
Cell 29 2013,9500,5319,285549929.9,1104,9552,8448,6377.296296,2120.553031
Cell 3 NE 2013,9500,5312,285174135.7,-1958,9292,11250,7062.897967,1455.576296
Cell 3 NW 2013,9500,5318,285496245,-1958,9292,11250,6453.448101,1834.892693
Cell 30 2013,9500,5322,285710984.6,4051,8980,4929,8066.89534,475.7189446
Cell 31 2013,9500,5323,285764669.5,5623,9061,3438,8155.458388,466.6880546
Cell 32 2013,9500,5322,285710984.6,5505,9061,3556,8007.971815,519.4221444
Cell 33 NE 2013,9500,5321,285657299.7,-908,9823,10731,5725.294306,2472.749702
Cell 33 SE 2013,9500,5322,285710984.6,-1781,9972,11753,5341.124577,2679.268254
Cell 33 SW 2013,9500,5315,285335190.3,-1781,9741,11522,4978.860019,2711.83047
Cell 34 N 2013,9500,5315,285335190.3,457,9931,9474,6031.078833,2273.612944
Cell 34 NW 2013,9500,5316,285388875.2,-1781,9959,11740,6133.901618,2234.415319
Cell 34 SE 2013,9500,5319,285549929.9,-1781,9972,11753,5984.138184,2390.016367
Cell 35 2013,9500,5325,285872039.2,418,9950,9532,4909.810892,2531.92458
Cell 37 2013,9500,5324,285818354.4,1384,9400,8016,7804.094853,921.9189819
Cell 38 2013,9500,5324,285818354.4,6337,9081,2744,8257.579264,411.6182677
Cell 39 2013,9500,5320,285603614.8,5043,9081,4038,8151.521805,512.3909966
Cell 4 2013,9500,5324,285818354.4,-1067,9270,10337,7471.347295,1225.425877
Cell 40 NE 2013,9500,5325,285872039.2,-1781,9972,11753,5093.377465,2771.935696
Cell 41 N 2013,9500,5321,285657299.7,-1781,9972,11753,5603.524713,2606.754429
Cell 41 NW 2013,9500,5321,285657299.7,-1781,9972,11753,5280.67882,2838.058003
Cell 42 NW 2013,9500,5320,285603614.8,418,9972,9554,6121.316541,2413.672604
Cell 43 2013,9500,5328,286033093.9,540,9904,9364,6034.089902,2479.871236
Cell 44 2013,9500,5325,285872039.2,1292,9652,8360,7041.013146,1890.207958
Cell 45 2013,9500,5327,285979409,1499,9510,8011,8024.42294,727.3437384
Cell 47 2013,9500,5316,285388875.2,853,9571,8718,6664.687359,2217.80938
Cell 48 2013,9500,5321,285657299.7,853,9904,9051,6309.589739,2362.476345
Cell 49 2013,9500,5329,286086778.8,1304,9904,8600,6771.466879,2073.192291
Cell 5 2011/12 Summer,9500,5315,285335190.3,-1836,9972,11808,5450.096707,2260.152049
Cell 5 2013,9500,5320,285603614.8,2603,8863,6260,7898.718985,581.956468
Cell 50 2013,9500,5321,285657299.7,1375,9692,8317,7167.781056,1764.840431
Cell 51 2013,9500,5330,286140463.7,5712,9085,3373,8155.059475,423.1843721
Cell 52 2013,9500,5322,285710984.6,1301,9483,8182,6707.523112,2186.489249
Cell 53 2013,9500,5322,285710984.6,1301,9692,8391,7081.031379,1949.114356
Cell 54 2013,9500,5323,285764669.5,1681,9005,7324,7953.978396,855.5891013
Cell 55 2013,9500,5324,285818354.4,5568,9005,3437,8078.506011,504.5550339
Cell 56 2013,9500,5324,285818354.4,1254,9542,8288,6863.293576,1752.534983
Cell 57 2013,9500,5324,285818354.4,1681,8980,7299,7303.137303,1162.980649
Cell 58 2013,9500,5323,285764669.5,1681,8980,7299,7890.401465,999.943003
Cell 59 2013,9500,5326,285925724.1,1327,9542,8215,6773.735449,1689.780877
Cell 6 2011/12,9500,5317,285442560.1,1036,9804,8768,6077.210833,2323.618854
Cell 6 2013,9500,5320,285603614.8,5597,8945,3348,7998.453383,397.3595208
Cell 6 NE 2011/12,9500,5325,285872039.2,1036,9292,8256,5953.511737,2239.138594
Cell 6 NW 2011/12,9500,5320,285603614.8,614,9804,9190,6024.025,2381.716651
Cell 6 SW 2011/12,9500,5318,285496245,-92,9804,9896,5677.615457,2635.00585
Cell 60 2013,9500,5322,285710984.6,1841,9542,7701,6985.633596,1069.239043
Cell 61 2013,9500,5321,285657299.7,1894,8955,7061,7449.974629,1228.327958
Cell 7 2013,9500,5329,286086778.8,4961,9168,4207,7956.683993,525.5884709
Cell 9 NW 2013,9500,5321,285657299.7,-1836,9736,11572,5290.883668,2318.194946
Cell 9 SE 2013,9500,5317,285442560.1,-1836,9804,11640,5088.945458,2335.05355
Cell 9 SW 2013,9500,5319,285549929.9,-1836,9804,11640,5101.323369,2307.866148
Cell R1,9500,5324,285818354.4,1080,9517,8437,5725.429564,1851.331735
Cell R10,9500,5324,285818354.4,-1067,9270,10337,7471.347295,1225.425877
Cell R100,9500,5321,285657299.7,1375,9692,8317,7167.781056,1764.840431
Cell R101,9500,5328,286033093.9,1375,9692,8317,7703.220158,1216.70372
Cell R104,9500,5326,285925724.1,1301,9468,8167,7113.177244,1930.215633
Cell R105,9500,5322,285710984.6,1301,9692,8391,7081.031379,1949.114356
Cell R106,9500,5324,285818354.4,1375,9692,8317,7482.635049,1397.015966
Cell R107,9500,5323,285764669.5,1681,9005,7324,7953.978396,855.5891013
Cell R11,9500,5320,285603614.8,2603,8863,6260,7898.718985,581.956468
Cell R111,9500,5324,285818354.4,1168,9468,8300,6800.843351,2150.041023
Cell R112,9500,5321,285657299.7,1681,9074,7393,7434.331705,1149.131472
Cell R113,9500,5323,285764669.5,1681,8980,7299,7303.073455,1163.080554
Cell R114,9500,5323,285764669.5,1681,8980,7299,7890.401465,999.943003
Cell R117,9500,5324,285818354.4,1168,9542,8374,6417.744929,2116.604403
Cell R118,9500,5324,285818354.4,1254,9542,8288,6863.293576,1752.534983
Cell R119,9500,5327,285979409,1681,8980,7299,7176.073963,1186.012936
Cell R120,9500,5334,286355203.3,1746,8874,7128,7429.056243,1280.899212
Cell R121,9500,5323,285764669.5,2412,8955,6543,8055.322938,655.5491422
Cell R123,9500,5322,285710984.6,1318,9889,8571,6699.268508,1782.997238
Cell R124,9500,5323,285764669.5,1894,8824,6930,6995.415555,1028.602125
Cell R125,9500,5325,285872039.2,1894,8780,6886,6905.949859,1062.429427
Cell R126,9500,5321,285657299.7,1894,8874,6980,7357.50141,1236.631691
Cell R15,9500,5318,285496245,-1428,9550,10978,5749.31572,2072.268194
Cell R16,9500,5315,285335190.3,-1836,9736,11572,5292.141675,2318.515104
Cell R17,9500,5317,285442560.1,614,9513,8899,6108.999436,2236.933765
Cell R18,9500,5320,285603614.8,-1958,9292,11250,6547.891729,1922.272563
Cell R19,9500,5322,285710984.6,1025,9571,8546,6719.266441,1805.840638
Cell R20,9500,5316,285388875.2,1806,9498,7692,7533.120579,1096.650125
Cell R21,9500,5314,285281505.5,1806,8863,7057,7505.141137,1161.604576
Cell R22,9500,5318,285496245,1806,8863,7057,7673.528206,1041.462962
Cell R24,9500,5316,285388875.2,-1836,9972,11808,5230.153875,2318.342586
Cell R25,9500,5317,285442560.1,-1836,9804,11640,5419.655821,2570.848987
Cell R26,9500,5322,285710984.6,614,9804,9190,6024.047539,2376.681071
Cell R27,9500,5317,285442560.1,674,9804,9130,6215.407749,2251.98821
Cell R28,9500,5319,285549929.9,1356,9571,8215,5805.159428,2279.245651
Cell R29,9500,5315,285335190.3,1335,9571,8236,6195.092756,2148.293139
Cell R30,9500,5320,285603614.8,1806,8855,7049,7489.530451,1095.024301
Cell R31,9500,5322,285710984.6,1872,8863,6991,7699.939496,896.6323409
Cell R35,9500,5317,285442560.1,-1836,9972,11808,5450.628362,2259.900845
Cell R36,9500,5321,285657299.7,-1836,9972,11808,5518.169893,2313.771313
Cell R37,9500,5318,285496245,-92,9804,9896,5817.24088,2520.894414
Cell R38,9500,5323,285764669.5,264,9787,9523,5557.224122,2514.714051
Cell R39,9500,5323,285764669.5,1319,9552,8233,6377.161939,2128.719658
Cell R40,9500,5318,285496245,1368,9552,8184,7055.289583,1564.90264
Cell R46,9500,5312,285174135.7,-1005,9882,10887,5260.688441,2672.979878
Cell R47,9500,5319,285549929.9,-1005,9882,10887,5176.264335,2716.230174
Cell R48,9500,5323,285764669.5,-92,9787,9879,6144.070449,2376.259283
Cell R49,9500,5321,285657299.7,-92,9787,9879,6124.312535,2326.062255
Cell R5,9500,5316,285388875.2,-1428,9210,10638,5648.697141,2015.352149
Cell R50,9500,5320,285603614.8,705,9950,9245,4709.862218,2506.081451
Cell R51,9500,5320,285603614.8,1104,9552,8448,6389.03797,2114.405303
Cell R52,9500,5319,285549929.9,2206,9552,7346,7643.892085,774.9195421
Cell R53,9500,5320,285603614.8,2206,8914,6708,7708.068985,721.9349779
Cell R54,9500,5323,285764669.5,5623,9061,3438,8155.458388,466.6880546
Cell R58,9500,5316,285388875.2,-1005,9882,10887,5159.685666,2738.628171
Cell R59,9500,5322,285710984.6,-908,9823,10731,5724.620443,2473.005943
Cell R6,9500,5316,285388875.2,-1954,9517,11471,6047.713883,2077.961797
Cell R60,9500,5316,285388875.2,-1781,9959,11740,6133.901618,2234.415319
Cell R61,9500,5327,285979409,418,9950,9532,4910.617608,2531.811851
Cell R62,9500,5319,285549929.9,540,9950,9410,5403.818575,2543.944956
Cell R63,9500,5319,285549929.9,1104,9552,8448,6122.687723,2321.174074
Cell R64,9500,5322,285710984.6,1919,9047,7128,7954.134724,555.4760268
Cell R65,9500,5322,285710984.6,4051,8980,4929,8067.011086,475.6447414
Cell R66,9500,5328,286033093.9,5623,8980,3357,8109.14452,455.6314128
Cell R69,9500,5315,285335190.3,-1781,9741,11522,4977.862841,2712.441307
Cell R7,9500,5318,285496245,-1958,9292,11250,6453.448101,1834.892693
Cell R70,9500,5322,285710984.6,-1781,9972,11753,5341.124577,2679.268254
Cell R71,9500,5317,285442560.1,-1781,9972,11753,5983.552191,2390.255055
Cell R72,9500,5314,285281505.5,418,9959,9541,5530.621754,2599.592467
Cell R73,9500,5321,285657299.7,418,9950,9532,4726.129299,2596.936029
Cell R74,9500,5322,285710984.6,540,9400,8860,6340.410748,2366.598516
Cell R75,9500,5324,285818354.4,1384,9400,8016,7804.094853,921.9189819
Cell R76,9500,5327,285979409,5854,8980,3126,8169.803079,390.1849052
Cell R77,9500,5325,285872039.2,6337,9081,2744,8257.558685,411.5823552
Cell R8,9500,5316,285388875.2,-1958,9292,11250,6995.538563,1506.855458
Cell R80,9500,5324,285818354.4,-1781,9972,11753,5093.052404,2772.068925
Cell R81,9500,5323,285764669.5,-1781,9972,11753,5636.595153,2637.709854
Cell R82,9500,5320,285603614.8,418,9972,9554,6121.316541,2413.672604
Cell R83,9500,5318,285496245,418,9571,9153,6339.520496,2376.038567
Cell R84,9500,5320,285603614.8,540,9904,9364,5807.16015,2533.007861
Cell R85,9500,5328,286033093.9,540,9904,9364,6034.089902,2479.871236
Cell R86,9500,5320,285603614.8,1304,9629,8325,7569.162406,1450.874337
Cell R87,9500,5327,285979409,1499,9510,8011,8024.42294,727.3437384
Cell R9,9500,5325,285872039.2,-1958,9292,11250,7198.893146,1386.922864
Cell R90,9500,5316,285388875.2,853,9571,8718,6664.687359,2217.80938
Cell R91,9500,5322,285710984.6,853,9904,9051,6309.262495,2362.374986
Cell R92,9500,5318,285496245,1175,9904,8729,6080.3868,2349.681192
Cell R93,9500,5328,286033093.9,1304,9904,8600,6771.290165,2073.346707
Cell R97,9500,5319,285549929.9,1029,9427,8398,7131.616281,1930.551343
Cell R98,9500,5320,285603614.8,1175,9904,8729,6520.902068,2313.896677
Cell R99,9500,5323,285764669.5,1301,9483,8182,6706.537291,2187.4664
Cell S102,9500,5326,285925724.1,5712,9085,3373,8172.003567,424.7463538
Cell S108,9500,5323,285764669.5,5568,9005,3437,8078.399775,504.542883
Cell S13,9500,5321,285657299.7,4961,9168,4207,8042.404623,409.2099267
Cell S14,9500,5327,285979409,4961,9168,4207,7956.748076,525.6725539
Cell S2,9500,5320,285603614.8,5597,8945,3348,7998.453383,397.3595208
Cell S23,9500,5321,285657299.7,4961,8886,3925,7932.794024,468.9175142
Cell S32,9500,5319,285549929.9,4978,8920,3942,7983.913142,473.3856055
Cell S33,9500,5322,285710984.6,4961,9021,4060,8053.099962,440.5606842
Cell S34,9500,5324,285818354.4,5645,9061,3416,7959.438956,491.7022207
Cell S41,9500,5317,285442560.1,2206,8914,6708,7687.849163,764.4348909
Cell S42,9500,5330,286140463.7,5457,9061,3604,8093.204315,444.4396528
Cell S44,9500,5321,285657299.7,5645,9061,3416,7965.341665,517.0347543
Cell S56,9500,5322,285710984.6,5505,9061,3556,7740.601466,527.3803053
Cell S67,9500,5323,285764669.5,5505,9061,3556,8007.965997,519.3735252
Cell S78,9500,5321,285657299.7,5043,9081,4038,8151.296749,512.5119426
Cell S88,9500,5323,285764669.5,4469,9085,4616,8184.594965,506.4126604
Cell S94,9500,5325,285872039.2,5543,9085,3542,8122.372582,485.1119832
Cell S95,9500,5332,286247833.5,5712,9085,3373,8155.228245,423.1960322
W287,9500,5314,285281505.5,894,9837,8943,4765.095032,2182.180572
W295,9500,5316,285388875.2,1217,9159,7942,6673.281415,1940.267912
W338,9500,5318,285496245,697,9484,8787,3848.469914,2306.341993
W342,9500,5321,285657299.7,894,8946,8052,5494.202406,2337.637394
W345,9500,5316,285388875.2,1609,8580,6971,7146.75696,1262.175353
W387,9500,5316,285388875.2,3,9470,9467,4817.996238,2304.591502
W393,9500,5315,285335190.3,728,9484,8756,5300.086736,2550.928467
W440,9500,5312,285174135.7,1073,9239,8166,5161.583208,2241.973156
W441,9500,5313,285227820.6,1101,9239,8138,6092.222097,1897.108356
W445,9500,5317,285442560.1,2150,8898,6748,6821.495204,1016.326751
W500,9500,5311,285120450.8,1196,8598,7402,6471.299379,1560.945782
1,9750,5601,300689068.9,-1954,9517,11471,6053.436708,2073.864002
2,9750,5602,300742753.8,-1958,9292,11250,6447.328633,1989.550828
3,9750,5605,300903808.4,-1958,9571,11529,7040.127208,1590.030256
4,9750,5604,300850123.6,1681,9571,7890,7424.549786,1254.123814
5,9750,5604,300850123.6,-1836,9972,11808,5445.287652,2267.283448
6,9750,5596,300420644.4,1036,9804,8768,6041.219442,2337.020158
7,9750,5601,300689068.9,1373,9571,8198,6205.95108,2126.102406
8,9750,5611,301225917.8,1806,9548,7742,7417.638211,1124.420915
9,9750,5612,301279602.7,4260,8920,4660,7954.913756,497.7990933
10,9750,5597,300474329.3,-1005,9882,10887,5091.277649,2680.829117
11,9750,5596,300420644.4,-92,9787,9879,6115.225876,2387.363702
12,9750,5594,300313274.7,705,9950,9245,4774.324991,2511.852764
13,9750,5601,300689068.9,1104,9552,8448,6364.846456,2140.079248
14,9750,5610,301172232.9,4412,9061,4649,8102.091087,482.5810102
16,9750,5596,300420644.4,-1781,9741,11522,4949.724267,2727.770306
17,9750,5601,300689068.9,-1781,9959,11740,6056.552937,2282.847125
18,9750,5606,300957493.3,418,9950,9532,4977.294149,2508.878509
19,9750,5605,300903808.4,540,9950,9410,5491.216057,2533.143176
20,9750,5605,300903808.4,1292,9400,8108,7752.216949,1051.099818
21,9750,5608,301064863.1,6337,9081,2744,8253.919044,413.9263799
22,9750,5600,300635384,-1781,9972,11753,5025.631429,2846.980793
23,9750,5613,301333287.6,418,9972,9554,6138.308213,2413.621383
24,9750,5603,300796438.7,853,9904,9051,6293.9859,2375.14014
25,9750,5612,301279602.7,1304,9904,8600,6769.097113,2081.842643
26,9750,5609,301118548,1499,9629,8130,8011.174184,772.9901749
27,9750,5611,301225917.8,1175,9904,8729,6494.578685,2312.118306
28,9750,5611,301225917.8,1301,9692,8391,7081.841739,1948.538178
29,9750,5605,300903808.5,1375,9692,8317,7170.511151,1774.47264
31,9750,5606,300957493.3,1168,9468,8300,6970.491973,1893.565665
32,9750,5611,301225917.8,1681,8980,7299,7322.808947,1147.814631
33,9750,5602,300742753.8,1226,9542,8316,6835.40075,1782.129852
34,9750,5611,301225917.8,1746,9542,7796,6982.919088,1127.952329
10A,9750,5597,300474329.3,-1005,9882,10887,5241.368233,2702.879456
10NE,9750,5599,300581699.1,-1005,9882,10887,5241.583854,2697.631733
10NW,9750,5608,301064863.1,-1836,9972,11808,5502.690977,2322.121545
10SW,9750,5596,300420644.4,-1005,9882,10887,5087.892423,2704.72704
11NE,9750,5607,301011178.2,-92,9804,9896,5794.850722,2535.964781
11NW,9750,5599,300581699.1,-92,9804,9896,6045.332559,2454.190623
11SE,9750,5603,300796438.7,-92,9787,9879,6075.895413,2347.444677
17NW,9750,5601,300689068.9,-908,9823,10731,5683.469559,2488.202675
17SE,9750,5605,300903808.5,-1781,9972,11753,5971.644603,2397.40688
17SW,9750,5596,300420644.4,-1781,9972,11753,5338.716047,2677.990906
22S,9750,5608,301064863.1,-1781,9972,11753,5000.628388,2841.093198
23S,9750,5592,300205904.9,1111,9571,8460,5427.574213,2387.245496
24S,9750,5609,301118548,853,9904,9051,6286.730612,2374.181899
27A,9750,5602,300742753.8,853,9427,8574,7072.97483,1979.34739
2A,9750,5601,300689068.9,-1958,9292,11250,6650.507231,1865.420452
5NE,9750,5601,300689068.9,-1836,9804,11640,5127.501518,2332.873613
5NW,9750,5601,300689068.9,-1836,9804,11640,5099.702553,2310.647149
5SE,9750,5599,300581699.1,-1836,9804,11640,5467.927308,2563.750006
6NE,9750,5606,300957493.3,674,9292,8618,5928.7467,2251.555977
6NW,9750,5606,300957493.3,614,9804,9190,6021.331966,2370.220334
6SW,9750,5607,301011178.2,-92,9804,9896,5648.462101,2632.843752
Cell 1 2011/12,9750,5601,300689068.9,-1954,9517,11471,6053.436708,2073.864002
Cell 1 SW 2013,9750,5595,300366959.5,-1428,9550,10978,5748.935478,2070.253752
Cell 10 2011/12,9750,5597,300474329.3,-1005,9882,10887,5091.277649,2680.829117
Cell 10 NE 2011/12,9750,5599,300581699.1,-1005,9882,10887,5241.583854,2697.631733
Cell 10 NW 2011/12,9750,5608,301064863.1,-1836,9972,11808,5502.690977,2322.121545
Cell 10 SE 2013,9750,5605,300903808.4,614,9804,9190,6021.128278,2370.382703
Cell 10 SW 2011/12,9750,5596,300420644.4,-1005,9882,10887,5087.892423,2704.72704
Cell 10-A 2011/12,9750,5597,300474329.3,-1005,9882,10887,5241.368233,2702.879456
Cell 11 NE 2011/12,9750,5607,301011178.2,-92,9804,9896,5794.850722,2535.964781
Cell 11 NW 2013,9750,5605,300903808.5,-1958,9292,11250,6542.331133,1928.483346
Cell 11 SW 2013,9750,5602,300742753.8,674,9804,9130,6038.784006,2285.11491
Cell 12 2013,9750,5603,300796438.7,1373,9571,8198,6205.040157,2126.697508
Cell 13 2013,9750,5608,301064863.1,1806,9548,7742,7400.240014,1142.248552
Cell 14 2013,9750,5603,300796438.7,1806,8863,7057,7652.241121,1071.02545
Cell 15 2013,9750,5609,301118548,4961,8963,4002,8031.575682,467.2160991
Cell 15-A 2013,9750,5615,301440657.4,4961,9021,4060,8056.829029,442.8602058
Cell 16 2013,9750,5610,301172232.9,5629,9021,3392,7993.227986,439.6968611
Cell 17 NW 2011/12,9750,5601,300689068.9,-908,9823,10731,5683.469559,2488.202675
Cell 17 NW 2013,9750,5605,300903808.5,-1836,9972,11808,5220.274219,2318.737799
Cell 17 SE 2013,9750,5607,301011178.2,-1836,9972,11808,5501.53344,2322.446549
Cell 17 SW 2013,9750,5595,300366959.5,-1836,9972,11808,5451.710813,2264.054631
Cell 18 2011/12,9750,5606,300957493.3,418,9950,9532,4977.294149,2508.878509
Cell 18 NE 2013,9750,5600,300635384,-92,9804,9896,5641.604643,2632.563785
Cell 18 NW 2013,9750,5602,300742753.8,-1836,9804,11640,5460.567476,2561.406393
Cell 18 SE 2013,9750,5606,300957493.3,-92,9804,9896,5795.429897,2535.82013
Cell 18 SSE 2013,9750,5600,300635384,-92,9804,9896,6069.339821,2437.16436
Cell 19 NW 2013,9750,5603,300796438.7,674,9804,9130,6154.806354,2270.207981
Cell 2 2011/12,9750,5602,300742753.8,-1958,9292,11250,6447.328633,1989.550828
Cell 2 NE 2013,9750,5608,301064863.1,-1958,9292,11250,6573.027639,1790.090743
Cell 2 SW 2013,9750,5604,300850123.6,-1954,9517,11471,6050.79586,2075.399167
Cell 20 2013,9750,5606,300957493.3,1335,9571,8236,6188.277025,2154.185681
Cell 21 2013,9750,5603,300796438.7,1319,9552,8233,7026.832947,1609.889922
Cell 22 2013,9750,5612,301279602.7,4978,8920,3942,7986.610478,481.0712388
Cell 23 2013,9750,5613,301333287.6,5457,9061,3604,8084.89649,444.6345006
Cell 24 2013,9750,5612,301279602.7,5645,9061,3416,7958.55809,496.7186913
Cell 25 NE 2013,9750,5596,300420644.4,-1005,9882,10887,5090.768049,2680.797557
Cell 25 SE 2013,9750,5596,300420644.4,-1005,9882,10887,5087.892423,2704.72704
Cell 26 NE 2013,9750,5596,300420644.4,-92,9787,9879,6115.225876,2387.363702
Cell 26 NNW 2013,9750,5598,300528014.2,-1005,9882,10887,5241.025009,2697.548576
Cell 26 NW 2013,9750,5597,300474329.3,-1005,9882,10887,5241.368233,2702.879456
Cell 27 NW 2013,9750,5602,300742753.8,-92,9787,9879,6076.463584,2347.268929
Cell 28 2013,9750,5593,300259589.8,705,9950,9245,4774.453782,2512.058839
Cell 29 2013,9750,5601,300689068.9,1104,9552,8448,6365.934297,2139.935794
Cell 3 NE 2013,9750,5602,300742753.8,-1958,9292,11250,7049.592645,1467.044101
Cell 3 NW 2013,9750,5608,301064863.1,-1958,9292,11250,6436.348431,1857.44871
Cell 30 2013,9750,5609,301118548,4051,8980,4929,8061.193796,479.9253375
Cell 31 2013,9750,5601,300689068.9,5623,9061,3438,8149.843421,469.4553009
Cell 32 2013,9750,5612,301279602.7,5505,9061,3556,8008.153243,523.0645211
Cell 33 NE 2013,9750,5600,300635384,-908,9823,10731,5683.126786,2488.292594
Cell 33 SE 2013,9750,5594,300313274.7,-1781,9972,11753,5338.294065,2678.347241
Cell 33 SW 2013,9750,5602,300742753.8,-1781,9741,11522,4949.612995,2727.627045
Cell 34 N 2013,9750,5602,300742753.8,457,9931,9474,6010.663335,2279.089488
Cell 34 NW 2013,9750,5602,300742753.8,-1781,9959,11740,6055.568725,2283.831486
Cell 34 SE 2013,9750,5604,300850123.6,-1781,9972,11753,5969.900071,2397.24075
Cell 35 2013,9750,5611,301225917.8,418,9950,9532,4936.527357,2523.983186
Cell 37 2013,9750,5606,300957493.3,1292,9400,8108,7764.313236,1025.985467
Cell 38 2013,9750,5603,300796438.7,6337,9081,2744,8253.459932,414.976002
Cell 39 2013,9750,5610,301172232.9,4745,9081,4336,8140.567201,522.1381448
Cell 4 2013,9750,5609,301118548,-1067,9498,10565,7443.150472,1286.224843
Cell 40 NE 2013,9750,5609,301118548,-1781,9972,11753,5139.137279,2756.725964
Cell 41 N 2013,9750,5597,300474329.3,-1781,9972,11753,5545.798642,2638.785106
Cell 41 NW 2013,9750,5602,300742753.8,-1781,9972,11753,5236.131382,2841.26126
Cell 42 NW 2013,9750,5598,300528014.2,418,9972,9554,6110.38085,2424.783464
Cell 43 2013,9750,5598,300528014.2,540,9904,9364,6058.374598,2472.68738
Cell 44 2013,9750,5601,300689068.9,1292,9841,8549,7004.613819,1926.057327
Cell 45 2013,9750,5609,301118548,1499,9629,8130,8011.389731,773.110524
Cell 47 2013,9750,5605,300903808.5,853,9571,8718,6631.661731,2237.845613
Cell 48 2013,9750,5606,300957493.3,853,9904,9051,6285.517125,2374.901034
Cell 49 2013,9750,5613,301333287.6,1304,9904,8600,6768.287547,2082.540452
Cell 5 2011/12 Summer,9750,5596,300420644.4,-1836,9972,11808,5451.83792,2263.872294
Cell 5 2013,9750,5607,301011178.2,2161,8863,6702,7888.120385,627.5642104
Cell 50 2013,9750,5605,300903808.5,1375,9692,8317,7170.511151,1774.47264
Cell 51 2013,9750,5596,300420644.4,5712,9085,3373,8153.944246,424.8758299
Cell 52 2013,9750,5607,301011178.2,1301,9524,8223,6676.841448,2211.188882
Cell 53 2013,9750,5612,301279602.7,1301,9692,8391,7081.888988,1948.36778
Cell 54 2013,9750,5610,301172232.9,1681,9017,7336,7947.309626,868.383768
Cell 55 2013,9750,5615,301440657.3,5568,9005,3437,8074.748887,505.1964371
Cell 56 2013,9750,5600,300635384,1226,9542,8316,6832.1525,1784.317877
Cell 57 2013,9750,5609,301118548,1681,8980,7299,7322.210554,1147.835463
Cell 58 2013,9750,5612,301279602.7,1681,8980,7299,7877.382751,1004.599926
Cell 59 2013,9750,5614,301386972.5,1327,9730,8403,6767.585679,1692.387517
Cell 6 2011/12,9750,5596,300420644.4,1036,9804,8768,6041.219442,2337.020158
Cell 6 2013,9750,5601,300689068.9,5597,8945,3348,7998.70541,395.2546999
Cell 6 NE 2011/12,9750,5606,300957493.3,674,9292,8618,5928.7467,2251.555977
Cell 6 NW 2011/12,9750,5606,300957493.3,614,9804,9190,6021.331966,2370.220334
Cell 6 SW 2011/12,9750,5607,301011178.2,-92,9804,9896,5648.462101,2632.843752
Cell 60 2013,9750,5605,300903808.5,1746,9542,7796,6979.723283,1085.391959
Cell 61 2013,9750,5608,301064863.1,1894,8955,7061,7460.691512,1221.032298
Cell 7 2013,9750,5599,300581699.1,4961,9168,4207,7956.427398,523.8859869
Cell 9 NW 2013,9750,5597,300474329.3,-1836,9736,11572,5316.282651,2320.202998
Cell 9 SE 2013,9750,5601,300689068.9,-1836,9804,11640,5127.501518,2332.873613
Cell 9 SW 2013,9750,5599,300581699.1,-1836,9804,11640,5098.828898,2310.578818
Cell R1,9750,5617,301548027.1,1080,9517,8437,5741.554923,1839.500028
Cell R10,9750,5610,301172232.9,-1067,9498,10565,7443.031729,1286.140947
Cell R100,9750,5605,300903808.5,1375,9692,8317,7170.511151,1774.47264
Cell R101,9750,5607,301011178.2,1375,9692,8317,7676.04209,1272.47974
Cell R104,9750,5613,301333287.6,1301,9468,8167,7087.845893,1957.307153
Cell R105,9750,5613,301333287.6,1301,9692,8391,7082.024229,1948.220558
Cell R106,9750,5604,300850123.6,1375,9692,8317,7481.150071,1409.143678
Cell R107,9750,5610,301172232.9,1681,9017,7336,7947.309626,868.383768
Cell R11,9750,5607,301011178.2,2161,8863,6702,7888.031389,627.5817347
Cell R111,9750,5613,301333287.6,1168,9468,8300,6809.319437,2138.635307
Cell R112,9750,5610,301172232.9,1681,9074,7393,7403.917825,1194.796991
Cell R113,9750,5610,301172232.9,1681,8980,7299,7322.298574,1147.752086
Cell R114,9750,5612,301279602.7,1681,8980,7299,7877.382751,1004.599926
Cell R117,9750,5609,301118548,1168,9542,8374,6431.380103,2111.91639
Cell R118,9750,5599,300581699.1,1226,9542,8316,6832.161279,1784.477092
Cell R119,9750,5611,301225917.8,1681,8980,7299,7194.176974,1184.677719
Cell R120,9750,5619,301655396.9,1746,8874,7128,7434.641395,1280.791476
Cell R121,9750,5616,301494342.2,2412,8955,6543,8049.238248,663.1300492
Cell R123,9750,5610,301172232.9,1318,9889,8571,6687.790018,1786.17094
Cell R124,9750,5603,300796438.7,1894,9542,7648,6988.074246,1042.603244
Cell R125,9750,5599,300581699.1,1894,8780,6886,6922.767101,1056.810661
Cell R126,9750,5604,300850123.6,1841,8874,7033,7376.541577,1230.325671
Cell R15,9750,5595,300366959.5,-1428,9550,10978,5748.935478,2070.253752
Cell R16,9750,5596,300420644.4,-1836,9736,11572,5319.68263,2320.619083
Cell R17,9750,5597,300474329.3,614,9513,8899,6128.340897,2216.86428
Cell R18,9750,5592,300205904.9,-1958,9292,11250,6552.221388,1923.453662
Cell R19,9750,5603,300796438.7,-1005,9571,10576,6691.867571,1826.918559
Cell R20,9750,5605,300903808.4,1806,9498,7692,7547.463158,1089.439107
Cell R21,9750,5606,300957493.3,1806,8863,7057,7524.033535,1140.623486
Cell R22,9750,5603,300796438.7,1806,8863,7057,7652.21899,1071.020413
Cell R24,9750,5605,300903808.5,-1836,9972,11808,5220.274219,2318.737799
Cell R25,9750,5602,300742753.8,-1836,9804,11640,5460.567476,2561.406393
Cell R26,9750,5606,300957493.3,614,9804,9190,6018.627007,2371.422725
Cell R27,9750,5603,300796438.7,674,9804,9130,6153.975906,2270.711596
Cell R28,9750,5608,301064863.1,1356,9571,8215,5805.403352,2273.606907
Cell R29,9750,5606,300957493.3,1335,9571,8236,6188.277025,2154.185681
Cell R30,9750,5611,301225917.8,1806,8914,7108,7496.364463,1090.171535
Cell R31,9750,5602,300742753.8,1872,8863,6991,7696.436094,926.9917121
Cell R35,9750,5595,300366959.5,-1836,9972,11808,5451.710813,2264.054631
Cell R36,9750,5607,301011178.2,-1836,9972,11808,5502.587837,2322.315765
Cell R37,9750,5607,301011178.2,-92,9804,9896,5794.715534,2535.829576
Cell R38,9750,5596,300420644.4,-92,9787,9879,5524.820765,2526.737355
Cell R39,9750,5600,300635384,1319,9552,8233,6356.785536,2132.956835
Cell R40,9750,5605,300903808.5,1319,9552,8233,7025.570919,1611.510022
Cell R46,9750,5601,300689068.9,-1005,9882,10887,5246.400821,2666.15248
Cell R47,9750,5597,300474329.3,-1005,9882,10887,5241.368233,2702.879456
Cell R48,9750,5596,300420644.4,-92,9787,9879,6115.225876,2387.363702
Cell R49,9750,5601,300689068.9,-92,9787,9879,6077.260311,2346.72093
Cell R5,9750,5604,300850123.6,-1428,9210,10638,5629.718951,2032.738743
Cell R50,9750,5592,300205904.9,705,9950,9245,4774.710658,2512.209989
Cell R51,9750,5601,300689068.9,1104,9552,8448,6372.038207,2137.323874
Cell R52,9750,5603,300796438.7,1847,9552,7705,7639.627342,788.8924938
Cell R53,9750,5607,301011178.2,2206,8914,6708,7711.243802,719.6596678
Cell R54,9750,5600,300635384,5623,9061,3438,8149.933036,469.4493092
Cell R58,9750,5603,300796438.7,-1005,9882,10887,5177.040692,2742.660201
Cell R59,9750,5602,300742753.8,-908,9823,10731,5683.02267,2488.360393
Cell R6,9750,5604,300850123.6,-1954,9517,11471,6050.950214,2075.55212
Cell R60,9750,5601,300689068.9,-1781,9959,11740,6056.339939,2283.305847
Cell R61,9750,5609,301118548,418,9950,9532,4937.220717,2524.093932
Cell R62,9750,5601,300689068.9,540,9950,9410,5474.70291,2534.614256
Cell R63,9750,5605,300903808.5,1104,9552,8448,6095.370205,2351.414025
Cell R64,9750,5613,301333287.6,1919,9400,7481,7950.161055,578.3827533
Cell R65,9750,5609,301118548,4051,8980,4929,8061.193796,479.9253375
Cell R66,9750,5598,300528014.2,5623,8980,3357,8105.021972,455.6072016
Cell R69,9750,5601,300689068.9,-1781,9741,11522,4950.404749,2727.226774
Cell R7,9750,5607,301011178.2,-1958,9292,11250,6436.890137,1857.17134
Cell R70,9750,5596,300420644.4,-1781,9972,11753,5338.716047,2677.990906
Cell R71,9750,5602,300742753.8,-1781,9972,11753,5970.290789,2396.749465
Cell R72,9750,5604,300850123.6,418,9959,9541,5528.455389,2604.315962
Cell R73,9750,5599,300581699.1,418,9950,9532,4738.844794,2591.82042
Cell R74,9750,5607,301011178.2,540,9400,8860,6347.69003,2363.24348
Cell R75,9750,5606,300957493.3,1292,9400,8108,7764.313236,1025.985467
Cell R76,9750,5603,300796438.7,5854,8980,3126,8163.091201,390.5220709
Cell R77,9750,5601,300689068.9,6337,9081,2744,8253.305481,414.9681708
Cell R8,9750,5609,301118548,-1958,9292,11250,6995.100374,1514.222864
Cell R80,9750,5609,301118548,-1781,9972,11753,5139.137279,2756.725964
Cell R81,9750,5603,300796438.7,-1781,9972,11753,5619.44851,2645.828993
Cell R82,9750,5598,300528014.2,418,9972,9554,6110.38085,2424.783464
Cell R83,9750,5602,300742753.8,418,9571,9153,6322.646555,2382.238607
Cell R84,9750,5609,301118548,540,9904,9364,5819.889107,2533.825946
Cell R85,9750,5596,300420644.4,540,9904,9364,6057.640636,2472.822722
Cell R86,9750,5609,301118548,1304,9629,8325,7548.957746,1492.235678
Cell R87,9750,5610,301172232.9,1499,9629,8130,8011.424599,773.046027
Cell R9,9750,5610,301172232.9,-1958,9292,11250,7179.02139,1414.056488
Cell R90,9750,5605,300903808.5,853,9571,8718,6631.661731,2237.845613
Cell R91,9750,5606,300957493.3,853,9904,9051,6285.517125,2374.901034
Cell R92,9750,5602,300742753.8,1175,9904,8729,6142.875402,2329.289885
Cell R93,9750,5613,301333287.6,1304,9904,8600,6768.287547,2082.540452
Cell R97,9750,5598,300528014.2,853,9427,8574,7113.289389,1948.4206
Cell R98,9750,5612,301279602.7,1175,9904,8729,6494.947969,2311.906573
Cell R99,9750,5608,301064863.1,1301,9524,8223,6676.840585,2210.991728
Cell S102,9750,5609,301118548,5712,9085,3373,8169.00731,428.0339891
Cell S108,9750,5615,301440657.3,5568,9005,3437,8074.748887,505.1964371
Cell S13,9750,5605,300903808.5,4961,9168,4207,8031.709723,419.8539177
Cell S14,9750,5599,300581699.1,4961,9168,4207,7956.427398,523.8859869
Cell S2,9750,5601,300689068.9,5597,8945,3348,7998.70541,395.2546999
Cell S23,9750,5613,301333287.6,4961,8945,3984,7936.898985,468.5547893
Cell S32,9750,5607,301011178.2,4978,8920,3942,7983.485643,474.0525001
Cell S33,9750,5615,301440657.4,4961,9021,4060,8056.829029,442.8602058
Cell S34,9750,5610,301172232.9,5645,9061,3416,7958.58467,496.7936046
Cell S41,9750,5606,300957493.3,2206,8914,6708,7682.972351,781.7501963
Cell S42,9750,5612,301279602.7,5457,9061,3604,8085.058268,444.5089016
Cell S44,9750,5604,300850123.6,5645,9061,3416,7960.750178,518.6090113
Cell S56,9750,5604,300850123.6,5505,9061,3556,7752.154711,527.2226684
Cell S67,9750,5612,301279602.7,5505,9061,3556,8008.153243,523.0645211
Cell S78,9750,5610,301172232.9,4745,9081,4336,8140.567201,522.1381448
Cell S88,9750,5613,301333287.6,4469,9085,4616,8175.321931,506.138461
Cell S94,9750,5615,301440657.4,5543,9085,3542,8117.193411,488.3858838
Cell S95,9750,5595,300366959.6,5712,9085,3373,8153.850045,424.8553602
W287,9750,5597,300474329.3,894,9837,8943,4799.423084,2194.819084
W295,9750,5604,300850123.6,1217,9159,7942,6658.549251,1962.667652
W338,9750,5604,300850123.6,697,9484,8787,3891.146681,2301.094858
W342,9750,5611,301225917.8,894,8946,8052,5521.015683,2328.394042
W345,9750,5604,300850123.6,1609,8626,7017,7122.973769,1297.999536
W387,9750,5597,300474329.3,3,9470,9467,4844.942291,2303.41435
W393,9750,5595,300366959.6,728,9484,8756,5280.192851,2556.356173
W440,9750,5596,300420644.4,1073,9239,8166,5130.122051,2251.729344
W441,9750,5604,300850123.6,1101,9239,8138,6072.597252,1910.074199
W445,9750,5604,300850123.6,2091,8898,6807,6818.782655,1026.218665
W500,9750,5600,300635384,1196,8598,7402,6491.347857,1547.983624
1,10000,5895,316472426.5,-1954,9517,11471,6061.736387,2071.491391
2,10000,5901,316794535.9,-1958,9292,11250,6449.436028,1995.875172
3,10000,5889,316150317.2,-1958,9571,11529,7031.8847,1598.208068
4,10000,5891,316257687,1635,9571,7936,7408.419623,1288.84461
5,10000,5890,316204002.1,-1836,9972,11808,5443.190832,2270.285296
6,10000,5898,316633481.2,1036,9804,8768,6000.900814,2346.814065
7,10000,5901,316794535.9,1356,9571,8215,6212.36909,2124.454576
8,10000,5890,316204002.1,1806,9548,7742,7434.033616,1118.301652
9,10000,5894,316418741.7,4260,8920,4660,7949.225314,500.6167606
10,10000,5893,316365056.8,-1005,9882,10887,5109.388427,2677.754931
11,10000,5894,316418741.7,-92,9787,9879,6093.880048,2396.67417
12,10000,5890,316204002.1,705,9950,9245,4839.844143,2516.525472
13,10000,5889,316150317.2,1104,9552,8448,6351.976906,2156.399038
14,10000,5891,316257687,4412,9061,4649,8100.283314,483.7776123
16,10000,5894,316418741.7,-1781,9741,11522,4921.49474,2742.837195
17,10000,5893,316365056.8,-1781,9959,11740,5979.963686,2324.869387
18,10000,5902,316848220.8,418,9950,9532,4996.570315,2507.56468
19,10000,5896,316526111.4,540,9950,9410,5550.855495,2524.956654
20,10000,5891,316257687,1292,9400,8108,7711.342896,1144.734395
21,10000,5904,316955590.6,6337,9081,2744,8248.753896,416.6552249
22,10000,5899,316687166.1,-1781,9972,11753,5060.034413,2837.490019
23,10000,5899,316687166.1,418,9972,9554,6119.082895,2427.691459
24,10000,5889,316150317.2,853,9904,9051,6270.547122,2385.173937
25,10000,5905,317009275.5,1304,9904,8600,6780.661304,2082.649924
26,10000,5902,316848220.8,1499,9629,8130,8002.185191,812.3411757
27,10000,5891,316257687,1175,9904,8729,6470.154643,2313.375622
28,10000,5894,316418741.7,1301,9692,8391,7083.495589,1941.762374
29,10000,5896,316526111.4,1375,9692,8317,7171.369403,1781.810742
31,10000,5901,316794535.9,1168,9468,8300,6941.755974,1914.957745
32,10000,5904,316955590.6,1681,8980,7299,7337.568598,1135.201802
33,10000,5892,316311371.9,1197,9542,8345,6796.850305,1820.825558
34,10000,5907,317116645.2,1681,9542,7861,6992.464703,1131.908842
10A,10000,5888,316096632.3,-1005,9882,10887,5301.269531,2686.406506
10NE,10000,5886,315989262.5,-1005,9882,10887,5278.024465,2690.325831
10NW,10000,5891,316257687,-1836,9972,11808,5488.552029,2334.497743
10SW,10000,5892,316311371.9,-1005,9882,10887,5083.123557,2695.89824
11NE,10000,5902,316848220.8,-92,9804,9896,5769.939173,2548.333843
11NW,10000,5889,316150317.2,-92,9804,9896,6044.250807,2455.104859
11SE,10000,5896,316526111.4,-92,9787,9879,6021.906377,2366.954436
17NW,10000,5893,316365056.8,-1005,9823,10828,5661.998642,2503.411517
17SE,10000,5897,316579796.3,-1781,9972,11753,5948.469052,2409.790106
17SW,10000,5895,316472426.5,-1781,9972,11753,5351.491264,2676.670275
22S,10000,5894,316418741.7,-1781,9972,11753,5052.064303,2829.322859
23S,10000,5889,316150317.2,1111,9571,8460,5508.97385,2384.910111
24S,10000,5895,316472426.5,853,9904,9051,6263.091433,2385.087498
27A,10000,5889,316150317.2,853,9427,8574,7065.69944,1985.609578
2A,10000,5890,316204002.1,-1958,9292,11250,6642.262649,1881.206783
5NE,10000,5889,316150317.2,-1836,9804,11640,5169.180336,2332.595069
5NW,10000,5898,316633481.2,-1836,9972,11808,5102.277891,2314.390142
5SE,10000,5886,315989262.5,-1836,9804,11640,5501.77387,2551.275473
6NE,10000,5901,316794535.9,674,9292,8618,5920.9717,2261.597214
6NW,10000,5901,316794535.9,614,9804,9190,6016.959837,2361.619507
6SW,10000,5888,316096632.3,-92,9804,9896,5623.276834,2624.469788
Cell 1 2011/12,10000,5895,316472426.5,-1954,9517,11471,6061.736387,2071.491391
Cell 1 SW 2013,10000,5884,315881892.8,-1428,9550,10978,5741.940347,2071.850966
Cell 10 2011/12,10000,5893,316365056.8,-1005,9882,10887,5109.388427,2677.754931
Cell 10 NE 2011/12,10000,5886,315989262.5,-1005,9882,10887,5278.024465,2690.325831
Cell 10 NW 2011/12,10000,5891,316257687,-1836,9972,11808,5488.552029,2334.497743
Cell 10 SE 2013,10000,5902,316848220.8,614,9804,9190,6016.416469,2361.788302
Cell 10 SW 2011/12,10000,5892,316311371.9,-1005,9882,10887,5083.123557,2695.89824
Cell 10-A 2011/12,10000,5888,316096632.3,-1005,9882,10887,5301.269531,2686.406506
Cell 11 NE 2011/12,10000,5902,316848220.8,-92,9804,9896,5769.939173,2548.333843
Cell 11 NW 2013,10000,5888,316096632.3,-1958,9292,11250,6547.050102,1934.566718
Cell 11 SW 2013,10000,5887,316042947.4,614,9804,9190,5995.724648,2304.447779
Cell 12 2013,10000,5897,316579796.3,1356,9571,8215,6211.557063,2124.714691
Cell 13 2013,10000,5890,316204002.1,1806,9548,7742,7400.943124,1157.731354
Cell 14 2013,10000,5892,316311371.9,1806,8863,7057,7636.809742,1086.062681
Cell 15 2013,10000,5906,317062960.3,4961,9021,4060,8032.212157,469.9776913
Cell 15-A 2013,10000,5893,316365056.8,4961,9021,4060,8059.334634,446.7613058
Cell 16 2013,10000,5899,316687166.1,5629,9021,3392,7991.99644,443.6370311
Cell 17 NW 2011/12,10000,5893,316365056.8,-1005,9823,10828,5661.998642,2503.411517
Cell 17 NW 2013,10000,5899,316687166.1,-1836,9972,11808,5205.663163,2317.504263
Cell 17 SE 2013,10000,5890,316204002.1,-1836,9972,11808,5489.091341,2334.328927
Cell 17 SW 2013,10000,5886,315989262.5,-1836,9972,11808,5448.361196,2266.700189
Cell 18 2011/12,10000,5902,316848220.8,418,9950,9532,4996.570315,2507.56468
Cell 18 NE 2013,10000,5889,316150317.2,-92,9804,9896,5608.551367,2629.430867
Cell 18 NW 2013,10000,5899,316687166.1,-1836,9804,11640,5492.731141,2547.364232
Cell 18 SE 2013,10000,5902,316848220.8,-92,9804,9896,5769.939173,2548.333843
Cell 18 SSE 2013,10000,5901,316794535.9,-92,9804,9896,6057.363837,2445.509619
Cell 19 NW 2013,10000,5898,316633481.2,674,9804,9130,6076.509156,2301.487413
Cell 2 2011/12,10000,5901,316794535.9,-1958,9292,11250,6449.436028,1995.875172
Cell 2 NE 2013,10000,5892,316311371.9,-1958,9292,11250,6561.068907,1795.442039
Cell 2 SW 2013,10000,5899,316687166.1,-1954,9517,11471,6062.947957,2071.649878
Cell 20 2013,10000,5889,316150317.2,1335,9571,8236,6185.069791,2158.91585
Cell 21 2013,10000,5889,316150317.2,1319,9552,8233,6992.721005,1657.337583
Cell 22 2013,10000,5897,316579796.3,4260,8920,4660,7983.257758,486.2519416
Cell 23 2013,10000,5908,317170330.1,5457,9061,3604,8076.858158,445.4022478
Cell 24 2013,10000,5905,317009275.4,5645,9061,3416,7958.731583,499.0071405
Cell 25 NE 2013,10000,5895,316472426.5,-1005,9882,10887,5109.52112,2677.411969
Cell 25 SE 2013,10000,5892,316311371.9,-1005,9882,10887,5082.450272,2696.650437
Cell 26 NE 2013,10000,5894,316418741.7,-92,9787,9879,6093.880048,2396.67417
Cell 26 NNW 2013,10000,5886,315989262.5,-1005,9882,10887,5279.051308,2689.886276
Cell 26 NW 2013,10000,5889,316150317.2,-1005,9882,10887,5301.522839,2686.248732
Cell 27 NW 2013,10000,5895,316472426.6,-92,9787,9879,6022.735708,2366.298474
Cell 28 2013,10000,5890,316204002.1,705,9950,9245,4839.548557,2516.269776
Cell 29 2013,10000,5887,316042947.4,1104,9552,8448,6351.722269,2157.099824
Cell 3 NE 2013,10000,5890,316204002.1,-1958,9292,11250,7036.329372,1489.982526
Cell 3 NW 2013,10000,5895,316472426.5,-1958,9292,11250,6422.895505,1874.896466
Cell 30 2013,10000,5904,316955590.6,4051,8980,4929,8055.895495,484.8532107
Cell 31 2013,10000,5897,316579796.3,5623,9061,3438,8142.859081,473.957151
Cell 32 2013,10000,5899,316687166.1,5505,9061,3556,8007.998983,525.5749509
Cell 33 NE 2013,10000,5894,316418741.7,-1005,9823,10828,5661.182219,2503.983603
Cell 33 SE 2013,10000,5894,316418741.7,-1781,9972,11753,5351.578554,2676.445563
Cell 33 SW 2013,10000,5886,315989262.5,-1781,9741,11522,4920.82297,2740.946532
Cell 34 N 2013,10000,5888,316096632.3,-1451,9959,11410,5994.0107,2286.497452
Cell 34 NW 2013,10000,5894,316418741.7,-1781,9959,11740,5979.163386,2325.483815
Cell 34 SE 2013,10000,5897,316579796.3,-1781,9972,11753,5947.26098,2409.878014
Cell 35 2013,10000,5899,316687166.1,418,9950,9532,4967.23326,2518.650716
Cell 37 2013,10000,5905,317009275.4,1292,9400,8108,7719.281964,1130.620364
Cell 38 2013,10000,5895,316472426.5,6337,9081,2744,8248.127566,419.2387989
Cell 39 2013,10000,5894,316418741.7,4588,9081,4493,8130.996776,533.8751029
Cell 4 2013,10000,5894,316418741.7,-1067,9498,10565,7423.269766,1321.261737
Cell 40 NE 2013,10000,5896,316526111.4,-1781,9972,11753,5171.622117,2742.130289
Cell 41 N 2013,10000,5893,316365056.8,-1781,9972,11753,5483.114034,2676.187979
Cell 41 NW 2013,10000,5897,316579796.3,-1781,9972,11753,5208.695947,2836.359263
Cell 42 NW 2013,10000,5889,316150317.2,418,9972,9554,6088.258108,2442.516126
Cell 43 2013,10000,5897,316579796.3,540,9904,9364,6082.69476,2471.131912
Cell 44 2013,10000,5897,316579796.3,1292,9841,8549,6965.249618,1969.382626
Cell 45 2013,10000,5898,316633481.2,1499,9629,8130,8002.284842,812.5792957
Cell 47 2013,10000,5888,316096632.3,853,9571,8718,6606.902004,2255.939778
Cell 48 2013,10000,5898,316633481.2,853,9904,9051,6263.153442,2384.726128
Cell 49 2013,10000,5902,316848220.8,1304,9904,8600,6780.098272,2083.015724
Cell 5 2011/12 Summer,10000,5886,315989262.5,-1836,9972,11808,5448.361196,2266.700189
Cell 5 2013,10000,5892,316311371.9,2161,8863,6702,7875.350984,675.6109895
Cell 50 2013,10000,5897,316579796.3,1375,9692,8317,7171.513312,1781.693925
Cell 51 2013,10000,5896,316526111.4,5712,9085,3373,8151.027137,426.1017099
Cell 52 2013,10000,5891,316257687,1301,9692,8391,6644.375488,2237.155498
Cell 53 2013,10000,5893,316365056.8,1301,9692,8391,7083.494485,1941.927117
Cell 54 2013,10000,5907,317116645.2,1681,9017,7336,7937.996614,879.3101385
Cell 55 2013,10000,5895,316472426.6,5568,9005,3437,8072.728244,504.7353788
Cell 56 2013,10000,5895,316472426.5,1197,9542,8345,6795.006616,1821.543492
Cell 57 2013,10000,5908,317170330.1,1681,8980,7299,7336.749323,1136.855263
Cell 58 2013,10000,5893,316365056.8,1681,8980,7299,7863.998133,1008.604917
Cell 59 2013,10000,5913,317438754.6,1327,9730,8403,6755.568239,1699.770842
Cell 6 2011/12,10000,5898,316633481.2,1036,9804,8768,6000.900814,2346.814065
Cell 6 2013,10000,5899,316687166.1,5597,9088,3491,7998.322258,393.0882664
Cell 6 NE 2011/12,10000,5901,316794535.9,674,9292,8618,5920.9717,2261.597214
Cell 6 NW 2011/12,10000,5901,316794535.9,614,9804,9190,6016.959837,2361.619507
Cell 6 SW 2011/12,10000,5888,316096632.3,-92,9804,9896,5623.276834,2624.469788
Cell 60 2013,10000,5894,316418741.7,1698,9542,7844,6975.559382,1098.933884
Cell 61 2013,10000,5907,317116645.2,1619,8955,7336,7471.358896,1220.307538
Cell 7 2013,10000,5898,316633481.2,4961,9168,4207,7957.691251,521.4748636
Cell 9 NW 2013,10000,5892,316311371.9,-1836,9736,11572,5345.434318,2323.996372
Cell 9 SE 2013,10000,5889,316150317.2,-1836,9804,11640,5169.180336,2332.595069
Cell 9 SW 2013,10000,5899,316687166.1,-1836,9972,11808,5101.684014,2314.47256
Cell R1,10000,5900,316740851,1080,9517,8437,5763.135424,1827.055913
Cell R10,10000,5894,316418741.7,-1067,9498,10565,7422.39396,1322.707848
Cell R100,10000,5897,316579796.3,1375,9692,8317,7171.513312,1781.693925
Cell R101,10000,5902,316848220.8,1375,9692,8317,7651.15859,1318.760797
Cell R104,10000,5897,316579796.3,1301,9468,8167,7062.687807,1982.624174
Cell R105,10000,5894,316418741.7,1301,9692,8391,7083.495589,1941.762374
Cell R106,10000,5903,316901905.7,1375,9692,8317,7475.361511,1427.386333
Cell R107,10000,5907,317116645.2,1681,9017,7336,7937.996614,879.3101385
Cell R11,10000,5891,316257687,2161,8863,6702,7875.328637,675.6661522
Cell R111,10000,5896,316526111.4,1168,9468,8300,6819.080393,2122.239065
Cell R112,10000,5892,316311371.9,1562,9468,7906,7376.680754,1243.695554
Cell R113,10000,5907,317116645.2,1681,8980,7299,7336.500085,1136.86226
Cell R114,10000,5894,316418741.7,1681,8980,7299,7864.06549,1008.532607
Cell R117,10000,5906,317062960.3,1168,9542,8374,6437.39553,2108.946686
Cell R118,10000,5895,316472426.5,1197,9542,8345,6795.006616,1821.543492
Cell R119,10000,5899,316687166.1,1681,8980,7299,7209.790982,1182.936853
Cell R120,10000,5905,317009275.5,1746,8874,7128,7436.599323,1283.174079
Cell R121,10000,5896,316526111.4,2412,8955,6543,8043.311398,666.4733327
Cell R123,10000,5892,316311371.9,1318,9889,8571,6672.722335,1788.632939
Cell R124,10000,5893,316365056.8,1698,9542,7844,6974.180384,1065.146851
Cell R125,10000,5898,316633481.2,1894,8780,6886,6938.742625,1053.870178
Cell R126,10000,5895,316472426.5,1627,8955,7328,7390.235454,1232.117702
Cell R15,10000,5883,315828207.9,-1428,9550,10978,5741.831039,2072.010082
Cell R16,10000,5898,316633481.2,-1836,9736,11572,5349.521024,2324.115449
Cell R17,10000,5892,316311371.9,614,9513,8899,6145.087237,2199.612645
Cell R18,10000,5884,315881892.8,-1958,9292,11250,6555.261217,1929.039956
Cell R19,10000,5899,316687166.1,-1067,9571,10638,6663.835396,1854.914245
Cell R20,10000,5890,316204002.1,1806,9498,7692,7559.670119,1080.276479
Cell R21,10000,5891,316257687,1806,8863,7057,7541.793753,1120.791118
Cell R22,10000,5892,316311371.9,1806,8863,7057,7636.809742,1086.062681
Cell R24,10000,5899,316687166.1,-1836,9972,11808,5205.663163,2317.504263
Cell R25,10000,5899,316687166.1,-1836,9804,11640,5492.731141,2547.364232
Cell R26,10000,5892,316311371.9,614,9804,9190,6014.662763,2359.44703
Cell R27,10000,5897,316579796.3,674,9804,9130,6076.335425,2301.643874
Cell R28,10000,5892,316311371.9,1335,9571,8236,5812.69484,2267.44652
Cell R29,10000,5889,316150317.2,1335,9571,8236,6185.069791,2158.91585
Cell R30,10000,5896,316526111.4,1806,8914,7108,7503.445556,1084.333617
Cell R31,10000,5892,316311371.9,1872,8903,7031,7694.282077,949.2585667
Cell R35,10000,5886,315989262.5,-1836,9972,11808,5448.361196,2266.700189
Cell R36,10000,5890,316204002.1,-1836,9972,11808,5489.091341,2334.328927
Cell R37,10000,5902,316848220.8,-92,9804,9896,5769.939173,2548.333843
Cell R38,10000,5894,316418741.7,-92,9787,9879,5499.952494,2529.863022
Cell R39,10000,5901,316794535.9,1319,9552,8233,6337.379258,2133.788199
Cell R40,10000,5889,316150317.2,1319,9552,8233,6992.721005,1657.337583
Cell R46,10000,5886,315989262.5,-1005,9882,10887,5225.09684,2665.470489
Cell R47,10000,5890,316204002.1,-1005,9882,10887,5301.955688,2686.226067
Cell R48,10000,5895,316472426.5,-92,9787,9879,6093.45581,2396.692193
Cell R49,10000,5897,316579796.3,-92,9787,9879,6022.671358,2366.185861
Cell R5,10000,5897,316579796.3,-1428,9285,10713,5613.04036,2051.240845
Cell R50,10000,5888,316096632.3,705,9950,9245,4839.329993,2516.639481
Cell R51,10000,5891,316257687,1104,9552,8448,6361.670005,2153.348227
Cell R52,10000,5891,316257687,1377,9552,8175,7621.411475,839.1862682
Cell R53,10000,5890,316204002.1,2206,8914,6708,7716.866384,717.5351863
Cell R54,10000,5897,316579796.3,5623,9061,3438,8142.859081,473.957151
Cell R58,10000,5895,316472426.6,-1005,9882,10887,5180.152672,2748.90053
Cell R59,10000,5893,316365056.8,-1005,9823,10828,5661.998642,2503.411517
Cell R6,10000,5899,316687166.1,-1954,9517,11471,6062.513985,2072.109163
Cell R60,10000,5893,316365056.8,-1781,9959,11740,5979.089598,2325.674216
Cell R61,10000,5899,316687166.1,418,9950,9532,4967.23326,2518.650716
Cell R62,10000,5896,316526111.4,540,9950,9410,5531.613297,2528.803737
Cell R63,10000,5891,316257687,1104,9552,8448,6078.501782,2373.702769
Cell R64,10000,5891,316257687,1566,9400,7834,7935.115091,633.5728164
Cell R65,10000,5905,317009275.5,4051,8980,4929,8055.794073,484.8747837
Cell R66,10000,5899,316687166.1,5623,8980,3357,8102.238515,455.6393632
Cell R69,10000,5888,316096632.3,-1781,9741,11522,4920.508492,2740.766588
Cell R7,10000,5895,316472426.5,-1958,9292,11250,6423.06531,1875.018322
Cell R70,10000,5894,316418741.7,-1781,9972,11753,5351.578554,2676.445563
Cell R71,10000,5898,316633481.2,-1781,9972,11753,5947.499322,2409.743217
Cell R72,10000,5890,316204002.1,418,9972,9554,5526.368081,2605.399458
Cell R73,10000,5888,316096632.3,418,9950,9532,4749.543818,2593.861399
Cell R74,10000,5900,316740851,540,9400,8860,6357.318475,2355.782905
Cell R75,10000,5904,316955590.6,1292,9400,8108,7719.267446,1130.71556
Cell R76,10000,5896,316526111.4,5854,8980,3126,8155.239993,393.0065187
Cell R77,10000,5895,316472426.5,6337,9081,2744,8248.147752,419.2705464
Cell R8,10000,5890,316204002.1,-1958,9292,11250,6990.714941,1521.201549
Cell R80,10000,5897,316579796.3,-1781,9972,11753,5171.983721,2742.03836
Cell R81,10000,5895,316472426.6,-1781,9972,11753,5593.517897,2655.859212
Cell R82,10000,5890,316204002.1,418,9972,9554,6088.886927,2442.785445
Cell R83,10000,5892,316311371.9,418,9921,9503,6295.801765,2398.73012
Cell R84,10000,5903,316901905.7,540,9904,9364,5830.583432,2542.402759
Cell R85,10000,5897,316579796.3,540,9904,9364,6082.69476,2471.131912
Cell R86,10000,5902,316848220.8,1304,9629,8325,7537.746527,1517.428485
Cell R87,10000,5898,316633481.2,1499,9629,8130,8002.284842,812.5792957
Cell R9,10000,5902,316848220.8,-1958,9292,11250,7160.476279,1436.15724
Cell R90,10000,5889,316150317.2,853,9571,8718,6606.684327,2255.810071
Cell R91,10000,5898,316633481.2,853,9904,9051,6263.153442,2384.726128
Cell R92,10000,5895,316472426.5,1175,9904,8729,6200.641221,2308.681098
Cell R93,10000,5899,316687166.1,1304,9904,8600,6779.260383,2083.211907
Cell R97,10000,5890,316204002.1,853,9427,8574,7081.693888,1981.319145
Cell R98,10000,5892,316311371.9,1175,9904,8729,6469.497115,2313.72976
Cell R99,10000,5890,316204002.1,1301,9692,8391,6644.231409,2237.318072
Cell S102,10000,5903,316901905.7,5712,9085,3373,8164.234288,430.5331025
Cell S108,10000,5895,316472426.6,5568,9005,3437,8072.728244,504.7353788
Cell S13,10000,5891,316257687,4961,9168,4207,8016.313869,436.1835933
Cell S14,10000,5898,316633481.2,4961,9168,4207,7957.691251,521.4748636
Cell S2,10000,5900,316740851,5597,9088,3491,7998.29339,393.0612061
Cell S23,10000,5892,316311371.9,4961,8945,3984,7938.625933,468.4588557
Cell S32,10000,5893,316365056.8,4978,8920,3942,7983.952825,474.1696809
Cell S33,10000,5893,316365056.8,4961,9021,4060,8059.334634,446.7613058
Cell S34,10000,5904,316955590.6,5645,9061,3416,7958.693767,499.040938
Cell S41,10000,5891,316257687,2206,8914,6708,7687.164318,787.4559115
Cell S42,10000,5908,317170330.1,5457,9061,3604,8076.858158,445.4022478
Cell S44,10000,5896,316526111.4,5645,9061,3416,7955.876018,519.8886108
Cell S56,10000,5903,316901905.7,5505,9061,3556,7760.742165,528.4779659
Cell S67,10000,5900,316740851,5505,9061,3556,8007.899492,525.5859606
Cell S78,10000,5896,316526111.4,4588,9081,4493,8131.065977,533.8041723
Cell S88,10000,5898,316633481.2,4469,9085,4616,8165.355883,507.2154216
Cell S94,10000,5893,316365056.8,5528,9085,3557,8111.514,491.1713041
Cell S95,10000,5897,316579796.3,5712,9085,3373,8151.037816,426.068676
W287,10000,5886,315989262.5,894,9837,8943,4821.072885,2204.365645
W295,10000,5894,316418741.7,1217,9159,7942,6649.331354,1979.859768
W338,10000,5897,316579796.3,697,9484,8787,3934.963371,2297.140727
W342,10000,5901,316794535.9,894,8946,8052,5539.399932,2320.930678
W345,10000,5890,316204002.1,1333,8652,7319,7093.592699,1340.569971
W387,10000,5889,316150317.2,3,9470,9467,4875.651214,2302.664678
W393,10000,5897,316579796.3,728,9484,8756,5256.968798,2564.758132
W440,10000,5882,315774523,1073,9239,8166,5109.952737,2258.121487
W441,10000,5886,315989262.5,1101,9239,8138,6054.826538,1920.223819
W445,10000,5897,316579796.3,2091,8898,6807,6815.737833,1043.639621
W500,10000,5889,316150317.2,1196,8598,7402,6512.32722,1532.954301
